Rk,Player,Pos,Age,Tm,G,GS,MP,FG,FGA,3P,3PA,2P,2PA,FT,FTA,ORB,DRB,TRB,AST,STL,BLK,TOV,PF,PTS
1,Tariq Abdul-Wahad,SG,25,TOT,61,56,1578,274,646,3,23,271,623,146,193,101,190,291,98,59,28,106,147,697
2,Shareef Abdur-Rahim,SF,23,VAN,82,82,3223,594,1277,29,96,565,1181,446,551,218,607,825,271,89,87,249,244,1663
3,Cory Alexander,PG,26,DEN,29,2,329,28,98,9,35,19,63,17,22,8,34,42,58,24,2,28,39,82
4,Ray Allen*,SG,24,MIL,82,82,3070,642,1411,172,407,470,1004,353,398,83,276,359,308,110,19,183,187,1809
5,Rafer Alston,PG,23,MIL,27,0,361,27,95,3,14,24,81,3,4,5,18,23,70,12,0,29,29,60
6,John Amaechi,C,29,ORL,80,53,1684,306,700,1,6,305,694,223,291,62,204,266,95,35,37,139,161,836
7,Derek Anderson,SG,25,LAC,64,58,2201,377,860,55,178,322,682,271,309,80,178,258,220,90,11,167,149,1080
8,Kenny Anderson,PG,29,BOS,82,82,2593,434,986,85,220,349,766,196,253,55,170,225,420,139,8,130,230,1149
9,Nick Anderson,SG,32,SAC,72,72,2094,306,782,132,397,174,385,37,76,83,256,339,123,94,16,95,118,781
10,Shandon Anderson,SF,26,HOU,82,82,2700,368,778,79,225,289,553,194,253,91,293,384,239,96,32,194,182,1009
11,Chris Anstey,C,25,CHI,73,11,1007,161,364,1,6,160,358,116,147,90,190,280,65,29,25,80,180,439
12,Greg Anthony,PG,32,POR,82,3,1548,169,416,88,233,81,183,88,114,17,116,133,208,59,9,85,143,514
13,B.J. Armstrong,PG,32,CHI,27,18,583,83,186,13,29,70,157,22,25,2,45,47,78,7,1,40,34,201
14,Darrell Armstrong,PG,31,ORL,82,82,2590,484,1119,137,403,347,716,225,247,65,205,270,501,169,9,248,137,1330
15,Chucky Atkins,PG,25,ORL,82,0,1626,314,741,57,163,257,578,97,133,20,106,126,306,52,3,142,137,782
16,Stacey Augmon,SG,31,POR,59,0,692,83,175,0,2,83,173,37,55,42,74,116,53,27,11,38,69,203
17,Isaac Austin,C,30,WAS,59,23,1173,151,352,1,4,150,348,94,137,64,218,282,74,17,38,107,128,397
18,Anthony Avent,PF,30,LAC,49,3,377,29,96,0,0,29,96,23,32,23,51,74,11,16,15,24,62,81
19,William Avery,PG,20,MIN,59,1,484,56,181,18,63,38,118,24,36,8,32,40,88,14,2,42,60,154
20,Toby Bailey,SG,24,PHO,46,2,449,58,140,2,10,56,130,45,65,26,46,72,30,13,4,24,55,163
21,Vin Baker,C,28,SEA,79,75,2849,514,1129,2,8,512,1121,281,412,227,378,605,148,47,66,213,288,1311
22,Charles Barkley*,PF,36,HOU,20,18,620,106,222,6,26,100,196,71,110,71,138,209,63,14,4,44,48,289
23,Dana Barros,PG,32,BOS,72,0,1139,196,435,59,144,137,291,66,76,13,86,99,133,31,4,66,80,517
24,Brent Barry,SG,28,SEA,80,74,2726,327,707,164,399,163,308,127,157,50,322,372,291,103,31,142,228,945
25,Drew Barry,PG,26,TOT,16,0,159,15,33,7,18,8,15,4,5,0,12,12,33,2,0,13,23,41
26,Jon Barry,SG,30,SAC,62,1,1281,161,346,66,154,95,192,107,116,38,121,159,150,75,7,85,104,495
27,Tony Battie,C,23,BOS,82,4,1505,219,459,1,8,218,451,102,151,152,258,410,63,47,70,67,249,541
28,Jonathan Bender,SF,19,IND,24,1,130,23,70,2,12,21,58,16,24,4,17,21,3,1,5,7,18,64
29,Benoit Benjamin,C,35,CLE,3,0,8,1,3,0,0,1,3,0,0,0,1,1,0,0,1,0,1,2
30,Corey Benjamin,SG,21,CHI,48,10,862,145,350,31,89,114,261,49,82,21,67,88,54,31,22,74,122,370
31,Mario Bennett,PF,26,LAC,1,0,3,0,3,0,0,0,3,0,0,1,1,2,0,0,0,0,1,0
32,Travis Best,PG,27,IND,82,0,1691,271,561,35,93,236,468,156,190,16,126,142,272,76,5,107,204,733
33,Mike Bibby,PG,21,VAN,82,82,3155,459,1031,77,212,382,819,195,250,73,233,306,665,132,15,247,171,1190
34,Chauncey Billups,SG,23,DEN,13,5,305,34,101,7,41,27,60,37,44,8,26,34,39,10,2,24,27,112
35,Mookie Blaylock,PG,32,GSW,73,72,2459,327,837,101,301,226,536,67,95,55,215,270,489,146,22,143,122,822
36,Corie Blount,PF,31,PHO,38,1,446,44,89,0,2,44,87,19,33,52,61,113,10,15,7,28,78,107
37,Muggsy Bogues,PG,35,TOR,80,5,1731,157,358,17,51,140,307,79,87,25,110,135,299,65,4,59,119,410
38,Etdrick Bohannon,PF,26,TOT,13,0,118,7,13,0,0,7,13,15,24,13,18,31,5,2,6,10,25,29
39,Calvin Booth,C,23,WAS,11,0,143,16,46,0,0,16,46,10,14,15,17,32,7,3,14,6,23,42
40,Lazaro Borrell,SF,27,SEA,17,6,167,28,63,0,3,28,60,6,11,14,26,40,10,6,3,6,9,62
41,Cal Bowdler,SF,22,ATL,46,0,423,49,115,0,1,49,114,24,38,22,63,85,14,14,9,21,46,122
42,Bruce Bowen,SF,28,TOT,69,2,878,72,194,27,58,45,136,25,43,27,69,96,34,23,15,19,118,196
43,Ryan Bowen,SF,24,DEN,52,0,589,46,117,1,9,45,108,38,53,75,39,114,20,39,13,14,95,131
44,Ira Bowman,SG,26,PHI,11,0,20,2,2,0,0,2,2,1,2,0,2,2,1,1,0,1,0,5
45,Earl Boykins,PG,23,TOT,26,0,261,56,116,8,20,48,96,18,23,12,14,26,48,12,1,17,23,138
46,Shawn Bradley,C,27,DAL,77,54,1901,266,555,1,5,265,550,114,149,160,337,497,60,71,190,74,260,647
47,A.J. Bramlett,C,23,CLE,8,0,61,4,21,0,0,4,21,0,0,12,10,22,0,1,0,3,13,8
48,Elton Brand,PF,20,CHI,81,80,2999,630,1306,0,2,630,1304,367,536,348,462,810,155,66,132,228,259,1627
49,Terrell Brandon,PG,29,MIN,71,71,2587,486,1042,53,132,433,910,187,208,44,194,238,629,134,30,184,158,1212
50,Chucky Brown,PF,31,TOT,63,29,1096,148,328,2,10,146,318,36,52,35,132,167,66,20,18,45,114,334
51,Dee Brown,PG,31,TOR,38,12,673,93,258,67,187,26,71,11,16,9,45,54,86,24,5,39,62,264
52,Marcus Brown,SG,25,DET,6,0,45,4,14,0,7,4,7,2,2,3,4,7,3,0,0,3,8,10
53,P.J. Brown,PF,30,MIA,80,80,2302,322,671,0,1,322,670,120,159,216,384,600,145,65,61,100,264,764
54,Randy Brown,PG,31,CHI,59,55,1625,157,435,3,6,154,429,62,84,23,121,144,202,61,15,105,120,379
55,Rick Brunson,PG,27,NYK,37,0,289,29,70,2,13,27,57,11,18,3,24,27,49,9,1,31,35,71
56,Kobe Bryant,SG,21,LAL,66,62,2524,554,1183,46,144,508,1039,331,403,108,308,416,323,106,62,182,220,1485
57,Mark Bryant,PF,34,CLE,75,50,1712,174,346,0,0,174,346,76,94,126,226,352,61,31,31,87,250,424
58,Greg Buckner,SG,23,DAL,48,1,923,111,233,10,26,101,207,43,63,56,118,174,55,38,20,36,148,275
59,Jud Buechler,SF,31,DET,58,5,657,55,156,18,83,37,73,2,7,30,61,91,33,25,16,13,50,130
60,Rodney Buford,SG,22,MIA,34,0,386,62,151,7,29,55,122,16,22,10,38,48,21,10,8,9,44,147
61,Matt Bullard,PF,32,HOU,56,27,1024,139,340,79,177,60,163,25,30,13,125,138,63,19,13,36,85,382
62,Scott Burrell,SF,29,NJN,74,9,1336,165,419,82,232,83,187,39,50,65,191,256,72,67,44,38,173,451
63,Jason Caffey,PF,26,GSW,71,56,2159,323,675,0,2,323,673,206,345,189,293,482,119,62,20,170,269,852
64,Michael Cage,C,38,NJN,20,7,242,12,24,0,0,12,24,3,3,33,48,81,9,8,8,4,30,27
65,Marcus Camby,C,25,NYK,59,11,1548,226,471,1,2,225,469,148,221,174,287,461,49,43,116,72,204,601
66,Elden Campbell,C,31,CHH,78,77,2538,370,829,0,6,370,823,247,358,168,422,590,129,56,150,127,269,987
67,Antoine Carr,SF,38,VAN,21,0,221,28,64,0,0,28,64,11,14,8,24,32,7,3,6,9,42,67
69,Anthony Carter,PG,24,MIA,79,30,1859,201,509,3,23,198,486,93,124,48,151,199,378,93,5,173,167,498
70,Vince Carter,SF,23,TOR,82,82,3126,788,1696,95,236,693,1460,436,551,150,326,476,322,110,92,178,263,2107
71,Sam Cassell,PG,30,MIL,81,81,2899,545,1170,26,90,519,1080,390,445,69,232,301,729,102,8,267,255,1506
72,Kelvin Cato,C,25,HOU,65,32,1581,216,402,0,4,216,398,135,208,102,287,389,26,33,124,71,175,567
73,Duane Causwell,C,31,MIA,25,2,185,20,37,0,0,20,37,26,38,11,36,47,2,2,16,10,42,66
74,Cedric Ceballos,SF,30,DAL,69,25,2064,447,1002,44,134,403,868,209,248,172,290,462,90,56,24,125,165,1147
75,John Celestand,PG,22,LAL,16,0,185,15,45,2,9,13,36,5,6,1,10,11,20,7,0,16,22,37
76,Rex Chapman,SG,32,PHO,53,19,957,124,320,41,123,83,197,59,78,10,70,80,62,22,1,38,70,348
77,Calbert Cheaney,SG,28,BOS,67,19,1309,120,273,18,54,102,219,9,21,23,115,138,80,44,14,46,158,267
78,Pete Chilcutt,PF,31,TOT,56,2,601,53,127,6,26,47,101,8,8,46,85,131,27,15,10,20,73,120
79,Chris Childs,PG,32,NYK,71,2,1675,146,357,37,104,109,253,47,59,17,130,147,285,36,4,105,240,376
80,Doug Christie,SG,29,TOR,73,73,2264,311,764,99,275,212,489,182,216,63,222,285,321,102,43,144,167,903
81,Keon Clark,C,24,DEN,81,20,1850,286,528,1,8,285,520,121,176,162,343,505,71,45,114,125,231,694
82,Keith Closs,C,23,LAC,57,6,820,96,197,0,3,96,194,46,78,65,114,179,25,13,73,34,80,238
83,Derrick Coleman,PF,32,CHH,74,64,2347,446,979,51,141,395,838,296,377,124,508,632,175,34,130,173,195,1239
84,Bimbo Coles,PG,31,ATL,80,54,1924,276,607,8,39,268,568,85,104,30,142,172,290,58,11,103,178,645
85,Marty Conlon,C,32,LAC,3,0,9,1,2,0,0,1,2,0,0,1,1,2,0,0,0,0,1,2
86,Tyrone Corbin,SF,37,SAC,54,5,941,88,247,10,44,78,203,33,39,40,125,165,60,36,5,29,99,219
87,Chris Crawford,PF,24,ATL,55,11,668,91,229,7,27,84,202,63,81,51,48,99,33,17,16,37,83,252
88,Austin Croshere,PF,24,IND,81,14,1885,288,653,63,174,225,479,196,231,135,381,516,89,44,60,121,203,835
89,John Crotty,PG,30,DET,69,0,937,106,251,33,80,73,171,80,93,17,58,75,128,27,5,54,104,325
90,Terry Cummings,PF,38,GSW,22,0,398,76,177,0,0,76,177,32,39,45,62,107,21,13,8,27,74,184
91,Vonteego Cummings,PG,23,GSW,75,11,1793,265,655,49,151,216,504,127,169,57,127,184,247,91,13,132,174,706
93,Dell Curry,SG,35,TOR,67,9,1095,194,454,95,242,99,212,24,32,11,89,100,89,32,9,40,66,507
94,Michael Curry,SG,31,DET,82,3,1611,182,379,1,5,181,374,141,168,21,83,104,87,33,5,73,209,506
95,Erick Dampier,C,24,GSW,21,12,495,70,173,0,0,70,173,27,51,48,86,134,19,8,15,29,75,167
96,Antonio Daniels,SG,24,SAS,68,1,1195,163,344,22,66,141,278,72,101,16,70,86,177,55,5,58,73,420
97,Kornél Dávid,SF,28,TOT,32,5,474,67,157,0,3,67,154,45,56,26,55,81,17,17,3,33,56,179
98,Antonio Davis,C,31,TOR,79,78,2479,313,712,0,0,313,712,284,371,235,461,696,105,38,100,121,267,910
99,Baron Davis,PG,20,CHH,82,0,1523,182,433,25,111,157,322,97,153,48,117,165,309,97,19,140,201,486
100,Ben Davis,PF,27,PHO,5,0,22,2,6,0,0,2,6,0,0,3,6,9,2,1,1,3,2,4
101,Dale Davis,C,30,IND,74,72,2127,302,602,0,0,302,602,139,203,256,473,729,64,52,94,91,203,743
102,Emanual Davis,PG,31,SEA,54,2,701,80,220,31,103,49,117,26,38,15,85,100,70,38,5,44,72,217
103,Hubert Davis,PG,29,DAL,79,15,1817,217,464,82,167,135,297,67,77,17,117,134,141,24,3,70,109,583
104,Mark Davis,SF,26,GSW,23,7,464,56,137,0,2,56,135,31,47,31,53,84,38,25,4,40,52,143
105,Ricky Davis,SG,20,CHH,48,4,570,94,187,0,4,94,183,39,51,29,54,83,62,30,8,46,39,227
106,Todd Day,SG,30,PHO,58,1,941,130,330,64,165,66,165,72,108,31,98,129,65,44,22,50,127,396
107,Andrew DeClercq,C,26,CLE,82,31,1831,225,443,0,0,225,443,94,160,156,283,439,58,63,66,108,275,544
108,Vinny Del Negro,PG,33,MIL,67,0,1211,153,325,8,24,145,301,35,39,9,98,107,160,36,0,48,81,349
109,Tony Delk,PG,26,SAC,46,1,682,120,279,9,40,111,239,47,59,36,52,88,55,35,5,32,58,296
110,Derrick Dial,SG,24,SAS,8,0,95,17,46,3,12,14,34,3,5,14,12,26,5,1,1,6,10,40
111,Michael Dickerson,SG,24,VAN,82,82,3103,554,1270,119,291,435,979,269,324,78,201,279,208,116,45,165,226,1496
112,Vlade Divac*,C,31,SAC,82,81,2374,384,764,7,26,377,738,230,333,174,482,656,244,103,103,190,251,1005
113,Michael Doleac,C,22,ORL,81,29,1335,242,535,1,2,241,533,80,95,89,245,334,63,29,34,65,224,565
114,Sherman Douglas,PG,33,NJN,20,2,309,45,90,5,16,40,74,25,28,13,16,29,34,17,0,24,26,120
115,Bryce Drew,PG,25,HOU,72,5,1293,158,413,59,163,99,250,45,53,23,80,103,162,41,1,66,79,420
116,Chris Dudley,C,34,NYK,47,3,459,23,67,0,0,23,67,9,27,63,73,136,5,7,21,18,95,55
117,Tim Duncan,PF,23,SAS,74,74,2875,628,1281,1,11,627,1270,459,603,262,656,918,234,66,165,242,210,1716
118,Howard Eisley,PG,27,UTA,82,5,2096,282,675,60,163,222,512,84,102,23,147,170,347,59,9,132,223,708
119,Obinna Ekezie,PF,24,VAN,39,0,351,41,88,0,0,41,88,43,64,34,58,92,8,9,4,26,61,125
120,Mario Elie,SF,36,SAS,79,79,2217,195,457,74,186,121,271,126,149,48,201,249,193,73,9,130,156,590
121,Sean Elliott,SF,31,SAS,19,19,391,38,106,13,37,25,69,25,32,6,41,47,28,12,2,19,34,114
122,Dale Ellis,SG,39,TOT,42,5,564,66,159,37,100,29,59,9,13,13,43,56,14,13,0,20,45,178
123,LaPhonso Ellis,PF,29,ATL,58,8,1309,209,464,3,21,206,443,66,95,98,192,290,59,32,25,52,133,487
124,Pervis Ellison,C,32,BOS,30,5,269,19,43,0,0,19,43,15,21,29,38,67,13,10,8,13,67,53
125,Evan Eschmeyer,C,24,NJN,31,5,373,38,72,0,0,38,72,15,30,40,68,108,21,8,21,21,84,91
126,Patrick Ewing*,C,37,NYK,62,62,2035,361,775,0,2,361,773,207,283,140,464,604,58,36,84,142,196,929
127,Tony Farmer,PF,30,GSW,74,9,1199,127,312,8,44,119,268,203,265,118,177,295,74,66,16,82,167,465
128,Jamie Feick,C,25,NJN,81,17,2241,181,423,3,3,178,420,94,133,264,491,755,68,43,38,59,206,459
129,Danny Ferry,PF,33,CLE,63,3,1326,189,380,33,75,156,305,52,57,55,183,238,67,22,24,55,181,463
130,Michael Finley,SF,26,DAL,82,82,3464,748,1636,99,247,649,1389,260,317,122,396,518,438,109,32,196,171,1855
131,Derek Fisher,PG,25,LAL,78,22,1803,167,483,52,166,115,317,105,145,22,121,143,216,80,3,75,150,491
132,Danny Fortson,PF,23,BOS,55,5,856,140,265,0,0,140,265,139,189,141,225,366,29,20,5,67,180,419
133,Greg Foster,PF,31,SEA,60,5,718,91,224,3,15,88,209,18,28,16,91,107,41,10,18,28,105,203
134,Jeff Foster,C,23,IND,19,0,86,13,23,0,1,13,22,17,25,12,20,32,5,5,1,2,18,43
135,Rick Fox,SF,30,LAL,82,1,1473,206,498,59,181,147,317,63,78,63,135,198,138,52,26,87,203,534
136,Adonal Foyle,C,24,GSW,76,59,1654,193,380,0,0,193,380,34,90,174,250,424,42,26,136,71,218,420
137,Steve Francis,PG,22,HOU,77,77,2776,497,1117,107,310,390,807,287,365,152,257,409,507,118,29,306,231,1388
138,Todd Fuller,C,25,CHH,41,2,399,51,122,0,0,51,122,32,53,36,74,110,5,9,8,27,46,134
139,Lawrence Funderburke,PF,29,SAC,75,1,1026,184,352,0,2,184,350,115,163,98,136,234,33,32,20,40,91,483
140,Kevin Garnett,PF,23,MIN,81,81,3243,759,1526,30,81,729,1445,309,404,223,733,956,401,120,126,268,205,1857
141,Dean Garrett,C,33,MIN,56,23,604,48,108,0,0,48,108,18,26,41,99,140,19,8,40,21,94,114
142,Kiwane Garris,SG,25,ORL,3,0,23,2,10,0,1,2,9,0,0,0,1,1,2,0,0,1,0,4
143,Pat Garrity,SF,23,ORL,82,1,1479,258,585,79,197,179,388,80,111,44,166,210,58,31,19,85,197,675
144,Chris Gatling,PF,32,TOT,85,0,1811,365,802,18,70,347,732,266,373,154,348,502,71,82,23,169,246,1014
145,Matt Geiger,C,30,PHI,65,20,1406,260,589,0,4,260,585,109,140,154,233,387,39,29,22,91,194,629
146,Devean George,SF,22,LAL,49,1,345,56,144,16,47,40,97,27,41,29,46,75,12,10,4,21,54,155
147,Kendall Gill,SF,31,NJN,76,75,2355,396,956,20,78,376,878,181,255,82,201,283,210,139,41,89,211,993
148,Armen Gilliam,PF,35,UTA,50,0,782,133,305,0,1,133,304,67,86,72,137,209,42,12,16,55,83,333
149,Dion Glover,SG,21,ATL,30,1,446,66,171,12,45,54,126,51,70,15,23,38,27,15,4,28,28,195
150,Brian Grant,PF,27,POR,63,14,1322,173,352,1,2,172,350,112,166,121,223,344,64,32,28,84,166,459
151,Gary Grant,PG,34,POR,3,0,24,6,14,0,0,6,14,0,0,0,3,3,1,1,0,2,3,12
152,Horace Grant,PF,34,SEA,76,76,2688,266,599,0,4,266,595,80,111,167,424,591,188,55,60,61,192,612
153,Devin Gray,SF,27,HOU,21,2,124,15,37,0,0,15,37,19,29,11,14,25,5,5,3,4,22,49
154,A.C. Green,PF,36,LAL,82,82,1929,173,387,1,4,172,383,66,95,160,326,486,80,53,18,53,127,413
155,Adrian Griffin,SG,25,BOS,72,47,1927,175,413,16,57,159,356,119,158,128,244,372,177,116,15,93,222,485
156,Tom Gugliotta,PF,30,PHO,54,54,1767,310,645,1,8,309,637,117,151,141,284,425,124,80,31,106,152,738
157,Darvin Ham,SF,26,MIL,35,21,792,71,128,0,1,71,127,35,78,85,87,172,42,29,29,29,102,177
158,Richard Hamilton,SG,21,WAS,71,12,1373,254,605,28,77,226,528,103,133,38,91,129,108,28,6,84,142,639
159,Thomas Hamilton,C,24,HOU,22,7,273,35,79,0,0,35,79,12,23,31,59,90,15,4,14,28,25,82
160,Tom Hammonds,PF,32,MIN,56,0,372,42,97,0,0,42,97,33,56,34,67,101,10,8,3,21,55,117
161,Anfernee Hardaway,SG,28,PHO,60,60,2253,378,798,33,102,345,696,226,286,91,256,347,315,94,38,153,164,1015
162,Tim Hardaway,PG,33,MIA,52,52,1672,246,638,94,256,152,382,110,133,25,125,150,385,49,4,119,112,696
163,Ron Harper,PG,36,LAL,80,78,2042,212,531,33,106,179,425,100,147,96,241,337,270,85,39,132,164,557
164,Matt Harpring,SF,23,ORL,4,0,63,4,17,2,2,2,15,6,7,5,7,12,8,5,1,1,7,16
165,Al Harrington,PF,19,IND,50,0,854,121,264,8,34,113,230,78,111,47,112,159,38,25,9,65,130,328
166,Othella Harrington,PF,26,VAN,82,82,2677,420,830,0,2,420,828,236,298,196,367,563,97,36,58,217,287,1076
167,Lucious Harris,SG,29,NJN,77,11,1510,198,463,38,115,160,348,79,99,53,134,187,100,65,6,42,98,513
168,Antonio Harvey,PF,29,POR,19,0,137,17,30,0,0,17,30,7,12,8,25,33,5,1,6,12,20,41
169,Hersey Hawkins,SG,33,CHI,61,49,1622,159,375,55,141,104,234,107,119,31,144,175,134,74,15,100,146,480
170,Michael Hawkins,PG,27,CHH,12,0,36,3,13,1,5,2,8,1,2,0,7,7,13,0,0,3,2,8
171,Alan Henderson,PF,27,ATL,82,82,2775,429,930,1,10,428,920,224,334,265,306,571,77,81,54,139,233,1083
172,Cedric Henderson,SF,24,CLE,61,7,1107,129,326,1,15,128,311,69,104,34,106,140,55,39,17,68,99,328
173,Mark Hendrickson,PF,25,TOT,15,0,71,5,8,0,0,5,8,3,4,3,10,13,6,2,1,3,8,13
174,Chris Herren,PG,24,DEN,45,1,597,45,124,24,67,21,57,27,40,12,40,52,111,15,2,42,74,141
175,Grant Hill*,SF,27,DET,74,74,2776,696,1422,34,98,662,1324,480,604,97,393,490,385,103,43,240,190,1906
176,Tyrone Hill,PF,31,PHI,68,65,2155,318,656,0,1,318,655,179,259,220,405,625,52,64,27,124,243,815
177,Fred Hoiberg,SG,27,CHI,31,11,845,89,230,32,94,57,136,69,76,7,103,110,85,40,2,43,66,279
178,Derek Hood,PF,23,CHH,2,0,4,0,3,0,0,0,3,0,0,0,1,1,0,0,0,0,0,0
179,Jeff Hornacek,SG,36,UTA,77,77,2133,358,728,66,138,292,590,171,180,49,133,182,202,66,16,113,149,953
180,Robert Horry,PF,29,LAL,76,0,1685,159,363,29,94,130,269,89,113,133,228,361,118,84,80,73,189,436
181,Allan Houston,SG,28,NYK,82,82,3169,614,1271,106,243,508,1028,280,334,38,233,271,224,65,14,186,219,1614
182,Juwan Howard,PF,26,WAS,82,82,2909,509,1108,0,7,509,1101,202,275,132,338,470,247,67,21,225,299,1220
183,Troy Hudson,PG,23,LAC,62,38,1592,204,541,60,193,144,348,77,95,28,120,148,242,43,0,108,65,545
184,Larry Hughes,SG,21,TOT,82,37,2324,459,1147,29,125,430,1022,279,377,113,236,349,205,115,28,195,191,1226
185,Rick Hughes,PF,26,DAL,21,0,224,35,72,0,1,35,71,12,26,24,25,49,9,3,1,14,30,82
186,Lindsey Hunter,PG,29,DET,82,82,2919,379,892,168,389,211,503,117,154,35,215,250,327,129,22,145,216,1043
187,Allen Iverson*,SG,24,PHI,70,70,2853,729,1733,89,261,640,1472,442,620,71,196,267,328,144,5,230,162,1989
188,Bobby Jackson,PG,26,MIN,73,10,1034,140,346,13,46,127,300,76,98,50,103,153,172,48,7,58,114,369
189,Jaren Jackson,SG,32,SAS,81,12,1691,186,488,108,306,78,182,33,51,34,147,181,118,54,7,66,157,513
190,Jermaine Jackson,SG,23,DET,7,0,73,1,11,0,1,1,10,5,8,1,10,11,4,3,0,7,7,7
191,Jim Jackson,SF,29,ATL,79,76,2767,507,1235,117,303,390,932,186,212,101,293,394,230,57,10,185,167,1317
192,Mark Jackson,PG,34,IND,81,81,2190,246,570,89,221,157,349,79,98,63,233,296,650,76,10,174,111,660
193,Randell Jackson,PF,24,DAL,1,0,1,0,0,0,0,0,0,0,0,0,0,0,0,0,0,0,0,0
194,Sam Jacobson,PG,24,TOT,52,5,681,108,212,9,24,99,188,30,41,25,46,71,32,30,3,33,113,255
195,Tim James,SF,23,MIA,4,0,23,5,14,0,0,5,14,1,3,3,1,4,2,0,3,2,1,11
196,Antawn Jamison,SF,23,GSW,43,41,1556,356,756,2,7,354,749,127,208,172,187,359,90,30,15,113,115,841
197,Harold Jamison,PF,23,MIA,12,0,74,7,20,0,0,7,20,4,18,16,5,21,4,2,1,4,17,18
198,Anthony Johnson,PG,25,TOT,56,6,637,62,164,2,11,60,153,28,39,21,30,51,72,33,4,32,58,154
199,Avery Johnson,PG,34,SAS,82,82,2571,402,850,1,9,401,841,114,155,33,125,158,491,76,18,140,150,919
200,DeMarco Johnson,PF,24,NYK,5,0,37,3,9,0,0,3,9,0,0,3,4,7,0,1,0,3,5,6
201,Ervin Johnson,C,32,MIL,80,74,2129,144,279,0,1,144,278,95,157,233,415,648,44,81,127,80,298,383
202,Kevin Johnson,PG,33,PHO,6,0,113,16,28,1,1,15,27,7,7,0,16,16,24,2,0,7,6,40
203,Larry Johnson,PF,30,NYK,70,68,2281,282,652,58,174,224,478,128,167,87,293,380,175,42,7,94,205,750
204,Charles Jones,PG,24,LAC,56,0,662,66,201,39,118,27,83,17,23,17,45,62,94,30,5,28,46,188
205,Damon Jones,PG,23,TOT,55,1,612,80,208,41,114,39,94,32,48,12,43,55,96,18,1,40,34,233
206,Eddie Jones,SG,28,CHH,72,72,2807,478,1119,128,341,350,778,362,419,81,262,343,305,192,49,160,176,1446
207,Jumaine Jones,SF,20,PHI,33,0,138,22,58,2,4,20,54,11,18,16,22,38,5,6,5,14,10,57
208,Popeye Jones,PF,29,DEN,40,1,330,44,104,2,3,42,101,14,19,41,62,103,19,3,6,13,50,104
209,Reggie Jordan,PG,32,WAS,36,0,243,17,53,0,1,17,52,7,13,16,25,41,32,12,2,19,29,41
210,Adam Keefe,C,29,UTA,62,3,604,53,130,0,1,53,129,29,36,45,91,136,34,17,13,46,90,135
211,Shawn Kemp,C,30,CLE,82,82,2492,484,1160,2,6,482,1154,493,635,231,494,725,138,100,96,291,371,1463
212,Steve Kerr,PG,34,SAS,32,0,268,32,74,16,31,16,43,9,11,3,16,19,12,4,0,7,14,89
213,Jerome Kersey,SF,37,SAS,72,18,1310,146,354,0,9,146,345,29,41,58,167,225,69,67,47,51,161,321
214,Lari Ketner,PF,22,TOT,22,0,132,13,32,0,0,13,32,8,12,12,22,34,1,4,3,10,20,34
215,Jason Kidd*,PG,26,PHO,67,67,2616,350,855,56,166,294,689,203,245,96,387,483,678,134,28,226,148,959
216,Gerard King,SF,27,WAS,62,28,1060,139,277,0,0,139,277,49,66,84,166,250,49,34,15,41,132,327
217,Kerry Kittles,SG,25,NJN,62,61,1896,305,698,96,240,209,458,101,127,46,179,225,142,79,19,56,120,807
218,Joe Kleine,C,38,POR,7,0,31,4,11,0,0,4,11,3,3,0,6,6,2,1,0,2,7,11
219,Brevin Knight,PG,24,CLE,65,46,1754,230,558,2,10,228,548,140,184,38,155,193,458,107,21,157,185,602
220,Travis Knight,C,25,LAL,63,0,410,46,118,0,0,46,118,17,28,46,83,129,23,6,23,26,88,109
221,Toni Kukoč,SF,31,TOT,56,31,1784,297,728,44,168,253,560,192,265,75,198,273,265,77,28,146,112,830
222,Christian Laettner,C,30,DET,82,82,2443,379,801,7,24,372,777,237,292,175,378,553,186,83,45,186,326,1002
223,Raef LaFrentz,C,23,DEN,81,80,2435,392,879,60,183,332,696,162,236,170,471,641,97,42,180,96,292,1006
224,Andrew Lang,C,33,NYK,19,10,244,28,64,0,0,28,64,3,7,16,44,60,3,8,6,5,31,59
225,Antonio Lang,SF,27,TOT,10,0,38,1,6,0,0,1,6,4,5,0,5,5,2,4,1,2,8,6
226,Trajan Langdon,SG,23,CLE,10,0,145,15,40,8,19,7,21,11,11,4,11,15,11,5,0,6,16,49
227,Rusty LaRue,PG,26,CHI,4,1,129,15,43,2,14,13,29,5,7,1,9,10,11,7,0,7,9,37
228,Tim Legler,SG,33,GSW,23,4,284,28,78,7,21,21,57,14,18,4,19,23,24,4,1,6,33,77
229,Voshon Lenard,SG,26,MIA,53,13,1434,228,560,89,228,139,332,84,106,37,116,153,136,41,15,80,127,629
230,Quincy Lewis,SG,22,UTA,74,0,896,111,298,23,63,88,235,38,52,46,67,113,40,24,15,46,158,283
231,Rashard Lewis,SF,20,SEA,82,8,1575,275,566,40,120,235,446,84,123,127,209,336,70,62,36,78,163,674
232,Randy Livingston,PG,24,PHO,79,15,1081,155,373,19,55,136,318,52,62,25,105,130,170,49,13,92,129,381
233,Grant Long,PF,33,VAN,42,1,920,74,167,0,4,74,163,55,71,86,148,234,43,45,10,49,108,203
234,Luc Longley,C,31,PHO,72,68,1417,186,399,0,0,186,399,80,97,100,223,323,77,22,42,136,221,452
235,Felipe López,SG,25,VAN,65,0,781,111,261,3,18,108,243,67,109,59,65,124,44,32,17,53,94,292
236,Tyronn Lue,PG,22,LAL,8,0,146,19,39,4,8,15,31,6,8,2,10,12,17,3,0,9,17,48
237,George Lynch,SF,29,PHI,75,75,2416,297,644,15,36,282,608,113,183,216,366,582,136,119,38,120,231,722
238,Todd MacCulloch,C,24,PHI,56,6,528,89,161,0,0,89,161,28,54,48,98,146,13,11,37,26,94,206
239,Sam Mack,SF,29,GSW,23,5,333,37,122,21,64,16,58,19,20,7,32,39,24,18,1,19,45,114
240,Don MacLean,PF,30,PHO,16,0,143,18,49,2,6,16,43,4,6,6,17,23,8,2,1,8,24,42
241,Corey Maggette,SF,20,ORL,77,5,1370,224,469,2,11,222,458,196,261,123,180,303,61,24,26,138,169,646
242,Dan Majerle,SG,34,MIA,69,69,2308,170,422,110,304,60,118,56,69,27,306,333,206,89,17,62,156,506
243,Karl Malone*,PF,36,UTA,82,82,2947,752,1476,2,8,750,1468,589,739,169,610,779,304,79,71,231,229,2095
244,Matt Maloney,PG,28,CHI,51,12,1175,114,318,62,174,52,144,37,45,10,54,64,138,32,3,63,42,327
245,Danny Manning,PF,33,MIL,72,0,1217,149,339,1,4,148,335,34,52,50,158,208,73,62,29,55,183,333
246,Stephon Marbury,PG,22,NJN,74,74,2881,569,1317,66,233,503,1084,436,536,61,179,240,622,112,15,270,195,1640
247,Shawn Marion,SF,21,PHO,51,38,1260,222,471,4,22,218,449,72,85,105,227,332,69,38,53,51,113,520
248,Sean Marks,PF,24,TOR,5,0,12,2,6,0,1,2,5,4,4,0,2,2,0,1,1,3,3,8
249,Donny Marshall,SF,27,CLE,6,0,39,3,11,0,3,3,8,5,6,0,1,1,0,2,0,3,7,11
250,Donyell Marshall,PF,26,GSW,64,51,2071,331,840,49,138,282,702,199,255,189,448,637,167,68,68,123,180,910
251,Darrick Martin,PG,28,SAC,71,1,893,133,350,38,124,95,226,98,119,7,37,44,122,28,2,62,89,402
252,Jamal Mashburn,SF,27,MIA,76,76,2828,515,1158,112,278,403,880,186,239,64,317,381,298,79,14,180,215,1328
253,Anthony Mason,SF,33,CHH,82,81,3133,317,661,0,1,317,660,314,421,145,554,699,367,74,29,160,220,948
254,Tony Massenburg,PF,32,HOU,10,0,109,16,36,0,0,16,36,14,16,7,20,27,3,2,5,9,13,46
255,Vernon Maxwell,SG,34,SEA,47,0,989,169,490,67,223,102,267,108,148,15,64,79,75,38,9,53,83,513
256,Walter McCarty,PF,25,BOS,61,5,879,78,230,34,110,44,120,39,54,33,77,110,70,24,23,67,83,229
257,George McCloud,SF,32,DEN,78,11,2118,266,638,107,283,159,355,148,181,72,213,285,246,48,26,134,180,787
258,Jelani McCoy,C,22,SEA,58,2,746,102,177,0,0,102,177,45,91,54,125,179,24,15,46,45,127,249
259,Antonio McDyess,PF,25,DEN,81,81,2698,614,1211,0,2,614,1209,323,516,234,451,685,159,69,139,230,316,1551
260,Tracy McGrady*,SF,20,TOR,79,34,2462,459,1018,18,65,441,953,277,392,188,313,501,263,90,151,160,201,1213
261,Jim McIlvaine,C,27,NJN,66,53,1048,64,154,0,0,64,154,29,56,106,124,230,36,26,117,38,205,157
262,Jeff McInnis,PG,25,LAC,25,10,597,80,186,7,21,73,165,13,17,18,54,72,89,15,2,27,55,180
263,Derrick McKey,SF,33,IND,32,0,634,43,108,10,23,33,85,43,56,29,106,135,35,29,13,19,81,139
264,Aaron McKie,SG,27,PHI,82,14,1952,244,593,44,121,200,472,121,146,47,199,246,240,108,18,113,194,653
265,Roshown McLeod,SF,24,ATL,44,20,860,131,332,2,13,129,319,54,70,41,97,138,52,16,5,59,84,318
266,Ron Mercer,SG,23,TOT,68,68,2377,460,1080,15,48,445,1032,213,270,64,186,250,158,75,23,151,151,1148
267,Andre Miller,PG,23,CLE,82,36,2093,339,755,10,49,329,706,226,292,85,195,280,476,84,17,166,194,914
268,Anthony Miller,PF,28,HOU,35,14,476,52,97,0,0,52,97,26,51,49,115,164,16,11,10,19,68,130
269,Brad Miller,C,23,CHH,55,4,961,135,293,0,2,135,291,153,195,113,180,293,45,23,35,48,111,423
270,Oliver Miller,C,29,PHO,51,9,1088,137,233,0,0,137,233,49,73,87,174,261,68,42,80,74,132,323
271,Reggie Miller*,SG,34,IND,81,81,2987,466,1041,165,404,301,637,373,406,50,189,239,187,85,25,129,126,1470
272,Chris Mills,SF,30,GSW,20,11,649,123,292,8,30,115,262,68,84,46,77,123,47,18,4,25,60,322
273,Terry Mills,PF,32,DET,82,78,1842,214,488,95,242,119,246,25,34,50,340,390,85,38,24,46,242,548
274,Jason Miskiri,PG,24,CHH,1,0,3,0,1,0,1,0,0,0,0,0,0,0,1,0,0,0,2,0
275,Sam Mitchell,SF,36,MIN,66,24,1227,168,376,10,23,158,353,81,92,28,110,138,111,27,14,44,116,427
276,Cuttino Mobley,SG,24,HOU,81,8,2496,437,1016,104,292,333,724,299,353,59,229,288,208,87,32,186,171,1277
277,Nazr Mohammed,C,22,PHI,28,3,190,21,54,0,0,21,54,12,22,16,34,50,2,4,12,18,29,54
278,Eric Montross,C,28,DET,51,0,332,17,55,0,0,17,55,6,12,18,54,72,7,6,9,22,81,40
279,Mikki Moore,C,24,DET,29,0,488,87,140,0,0,87,140,54,68,44,68,112,17,9,31,23,104,228
280,Alonzo Mourning*,C,29,MIA,79,78,2748,652,1184,0,4,652,1180,414,582,215,538,753,123,40,294,217,308,1718
281,Chris Mullin*,SG,36,IND,47,2,582,80,187,45,110,35,77,37,41,14,62,76,37,28,9,28,60,242
282,Eric Murdock,PG,31,LAC,40,15,693,79,205,16,42,63,163,51,80,15,62,77,108,47,5,58,67,225
283,Gheorghe Mureșan,C,28,NJN,30,2,267,41,90,0,0,41,90,23,38,24,44,68,9,0,12,16,52,105
284,Lamond Murray,SF,26,CLE,74,72,2365,460,1019,51,139,409,880,204,268,127,296,423,132,105,36,184,208,1175
285,Tracy Murray,SF,28,WAS,80,8,1831,290,670,113,263,177,407,120,141,63,208,271,72,45,24,84,185,813
286,Dikembe Mutombo*,C,33,ATL,82,82,2984,322,573,0,0,322,573,298,421,304,853,1157,105,27,269,174,248,942
287,Steve Nash*,PG,25,DAL,56,27,1532,173,363,60,149,113,214,75,85,34,87,121,272,37,3,102,122,481
288,Tyrone Nesby,SG,24,LAC,73,39,2317,364,915,94,281,270,634,151,191,82,193,275,121,75,31,102,205,973
289,Rasho Nesterović,C,23,MIN,82,55,1723,206,433,0,2,206,431,59,103,135,244,379,93,21,85,71,262,471
290,Johnny Newman,SF,36,NJN,82,9,1763,278,623,72,190,206,433,192,229,39,115,154,65,53,11,89,207,820
291,Moochie Norris,PG,26,HOU,30,0,502,69,159,12,29,57,130,57,73,16,52,68,94,23,1,30,32,207
292,Dirk Nowitzki,PF,21,DAL,82,81,2938,515,1118,116,306,399,812,289,348,102,430,532,203,63,68,141,256,1435
293,Jermaine O'Neal,C,21,POR,70,8,859,108,222,0,1,108,221,57,98,97,132,229,18,11,55,47,127,273
294,Shaquille O'Neal*,C,27,LAL,79,79,3163,956,1665,0,1,956,1664,432,824,336,742,1078,299,36,239,223,255,2344
295,Charles Oakley,PF,36,TOR,80,80,2431,234,560,14,41,220,519,66,85,117,423,540,253,102,45,154,294,548
296,Lamar Odom,SF,20,LAC,76,70,2767,449,1024,59,164,390,860,302,420,159,436,595,317,91,95,258,291,1259
297,Hakeem Olajuwon*,C,37,HOU,44,28,1049,193,421,0,2,193,419,69,112,65,209,274,61,41,70,73,88,455
298,Kevin Ollie,PG,27,PHI,40,0,290,22,49,0,0,22,49,28,37,4,27,31,46,10,0,10,27,72
299,Michael Olowokandi,C,24,LAC,80,77,2493,330,756,0,0,330,756,123,189,194,462,656,38,35,140,177,304,783
300,Greg Ostertag,C,26,UTA,81,3,1606,124,267,0,1,124,266,119,187,172,310,482,18,20,172,79,196,367
301,Bo Outlaw,PF,28,ORL,82,55,2326,204,339,0,3,204,336,82,162,202,323,525,245,113,148,133,203,490
302,Doug Overton,PG,30,BOS,48,0,432,61,154,10,28,51,126,20,21,14,19,33,53,10,0,20,46,152
304,Robert Pack,PG,30,DAL,29,22,665,96,230,4,11,92,219,63,78,7,35,42,168,31,3,76,44,259
305,Scott Padgett,PF,23,UTA,47,9,432,44,140,13,44,31,96,19,27,24,64,88,25,14,8,22,55,120
306,Milt Palacio,PG,21,VAN,53,0,394,43,98,0,2,43,96,22,37,17,34,51,48,20,0,44,32,108
307,Anthony Parker,SG,24,ORL,16,0,185,24,57,1,14,23,43,8,11,5,22,27,10,8,4,11,13,57
308,Cherokee Parks,C,27,VAN,56,14,808,72,145,0,1,72,144,24,37,55,128,183,35,29,45,28,115,168
309,Andrae Patterson,PF,24,MIN,5,0,20,3,4,0,0,3,4,0,0,1,1,2,1,1,0,1,4,6
310,Ruben Patterson,SF,24,SEA,81,74,2097,354,661,12,27,342,634,222,321,218,216,434,126,94,40,144,190,942
311,Gary Payton*,PG,31,SEA,82,82,3425,747,1666,177,520,570,1146,311,423,100,429,529,732,153,18,224,178,1982
312,Anthony Peeler,SG,30,MIN,82,22,2073,316,725,85,255,231,470,87,109,58,174,232,195,62,10,85,171,804
313,Will Perdue,C,34,CHI,67,15,1012,59,168,0,0,59,168,50,105,88,174,262,65,14,42,78,126,168
314,Sam Perkins,PF,38,IND,81,0,1620,184,441,89,218,95,223,80,97,64,225,289,68,31,33,63,136,537
315,Elliot Perry,PG,30,NJN,60,5,803,128,294,11,39,117,255,50,62,13,48,61,139,39,1,60,47,317
316,Chuck Person,SF,35,SEA,37,0,340,37,123,24,95,13,28,4,8,6,47,53,22,5,2,12,56,102
317,Wesley Person,SG,28,CLE,79,38,2056,280,654,106,250,174,404,61,77,44,223,267,146,40,19,60,119,727
318,Bobby Phills,SG,30,CHH,28,9,825,152,335,30,91,122,244,47,65,17,54,71,79,41,8,48,72,381
319,Eric Piatkowski,SF,29,LAC,75,23,1712,238,573,93,243,145,330,85,100,74,148,222,81,44,13,57,140,654
320,Paul Pierce,SF,22,BOS,73,72,2583,486,1099,96,280,390,819,359,450,83,313,396,221,152,62,178,237,1427
321,Scottie Pippen*,SF,34,POR,82,82,2749,388,860,86,263,302,597,160,223,114,399,513,406,117,41,208,208,1022
322,Scot Pollard,C,24,SAC,76,5,1336,149,283,0,0,149,283,114,159,168,236,404,43,55,59,50,213,412
323,Olden Polynice,C,35,UTA,82,79,1819,203,398,1,2,202,396,28,90,166,287,453,37,30,84,70,260,435
324,Terry Porter,PG,36,SAS,68,8,1613,207,463,90,207,117,256,137,170,24,167,191,221,50,9,100,79,641
325,James Posey,SF,23,DEN,81,77,2052,230,536,82,220,148,316,120,150,85,232,317,146,98,33,95,207,662
326,Vitaly Potapenko,C,24,BOS,79,72,1797,307,615,0,1,307,614,109,160,182,317,499,77,41,29,145,239,723
327,Brent Price,PG,31,VAN,41,0,424,41,119,25,68,16,51,34,39,8,29,37,69,17,1,47,63,141
328,Laron Profit,SG,22,WAS,33,1,225,21,59,3,17,18,42,4,10,2,24,26,25,7,4,19,26,49
329,Aleksandar Radojević,C,23,TOR,3,0,24,2,7,0,0,2,7,3,6,2,6,8,1,2,1,5,5,7
330,Theo Ratliff,PF,26,PHI,57,56,1795,247,491,0,0,247,491,182,236,140,295,435,36,32,171,108,185,676
331,Eldridge Recasner,PG,32,CHH,7,0,28,3,7,1,4,2,3,0,0,0,4,4,5,0,0,0,1,7
332,Bryant Reeves,C,26,VAN,69,67,1773,252,562,0,4,252,558,107,165,126,264,390,82,33,38,119,245,611
333,Khalid Reeves,PG,27,CHI,3,0,48,3,12,0,3,3,9,5,5,2,2,4,13,2,0,6,8,11
334,Don Reid,PF,26,TOT,38,3,498,60,112,0,0,60,112,24,34,31,71,102,11,24,31,23,118,144
335,J.R. Reid,PF,31,MIL,34,7,602,53,127,1,7,52,120,43,56,29,88,117,18,19,5,20,81,150
336,Rodrick Rhodes,SF,26,DAL,1,0,8,0,3,0,0,0,3,0,0,1,0,1,0,2,0,2,0,0
337,Glen Rice,SF,32,LAL,80,80,2530,421,980,84,229,337,751,346,396,56,271,327,176,47,12,114,179,1272
338,Mitch Richmond*,SG,34,WAS,74,69,2397,447,1049,93,241,354,808,298,340,37,176,213,185,110,13,154,191,1285
339,Isaiah Rider,SG,28,ATL,60,47,2084,449,1072,56,180,393,892,204,260,63,195,258,219,41,6,168,132,1158
340,Stanley Roberts,C,29,PHI,5,1,51,5,16,0,1,5,15,0,3,6,9,15,3,1,1,2,15,10
341,Ryan Robertson,SG,23,SAC,1,0,25,2,6,0,2,2,4,1,1,0,0,0,0,0,0,0,0,5
342,Clifford Robinson,SF,33,PHO,80,67,2839,530,1142,120,324,410,818,298,381,105,254,359,224,90,61,166,239,1478
343,David Robinson*,C,34,SAS,80,80,2557,528,1031,0,2,528,1029,371,511,193,577,770,142,97,183,164,247,1427
344,Eddie Robinson,SF,23,CHH,67,8,1112,212,386,0,4,212,382,47,64,54,130,184,32,48,25,39,67,471
345,Glenn Robinson,SF,27,MIL,81,81,2909,690,1461,86,237,604,1224,227,283,107,378,485,193,78,41,223,212,1693
346,Dennis Rodman*,PF,38,DAL,12,12,389,12,31,0,1,12,30,10,14,48,123,171,14,2,1,19,41,34
347,Carlos Rogers,C,28,HOU,53,15,1101,170,324,1,14,169,310,81,137,98,177,275,42,14,34,63,77,422
348,Rodney Rogers,PF,28,PHO,82,7,2286,428,881,115,262,313,619,159,249,138,309,447,170,94,47,163,290,1130
349,Roy Rogers,PF,26,DEN,40,0,355,35,88,0,1,35,87,19,41,33,47,80,9,2,38,10,36,89
350,Sean Rooks,C,30,DAL,71,13,1001,122,283,0,0,122,283,65,89,82,166,248,68,29,52,70,169,309
351,Jalen Rose,SF,27,IND,80,80,2978,563,1196,77,196,486,1000,254,307,42,345,387,320,84,49,188,234,1457
352,Malik Rose,PF,25,SAS,74,3,1341,176,385,1,3,175,382,143,198,133,202,335,47,35,52,99,232,496
353,Michael Ruffin,PF,23,CHI,71,6,975,58,138,0,0,58,138,43,88,117,133,250,44,26,26,59,170,159
354,Bryon Russell,SF,29,UTA,82,70,2900,408,914,106,268,302,646,237,316,99,328,427,158,128,23,101,255,1159
355,Arvydas Sabonis*,C,35,POR,66,61,1688,302,598,7,19,295,579,167,198,97,416,513,118,43,78,97,184,778
356,John Salley,C,35,LAL,45,3,303,25,69,0,0,25,69,21,28,20,45,65,26,8,14,18,67,71
357,Detlef Schrempf,SF,37,POR,77,6,1662,187,433,21,52,166,381,179,215,79,253,332,197,37,17,100,182,574
358,Dennis Scott,SF,31,VAN,66,0,1263,125,333,71,189,54,144,48,57,16,90,106,69,28,9,30,104,369
359,Malik Sealy,SF,29,MIN,82,61,2392,371,780,10,35,361,745,177,218,119,233,352,197,76,19,110,197,929
360,Brian Shaw,SG,33,LAL,74,2,1249,123,322,18,58,105,264,41,54,45,171,216,201,35,14,75,105,305
361,Dickey Simpkins,PF,27,CHI,69,48,1651,111,274,0,1,111,273,65,120,124,248,372,100,22,22,128,217,287
362,Brian Skinner,PF,23,LAC,33,9,775,68,134,0,0,68,134,43,65,63,138,201,11,16,44,37,75,179
363,Joe Smith,C,24,MIN,78,9,1975,289,623,1,1,288,622,195,258,186,298,484,88,45,85,119,302,774
364,Michael Smith,SF,27,WAS,46,46,1145,108,192,0,1,108,191,73,101,121,210,331,56,27,23,45,127,289
365,Steve Smith,SG,30,POR,82,81,2689,420,900,96,241,324,659,289,340,123,190,313,209,71,31,117,214,1225
366,Rik Smits,C,33,IND,79,79,1852,431,890,0,1,431,889,156,211,94,307,401,85,20,100,108,249,1018
367,Eric Snow,PG,26,PHI,82,80,2866,257,597,11,45,246,552,126,177,42,219,261,624,140,8,162,243,651
368,Felton Spencer,C,32,SAS,26,0,149,15,33,0,0,15,33,20,30,15,24,39,3,6,8,9,32,50
369,Latrell Sprewell,SF,29,NYK,82,82,3276,568,1305,44,127,524,1178,344,397,49,300,349,332,109,22,226,184,1524
370,Ryan Stack,PF,24,CLE,25,0,198,17,51,0,1,17,50,18,27,15,30,45,5,4,11,17,47,52
371,Jerry Stackhouse,SG,25,DET,82,82,3148,619,1447,83,288,536,1159,618,758,118,197,315,365,103,36,311,188,1939
372,John Starks,SG,34,TOT,37,30,1190,203,542,59,171,144,371,50,59,10,91,101,181,42,4,67,102,515
373,Vladimir Stepania,C,23,SEA,30,1,202,29,79,0,6,29,73,17,36,21,26,47,3,10,11,22,44,75
374,Joe Stephens,SF,27,VAN,13,0,181,19,51,0,8,19,43,3,4,13,23,36,11,7,3,6,9,41
375,Michael Stewart,C,24,TOR,42,1,389,20,53,0,0,20,53,18,32,33,61,94,6,5,19,17,81,58
376,Bryant Stith,SG,29,DEN,45,6,691,86,189,17,56,69,133,64,77,23,61,84,61,18,12,33,56,253
377,John Stockton*,PG,37,UTA,82,82,2432,363,725,43,121,320,604,221,257,45,170,215,703,143,15,179,192,990
378,Peja Stojaković,SF,22,SAC,74,11,1749,321,717,100,267,221,450,135,153,74,202,276,106,52,7,88,97,877
379,Damon Stoudamire,PG,26,POR,78,78,2372,386,894,80,212,306,682,122,145,61,182,243,405,77,1,149,173,974
380,Erick Strickland,SG,26,DAL,68,67,2025,316,730,73,186,243,544,162,195,69,254,323,211,105,13,102,190,867
381,Mark Strickland,SF,29,MIA,58,5,663,122,224,0,0,122,224,40,56,44,96,140,22,15,18,24,68,284
382,Rod Strickland,PG,33,WAS,69,67,2188,327,762,1,21,326,741,214,305,73,186,259,519,94,18,187,147,869
383,Derek Strong,PF,31,ORL,20,0,148,21,48,1,4,20,44,11,14,11,33,44,4,5,2,12,15,54
384,Bruno Šundov,C,19,DAL,14,0,61,12,31,0,0,12,31,2,2,5,7,12,2,2,2,4,16,26
385,Bob Sura,SG,26,CLE,73,45,2216,356,815,122,332,234,483,175,251,50,238,288,284,91,19,148,201,1009
386,Wally Szczerbiak,SF,22,MIN,73,53,2171,342,669,28,78,314,591,133,161,89,183,272,201,58,23,83,175,845
387,Žan Tabak,C,29,IND,18,0,114,16,34,0,0,16,34,5,8,16,16,32,4,3,9,11,13,37
388,Johnny Taylor,SF,25,TOT,6,0,34,5,14,1,1,4,13,0,0,2,4,6,1,1,1,2,5,11
389,Maurice Taylor,PF,23,LAC,62,60,2227,458,988,1,8,457,980,143,201,96,304,400,101,51,48,169,217,1060
390,Jason Terry,PG,22,ATL,81,27,1888,249,600,46,157,203,443,113,140,24,142,166,346,90,10,156,133,657
391,Jamel Thomas,SF,26,TOT,7,0,46,8,18,0,3,8,15,1,1,1,4,5,6,1,0,5,2,17
392,John Thomas,C,24,TOR,55,6,477,49,107,0,1,49,106,16,41,37,38,75,9,12,14,14,106,114
393,Kenny Thomas,PF,22,HOU,72,29,1797,212,531,32,122,180,409,138,209,147,290,437,113,54,22,112,167,594
394,Kurt Thomas,PF,27,NYK,80,21,1971,270,535,1,3,269,532,100,128,144,361,505,82,51,42,105,278,641
395,Tim Thomas,SF,22,MIL,80,1,2093,347,753,63,182,284,571,188,243,100,232,332,113,59,31,129,227,945
396,Otis Thorpe,PF,37,MIA,51,1,777,125,243,0,3,125,240,29,48,56,110,166,33,26,9,59,136,279
397,Robert Traylor,PF,22,MIL,44,16,447,58,122,0,4,58,118,41,68,50,65,115,20,25,25,27,79,157
398,Gary Trent,SF,25,DAL,11,11,301,70,142,0,2,70,140,11,21,20,32,52,22,8,3,25,28,151
399,Mirsad Türkcan,PF,23,TOT,17,0,90,14,38,0,6,14,32,5,8,13,20,33,5,3,1,8,14,33
400,Wayne Turner,PG,23,BOS,3,0,41,1,6,0,0,1,6,2,6,1,2,3,5,0,0,3,4,4
401,Nick Van Exel,PG,28,DEN,79,79,2950,473,1213,133,401,340,812,196,240,34,277,311,714,68,11,221,148,1275
402,Keith Van Horn,PF,24,NJN,80,80,2782,559,1257,84,228,475,1029,333,393,200,476,676,158,64,60,245,258,1535
403,Jacque Vaughn,PG,24,UTA,78,0,884,109,262,14,34,95,228,57,76,11,54,65,121,32,0,77,92,289
404,Loy Vaught,PF,31,DET,43,0,292,32,89,0,3,32,86,11,16,26,65,91,11,6,4,11,45,75
405,Fred Vinson,SG,29,SEA,8,0,40,5,17,2,7,3,10,1,2,0,1,1,0,3,0,4,2,13
406,Antoine Walker,PF,23,BOS,82,82,3003,648,1506,73,285,575,1221,311,445,199,453,652,305,117,32,259,263,1680
407,Samaki Walker,PF,23,SAS,71,7,980,137,305,0,0,137,305,86,126,77,195,272,38,10,35,64,108,360
408,Ben Wallace,PF,25,ORL,81,81,1959,168,334,0,0,168,334,54,114,211,454,665,67,72,130,67,162,390
409,John Wallace,SF,25,NYK,60,0,798,155,332,0,3,155,329,82,102,42,93,135,22,10,14,63,103,392
410,Rasheed Wallace,PF,25,POR,81,77,2845,542,1045,8,50,534,995,233,331,129,437,566,142,87,107,157,216,1325
411,Rex Walters,PG,29,MIA,33,0,389,38,91,5,20,33,71,12,16,8,28,36,65,6,0,29,44,93
412,Charlie Ward,PG,29,NYK,72,69,1986,189,447,102,264,87,183,48,58,22,206,228,300,95,16,102,176,528
413,Clarence Weatherspoon,PF,29,MIA,78,2,1615,215,419,0,0,215,419,135,183,128,321,449,93,51,49,100,165,565
414,Chris Webber,PF,26,SAC,75,75,2880,748,1548,27,95,721,1453,311,414,189,598,787,345,120,128,218,264,1834
415,Bonzi Wells,SF,23,POR,66,0,1162,236,480,20,53,216,427,88,129,78,104,182,97,69,12,97,153,580
416,Bill Wennington,C,36,SAC,7,0,57,6,19,0,0,6,19,2,2,5,14,19,1,2,2,1,13,14
417,David Wesley,PG,29,CHH,82,82,2760,407,955,88,248,319,707,214,275,39,186,225,463,109,11,159,186,1116
418,Doug West,SG,32,VAN,38,0,581,59,145,0,3,59,142,34,40,18,53,71,43,12,8,19,80,152
419,Mark West,C,39,PHO,22,2,127,5,12,0,0,5,12,5,8,6,25,31,2,2,4,6,23,15
420,Jahidi White,C,23,WAS,80,59,1537,228,450,0,0,228,450,113,211,202,351,553,15,31,83,94,234,569
421,Chris Whitney,PG,28,WAS,82,15,1627,217,521,96,255,121,266,112,132,20,114,134,313,55,5,107,166,642
422,Aaron Williams,PF,28,WAS,81,0,1545,235,450,0,3,235,447,146,201,159,250,409,58,41,92,80,234,616
423,Alvin Williams,PG,25,TOR,55,28,779,114,287,16,55,98,232,48,65,27,58,85,126,34,11,47,78,292
424,Eric Williams,SF,27,BOS,68,17,1378,165,386,25,72,140,314,134,169,55,101,156,93,44,16,66,165,489
425,Jason Williams,PG,24,SAC,81,81,2760,363,973,145,505,218,468,128,170,22,208,230,589,117,8,296,140,999
426,Jerome Williams,PF,26,DET,82,1,2102,257,456,0,3,257,453,175,284,277,512,789,68,95,21,105,196,689
427,Lorenzo Williams,PF,30,WAS,8,0,76,7,9,0,0,7,9,0,0,12,13,25,1,3,6,3,13,14
428,Monty Williams,SF,28,ORL,75,23,1501,263,538,2,5,261,533,123,166,96,154,250,106,46,17,109,187,651
429,Scott Williams,C,31,MIL,68,46,1488,213,426,0,0,213,426,94,129,177,271,448,28,40,66,65,230,520
430,Shammond Williams,PG,24,SEA,43,5,517,84,225,24,81,60,144,33,51,12,40,52,78,18,0,40,39,225
431,Walt Williams,SF,29,HOU,76,66,1859,312,681,102,261,210,420,101,123,69,237,306,157,49,44,113,190,827
432,Corliss Williamson,SF,26,SAC,76,76,1707,311,622,0,0,311,622,163,212,122,168,290,82,38,19,110,192,785
433,Kevin Willis,PF,37,TOR,79,1,1679,236,569,1,3,235,566,131,164,201,281,482,49,36,48,98,256,604
434,Dedric Willoughby,PG,25,CHI,25,1,508,61,179,29,98,32,81,39,51,11,40,51,66,23,2,37,32,190
435,David Wingate,SG,36,NYK,7,0,32,1,9,0,0,1,9,0,0,1,1,2,3,1,2,2,7,2
436,Haywoode Workman,PG,34,TOT,36,2,350,31,90,14,43,17,47,10,15,1,25,26,61,20,0,18,37,86
437,Metta World Peace,SF,20,CHI,72,63,2238,309,759,60,191,249,568,188,279,62,246,308,202,119,39,166,159,866
438,Lorenzen Wright,C,24,ATL,75,0,1205,180,361,1,3,179,358,87,135,117,188,305,21,29,40,66,203,448
439,Tim Young,C,23,GSW,25,0,137,13,39,0,0,13,39,28,36,13,22,35,5,2,1,9,18,54
1,Mahmoud Abdul-Rauf,PG,31,VAN,41,0,486,120,246,4,14,116,232,22,29,5,20,25,76,9,1,26,50,266
2,Tariq Abdul-Wahad,SG,26,DEN,29,12,420,43,111,4,10,39,101,21,36,14,45,59,22,14,13,34,54,111
3,Shareef Abdur-Rahim,SF,24,VAN,81,81,3241,604,1280,12,64,592,1216,443,531,175,560,735,250,90,77,231,238,1663
4,Cory Alexander,PG,27,ORL,26,0,227,18,56,4,16,14,40,12,18,0,25,25,36,16,0,25,29,52
5,Courtney Alexander,PG,23,TOT,65,24,1382,239,573,17,46,222,527,123,150,42,101,143,62,45,5,75,139,618
6,Ray Allen*,SG,25,MIL,82,82,3129,628,1309,202,467,426,842,348,392,101,327,428,374,124,20,204,192,1806
7,Rafer Alston,PG,24,MIL,37,2,288,30,84,8,30,22,54,9,13,4,27,31,68,13,0,20,27,77
8,John Amaechi,C,30,ORL,82,36,1710,237,592,0,7,237,585,176,279,77,191,268,74,28,29,124,175,650
9,Derek Anderson,SG,26,SAS,82,82,2859,413,993,101,253,312,740,342,402,75,288,363,301,120,14,165,188,1269
10,Kenny Anderson,PG,30,BOS,33,28,849,88,227,11,33,77,194,59,71,16,57,73,134,44,2,52,62,246
11,Nick Anderson,SG,33,SAC,21,0,169,14,57,10,39,4,18,0,0,3,22,25,13,10,4,7,13,38
12,Shandon Anderson,SG,27,HOU,82,82,2396,263,590,46,170,217,420,138,188,72,261,333,189,82,40,131,202,710
13,Greg Anthony,PG,33,POR,58,0,856,97,253,65,159,32,94,23,35,21,40,61,82,40,3,43,63,282
14,Darrell Armstrong,PG,32,ORL,75,75,2767,413,1002,143,403,270,599,220,249,94,249,343,524,135,13,200,155,1189
15,Chucky Atkins,PG,26,DET,81,75,2363,380,952,121,339,259,613,90,130,28,145,173,330,67,5,149,184,971
16,Stacey Augmon,SG,32,POR,66,23,1182,127,266,0,4,127,262,57,87,60,99,159,98,48,21,48,105,311
17,Isaac Austin,C,31,VAN,52,16,845,96,270,6,24,90,246,28,40,50,172,222,58,20,23,54,94,226
18,William Avery,PG,21,MIN,55,0,463,55,144,16,59,39,85,28,36,5,24,29,75,13,4,45,48,154
19,Dalibor Bagarić,C,20,CHI,35,0,259,17,65,0,1,17,64,13,28,22,34,56,10,9,16,21,44,47
20,Vin Baker,PF,29,SEA,76,27,2129,347,822,1,16,346,806,232,321,179,251,430,90,38,73,158,264,927
21,Erick Barkley,PG,22,POR,8,0,38,8,22,3,8,5,14,0,0,0,3,3,6,2,0,5,2,19
22,Dana Barros,PG,33,DET,60,0,1079,183,412,44,105,139,307,68,80,6,88,94,110,30,2,60,63,478
23,Brent Barry,SG,29,SEA,67,20,1778,198,401,109,229,89,172,84,103,33,178,211,225,80,14,86,126,589
24,Jon Barry,SG,31,SAC,62,2,1010,103,255,46,132,57,123,64,73,16,78,94,130,28,6,53,66,316
25,Tony Battie,C,24,BOS,40,25,845,108,201,0,3,108,198,44,69,73,160,233,16,27,60,37,126,260
26,Raja Bell,SG,24,PHI,5,0,30,2,7,1,3,1,4,0,0,0,1,1,0,1,0,2,1,5
27,Jonathan Bender,SF,20,IND,59,7,574,66,186,11,41,55,145,50,68,14,60,74,32,7,28,42,73,193
28,Corey Benjamin,PG,22,CHI,65,5,857,115,302,21,81,94,221,56,83,38,62,100,69,28,16,63,128,307
29,David Benoit,SF,32,UTA,49,2,446,71,147,5,13,66,134,31,39,20,61,81,22,6,6,28,75,178
30,Travis Best,PG,28,IND,77,21,2457,347,788,37,97,310,691,187,226,38,184,222,473,110,11,127,246,918
31,Mike Bibby,PG,22,VAN,82,82,3190,525,1157,108,285,417,872,143,188,47,257,304,685,107,12,248,148,1301
32,Chauncey Billups,SG,24,MIN,77,33,1790,248,587,73,194,175,393,144,171,32,126,158,260,51,11,111,178,713
33,Mookie Blaylock,PG,33,GSW,69,59,2352,317,801,73,225,244,576,53,76,71,201,272,462,163,20,128,134,760
34,Corie Blount,PF,32,TOT,68,6,1305,130,294,2,8,128,286,51,83,181,219,400,59,42,22,73,165,313
35,Mark Blount,C,25,BOS,64,50,1098,101,200,0,0,101,200,46,66,97,134,231,32,39,76,62,183,248
36,Muggsy Bogues,PG,36,TOR,3,0,34,0,2,0,1,0,1,0,0,0,3,3,5,2,0,4,3,0
37,Etdrick Bohannon,PF,27,CLE,6,0,19,2,4,0,0,2,4,4,4,3,4,7,0,0,2,1,4,8
38,Calvin Booth,C,24,TOT,55,29,933,120,252,0,0,120,252,53,78,77,169,246,42,29,111,53,146,293
39,Cal Bowdler,SF,23,ATL,44,0,375,53,114,1,5,52,109,33,40,30,47,77,4,10,21,11,45,140
40,Bruce Bowen,SF,29,MIA,82,72,2685,211,581,103,307,108,274,98,161,45,200,245,132,83,53,74,269,623
41,Ryan Bowen,SF,25,DEN,57,0,696,80,144,4,11,76,133,27,44,62,51,113,30,37,12,24,95,191
42,Ira Bowman,PG,27,ATL,3,0,19,0,2,0,0,0,2,0,0,1,1,2,7,0,0,1,0,0
43,Earl Boykins,PG,24,LAC,10,0,149,25,63,1,8,24,55,14,17,4,7,11,32,5,0,9,9,65
44,Shawn Bradley,C,28,DAL,82,35,2001,219,447,1,6,218,441,140,178,160,448,608,38,36,228,88,256,579
45,Elton Brand,PF,21,CHI,74,74,2906,578,1215,0,2,578,1213,334,472,285,461,746,240,71,118,219,243,1490
46,Terrell Brandon,PG,30,MIN,78,78,2821,511,1134,33,91,478,1043,195,224,60,238,298,583,161,21,155,138,1250
47,Chucky Brown,SF,32,TOT,26,2,339,40,95,0,3,40,92,22,34,8,46,54,11,9,7,8,37,102
48,Dee Brown,PG,32,ORL,7,0,155,16,44,12,32,4,12,4,5,0,11,11,12,4,0,7,10,48
49,P.J. Brown,C,31,CHH,80,79,2811,249,561,0,4,249,557,178,209,257,485,742,127,78,92,108,260,676
50,Randy Brown,PG,32,BOS,54,35,1238,100,237,0,3,100,234,23,40,23,76,99,154,62,10,56,132,223
51,Rick Brunson,PG,28,TOT,22,0,208,18,54,2,14,16,40,8,15,5,16,21,31,8,1,17,21,46
52,Kobe Bryant,SG,22,LAL,68,68,2783,701,1510,61,200,640,1310,475,557,104,295,399,338,114,43,220,222,1938
53,Mark Bryant,PF,35,DAL,18,1,101,8,20,0,0,8,20,3,5,4,17,21,3,1,2,5,29,19
54,Greg Buckner,SG,24,DAL,37,9,820,84,192,2,7,82,185,59,81,60,97,157,49,33,9,27,118,229
55,Jud Buechler,SF,32,DET,57,3,737,76,164,32,77,44,87,9,12,20,74,94,39,21,10,25,83,193
56,Rodney Buford,SF,23,PHI,47,0,573,104,241,16,38,88,203,24,29,16,58,74,17,17,6,29,68,248
57,Matt Bullard,PF,33,HOU,61,5,1000,129,305,86,213,43,92,10,14,22,108,130,42,10,9,12,76,354
58,Scott Burrell,SF,30,CHH,4,0,41,7,15,2,6,5,9,1,4,1,2,3,1,3,0,0,8,17
59,Jason Caffey,PF,27,MIL,70,33,1460,179,367,0,0,179,367,142,211,135,218,353,53,38,25,77,184,500
60,Marcus Camby,C,26,NYK,63,63,2127,304,580,1,8,303,572,150,225,196,527,723,52,66,136,63,205,759
61,Elden Campbell,PF,32,CHH,78,78,2337,367,834,0,6,367,828,288,406,157,451,608,104,60,140,144,280,1022
62,Brian Cardinal,PF,23,DET,15,0,126,10,31,0,5,10,26,11,18,8,15,23,3,7,2,9,27,31
63,Chris Carr,SG,26,BOS,35,0,309,53,112,17,37,36,75,46,60,11,33,44,11,4,3,19,45,169
64,Anthony Carter,PG,25,MIA,72,6,1630,195,480,6,40,189,440,65,103,46,134,180,268,73,10,119,154,461
65,Vince Carter,SF,24,TOR,75,75,2979,762,1656,162,397,600,1259,384,502,176,240,416,291,114,82,167,205,2070
66,Sam Cassell,PG,31,MIL,76,75,2709,537,1132,30,98,507,1034,277,323,46,244,290,580,88,8,220,214,1381
67,Kelvin Cato,C,26,HOU,35,13,624,64,111,0,0,64,111,37,57,47,94,141,11,13,31,25,89,165
68,Duane Causwell,C,32,MIA,31,14,384,32,85,0,0,32,85,12,25,23,60,83,5,8,18,23,67,76
69,Cedric Ceballos,SF,31,TOT,40,0,559,101,229,22,73,79,156,37,43,34,72,106,20,16,7,32,61,261
70,Calbert Cheaney,SG,29,DEN,9,5,153,10,30,0,0,10,30,1,2,5,15,20,9,4,2,5,14,21
71,Chris Childs,PG,33,TOT,77,5,1859,135,335,32,106,103,229,60,71,24,178,202,355,59,15,156,242,362
72,Doug Christie,SG,30,SAC,81,81,2939,311,788,94,250,217,538,280,312,95,260,355,289,183,45,154,224,996
73,Keon Clark,PF,25,TOT,81,3,1720,249,519,0,1,249,518,142,240,136,298,434,72,32,154,90,244,640
74,Mateen Cleaves,PG,23,DET,78,8,1268,160,400,5,17,155,383,97,137,26,106,132,207,49,1,139,153,422
75,John Coker,C,29,GSW,6,0,32,1,8,0,0,1,8,0,0,3,2,5,2,1,0,2,4,2
76,Derrick Coleman,PF,33,CHH,34,3,683,97,255,20,51,77,204,63,92,46,138,184,39,10,21,42,53,277
77,Bimbo Coles,PG,32,CLE,47,0,804,91,239,2,16,89,223,48,56,9,39,48,138,27,6,59,87,232
78,Jason Collier,C,23,HOU,23,0,222,27,71,0,1,27,70,17,24,12,25,37,6,2,3,11,27,71
79,Sean Colson,PG,25,TOT,13,0,44,6,24,1,5,5,19,2,4,2,4,6,10,1,0,2,6,15
80,Tyrone Corbin,SF,38,TOR,15,1,117,9,38,0,5,9,33,2,4,3,10,13,4,2,0,3,18,20
81,Chris Crawford,PF,25,ATL,47,22,901,122,270,6,22,116,248,68,83,28,82,110,37,21,16,62,117,318
82,Jamal Crawford,PG,20,CHI,61,8,1050,107,304,41,117,66,187,27,34,9,80,89,141,43,14,85,68,282
83,Austin Croshere,PF,25,IND,81,23,1874,276,701,70,207,206,494,200,231,123,264,387,92,36,50,136,180,822
84,John Crotty,PG,31,UTA,31,0,264,22,65,4,7,18,58,17,19,13,15,28,34,6,0,19,32,65
85,Vonteego Cummings,PG,24,GSW,66,11,1495,178,517,48,143,130,374,79,116,47,90,137,227,67,14,91,160,483
86,Bill Curley,PF,28,TOT,20,2,192,25,47,1,2,24,45,12,19,21,16,37,3,7,9,16,45,63
87,Dell Curry,SG,36,TOR,71,1,956,162,382,62,145,100,237,43,51,16,69,85,75,27,8,39,66,429
88,Michael Curry,SG,32,DET,68,58,1485,145,319,4,9,141,310,62,73,21,100,121,132,27,3,61,173,356
89,Erick Dampier,C,25,GSW,43,26,1038,126,314,0,2,126,312,67,126,97,153,250,59,17,58,82,123,319
90,Antonio Daniels,PG,25,SAS,79,23,2060,275,588,74,183,201,405,121,156,26,137,163,304,61,14,109,120,745
91,Kornél Dávid,SF,29,TOT,27,0,209,25,51,0,0,25,51,12,13,15,37,52,7,6,4,11,28,62
92,Antonio Davis,C,32,TOR,78,77,2729,375,866,0,1,375,865,319,423,274,513,787,106,22,151,135,230,1069
93,Baron Davis,PG,21,CHH,82,82,3192,409,957,85,274,324,683,228,337,129,279,408,598,170,36,226,267,1131
94,Dale Davis,C,31,POR,81,43,2162,242,487,0,4,242,483,96,152,233,373,606,103,44,76,67,199,580
95,Emanual Davis,SG,32,SEA,62,39,1290,133,318,50,127,83,191,45,55,28,126,154,137,64,12,77,101,361
96,Hubert Davis,PG,30,TOT,66,18,1692,196,433,78,171,118,262,54,62,28,111,139,110,35,1,81,121,524
97,Ricky Davis,SG,21,MIA,7,0,70,12,29,1,1,11,28,7,8,1,6,7,11,5,2,5,7,32
98,Terry Davis,PF,33,DEN,19,1,228,12,25,0,0,12,25,9,22,24,29,53,7,1,1,5,34,33
99,Todd Day,SG,31,MIN,31,0,345,44,118,26,69,18,49,18,23,10,27,37,28,10,7,24,52,132
100,Andrew DeClercq,C,27,ORL,67,51,903,107,193,0,0,107,193,47,82,91,145,236,32,41,33,51,198,261
101,Vinny Del Negro,PG,34,TOT,65,1,922,106,234,1,13,105,221,41,44,12,70,82,126,26,3,34,78,254
102,Tony Delk,SG,27,PHO,82,11,2288,383,923,54,168,329,755,185,235,76,185,261,160,75,17,101,171,1005
103,Derrick Dial,SG,25,SAS,33,0,207,36,83,2,10,34,73,12,21,12,26,38,21,4,6,12,22,86
104,Michael Dickerson,SG,25,VAN,70,69,2618,425,1020,86,230,339,790,206,270,70,159,229,233,62,27,162,207,1142
105,Vlade Divac*,C,32,SAC,81,81,2420,364,755,4,14,360,741,242,350,207,466,673,231,87,93,192,242,974
106,Michael Doleac,C,23,ORL,77,21,1398,220,527,0,3,220,524,50,59,70,203,273,65,37,41,59,239,490
107,Keyon Dooling,PG,20,LAC,76,1,1237,148,362,28,80,120,282,125,179,8,81,89,177,41,11,94,107,449
108,Sherman Douglas,PG,34,NJN,59,7,1094,122,303,8,40,114,263,86,115,21,53,74,144,36,4,79,93,338
109,Bryce Drew,PG,26,CHI,48,41,1305,124,327,40,105,84,222,14,19,12,57,69,185,32,3,68,99,302
110,Chris Dudley,C,35,PHO,53,33,613,29,73,0,0,29,73,14,36,64,119,183,18,14,29,26,111,72
111,Tim Duncan,PF,24,SAS,82,82,3174,702,1406,7,27,695,1379,409,662,259,738,997,245,70,192,242,247,1820
112,Tyus Edney,PG,27,IND,24,0,263,35,91,1,6,34,85,35,39,5,19,24,54,17,0,25,17,106
113,Kevin Edwards,SG,35,VAN,46,5,634,56,170,5,19,51,151,43,53,23,59,82,52,29,8,37,46,160
114,Howard Eisley,SG,28,DAL,82,40,2426,265,675,107,269,158,406,104,126,23,174,197,295,99,12,102,218,741
115,Obinna Ekezie,PF,25,TOT,33,0,281,32,81,0,0,32,81,37,53,31,47,78,9,5,5,14,48,101
116,Khalid El-Amin,PG,21,CHI,50,14,936,115,311,28,84,87,227,56,72,21,60,81,145,48,2,54,99,314
117,Mario Elie,SG,37,PHO,68,67,1506,104,246,36,100,68,146,55,69,38,117,155,131,58,12,60,112,299
118,Sean Elliott,SF,32,SAS,52,34,1229,147,339,55,129,92,210,60,84,17,153,170,81,23,25,51,80,409
119,LaPhonso Ellis,PF,30,MIN,82,5,1948,298,642,7,22,291,620,169,214,199,295,494,93,67,74,108,290,772
120,Pervis Ellison,C,33,SEA,9,0,40,2,7,0,0,2,7,2,2,2,10,12,3,0,2,3,13,6
121,Evan Eschmeyer,C,25,NJN,74,51,1331,92,200,0,0,92,200,67,102,135,231,366,40,41,58,53,220,251
122,Patrick Ewing*,C,38,SEA,79,79,2107,294,684,0,2,294,682,172,251,124,461,585,92,53,91,151,229,760
123,Jamie Feick,C,26,NJN,6,0,149,8,23,0,0,8,23,6,12,12,44,56,5,8,3,7,15,22
124,Danny Ferry,SF,34,SAS,80,29,1688,178,375,70,156,108,219,22,30,55,168,223,71,28,21,50,169,448
125,Michael Finley,SF,27,DAL,82,82,3443,711,1552,91,263,620,1289,252,325,109,316,425,360,118,32,190,174,1765
126,Derek Fisher,PG,26,LAL,20,20,709,77,187,25,63,52,124,50,62,5,54,59,87,39,2,29,50,229
127,Marcus Fizer,PF,22,CHI,72,13,1580,278,646,10,39,268,607,117,161,76,237,313,76,30,19,124,175,683
128,Danny Fortson,PF,24,GSW,6,6,203,29,50,0,0,29,50,42,54,29,69,98,5,2,0,10,22,100
129,Greg Foster,C,32,LAL,62,8,451,56,133,3,9,53,124,10,14,29,83,112,32,9,12,25,76,125
130,Jeff Foster,C,24,IND,71,9,1152,100,213,2,7,98,206,47,91,144,245,389,33,39,28,52,152,249
131,Rick Fox,SF,31,LAL,82,77,2291,287,646,118,300,169,346,95,122,80,245,325,262,70,29,136,225,787
132,Adonal Foyle,C,25,GSW,58,37,1457,156,375,0,0,156,375,30,68,156,249,405,48,31,156,79,136,342
133,Steve Francis,PG,23,HOU,80,79,3194,550,1219,133,336,417,883,358,438,190,363,553,517,141,31,265,274,1591
134,Todd Fuller,C,26,MIA,10,0,77,10,35,0,0,10,35,8,8,7,11,18,1,3,2,3,10,28
135,Lawrence Funderburke,PF,30,SAC,59,2,698,120,242,0,0,120,242,48,77,74,122,196,17,9,13,32,44,288
136,Rubén Garcés,PF,27,TOT,13,0,73,7,22,0,0,7,22,2,8,16,13,29,5,3,2,5,14,16
137,Chris Garner,PG,25,GSW,8,0,149,7,37,0,7,7,30,5,6,2,10,12,18,7,1,9,18,19
138,Kevin Garnett,PF,24,MIN,81,81,3202,704,1475,19,66,685,1409,357,467,219,702,921,401,111,145,230,204,1784
139,Dean Garrett,C,34,MIN,70,21,831,75,156,0,0,75,156,27,39,65,152,217,24,26,49,25,93,177
140,Pat Garrity,SF,24,ORL,76,1,1579,223,576,97,224,126,352,85,98,51,159,210,51,40,15,68,241,628
141,Chris Gatling,PF,33,CLE,74,6,1670,329,733,28,92,301,641,156,228,99,292,391,61,52,27,119,185,842
142,Matt Geiger,C,31,PHI,35,4,542,88,224,0,2,88,222,37,54,50,89,139,14,12,8,25,73,213
143,Devean George,SF,23,LAL,59,1,593,64,207,15,68,49,139,39,55,35,75,110,19,15,15,34,87,182
144,Eddie Gill,PG,22,NJN,8,0,152,16,41,3,9,13,32,4,5,0,9,9,24,4,1,10,9,39
145,Kendall Gill,SG,32,NJN,31,26,892,107,323,4,14,103,309,65,90,32,99,131,87,47,7,48,64,283
146,Dion Glover,SG,22,ATL,57,7,929,141,336,9,46,132,290,47,69,39,92,131,69,49,10,54,92,338
147,Anthony Goldwire,PG,29,DEN,20,0,201,30,80,9,34,21,46,13,17,1,11,12,34,9,0,15,13,82
148,Steve Goodrich,PF,24,CHI,12,0,133,7,18,1,3,6,15,4,7,7,14,21,6,2,1,8,14,19
149,Brian Grant,C,28,MIA,82,79,2771,484,1010,0,1,484,1009,282,354,217,501,718,101,60,71,170,293,1250
150,Gary Grant,PG,35,POR,4,0,17,5,7,0,0,5,7,0,0,0,0,0,1,0,0,0,1,10
151,Horace Grant,PF,35,LAL,77,77,2390,263,569,0,3,263,566,131,169,220,325,545,121,51,61,48,181,657
152,A.C. Green,PF,37,MIA,82,1,1411,144,324,0,6,144,318,79,111,107,206,313,39,30,8,45,119,367
153,Adrian Griffin,SF,26,BOS,44,0,377,33,97,9,26,24,71,18,24,27,60,87,27,18,5,18,45,93
154,Tom Gugliotta,PF,31,PHO,57,2,1159,149,380,3,12,146,368,61,77,76,179,255,55,47,21,51,110,362
155,A.J. Guyton,PG,22,CHI,33,8,630,78,192,27,69,51,123,15,18,10,26,36,64,9,5,24,35,198
156,Darvin Ham,SF,27,MIL,29,13,540,39,80,2,3,37,77,29,49,56,65,121,25,17,21,33,85,109
157,Richard Hamilton,SF,22,WAS,78,42,2519,547,1249,40,146,507,1103,277,319,75,163,238,224,75,10,201,203,1411
158,Zendon Hamilton,C,25,LAC,3,0,19,2,9,0,0,2,9,5,8,3,5,8,0,0,0,2,4,9
159,Tom Hammonds,PF,33,MIN,7,0,30,3,10,0,0,3,10,1,2,2,2,4,1,0,0,3,8,7
160,Anfernee Hardaway,SG,29,PHO,4,4,112,15,36,2,8,13,28,7,11,5,13,18,15,6,1,3,6,39
161,Tim Hardaway,PG,34,MIA,77,77,2613,408,1042,189,517,219,525,145,181,26,178,204,483,90,6,189,155,1150
162,Ron Harper,PG,37,LAL,47,46,1139,127,271,19,72,108,199,34,48,46,120,166,113,39,25,62,70,307
163,Matt Harpring,SG,24,CLE,56,55,1615,238,524,13,52,225,472,134,165,90,152,242,102,42,17,90,161,623
164,Al Harrington,PF,20,IND,78,38,1892,241,543,1,7,240,536,103,157,119,262,381,130,63,18,148,223,586
165,Othella Harrington,C,27,TOT,74,45,1815,247,507,0,3,247,504,171,224,139,249,388,56,34,45,145,237,665
166,Lucious Harris,SG,30,NJN,73,50,2071,265,624,46,132,219,492,107,139,71,217,288,135,74,16,64,127,683
167,Jason Hart,PG,22,MIL,1,0,10,1,1,0,0,1,1,0,0,0,0,0,1,0,0,2,0,2
168,Antonio Harvey,PF,30,POR,12,0,72,13,28,0,0,13,28,5,6,5,9,14,4,1,6,3,10,31
169,Donnell Harvey,PF,20,DAL,18,0,65,8,14,0,0,8,14,6,16,6,14,20,2,3,1,7,15,22
170,Hersey Hawkins,SG,34,CHH,59,0,681,56,137,17,46,39,91,54,63,17,63,80,72,33,9,19,45,183
171,Michael Hawkins,PG,28,CLE,10,0,76,3,9,2,4,1,5,0,0,2,3,5,13,2,0,6,13,8
172,Alan Henderson,PF,28,ATL,73,42,1810,298,671,0,1,298,670,173,271,180,226,406,50,51,29,126,164,769
173,Cedric Henderson,SF,25,CLE,55,10,961,102,262,1,8,101,254,30,46,19,71,90,79,29,23,63,101,235
174,Chris Herren,PG,25,BOS,25,7,408,29,96,16,55,13,41,9,12,4,17,21,56,14,0,20,43,83
175,Grant Hill*,SF,28,ORL,4,4,133,19,43,1,1,18,42,16,26,8,17,25,25,5,2,11,9,55
176,Tyrone Hill,PF,32,PHI,76,75,2363,278,587,0,1,278,586,172,273,239,448,687,48,37,27,127,242,728
177,Fred Hoiberg,SG,28,CHI,74,37,2247,217,495,103,250,114,245,136,157,21,287,308,263,98,12,74,155,673
178,Robert Horry,PF,30,LAL,79,1,1587,147,380,54,156,93,224,59,83,93,203,296,128,54,54,79,210,407
179,Eddie House,PG,22,MIA,50,0,550,104,247,19,55,85,192,24,35,5,37,42,52,13,0,35,58,251
180,Allan Houston,SG,29,NYK,78,78,2858,542,1208,96,252,446,956,279,307,20,263,283,173,52,10,161,190,1459
181,Juwan Howard,PF,27,TOT,81,81,2974,583,1218,0,3,583,1215,296,383,171,401,572,224,75,37,242,292,1462
182,Troy Hudson,PG,24,ORL,75,7,1008,125,372,22,109,103,263,85,104,38,67,105,162,37,3,92,82,357
183,Larry Hughes,SG,22,GSW,50,45,1846,308,805,14,75,294,730,193,252,76,200,276,223,96,29,152,147,823
184,Lindsey Hunter,PG,30,MIL,82,5,2002,298,783,152,407,146,376,77,96,32,137,169,222,102,12,68,172,825
185,Zydrunas Ilgauskas,C,25,CLE,24,24,616,114,234,0,2,114,232,53,78,65,95,160,18,15,37,60,78,281
186,Allen Iverson*,SG,25,PHI,71,71,2979,762,1813,98,306,664,1507,585,719,50,223,273,325,178,20,237,147,2207
187,Bobby Jackson,PG,27,SAC,79,7,1648,231,526,39,104,192,422,65,88,74,172,246,161,87,7,103,139,566
188,Jaren Jackson,SG,33,SAS,16,0,114,16,40,7,18,9,22,0,2,1,11,12,7,5,0,3,13,39
189,Jim Jackson,SF,30,TOT,56,40,1690,239,632,26,80,213,552,139,169,53,171,224,163,53,10,130,139,643
190,Marc Jackson,C,26,GSW,48,35,1410,237,508,5,23,232,485,154,192,119,242,361,59,34,27,93,138,633
191,Mark Jackson,PG,35,TOT,83,82,2588,244,583,70,207,174,376,73,93,63,242,305,661,84,7,175,139,631
192,Stephen Jackson,SF,22,NJN,77,40,1660,243,572,52,155,191,417,97,135,41,167,208,140,86,14,130,166,635
193,Sam Jacobson,PG,25,MIN,14,0,59,9,18,0,0,9,18,2,3,3,3,6,4,3,0,0,19,20
194,Tim James,SF,24,CHH,30,0,197,16,52,1,3,15,49,12,14,15,20,35,8,2,5,8,27,45
195,Antawn Jamison,SF,24,GSW,82,82,3394,800,1812,62,205,738,1607,382,534,280,435,715,164,114,28,199,225,2044
196,Anthony Johnson,PG,26,TOT,53,0,511,53,152,1,5,52,147,23,33,10,34,44,78,23,6,34,62,130
197,Avery Johnson,PG,35,SAS,55,20,1290,134,300,1,6,133,294,41,60,21,64,85,237,33,4,60,90,310
198,DerMarr Johnson,SF,20,ATL,78,21,1313,146,390,41,127,105,263,64,87,56,122,178,64,43,30,93,134,397
199,Ervin Johnson,C,33,MIL,82,19,1981,108,198,0,0,108,198,50,93,205,408,613,40,44,97,47,257,266
200,Larry Johnson,PF,31,NYK,65,65,2105,246,598,51,163,195,435,102,128,90,273,363,127,39,29,97,209,645
201,Damon Jones,PG,24,VAN,71,10,1415,170,416,84,231,86,185,37,52,16,108,124,224,36,1,76,58,461
202,Eddie Jones,SG,29,MIA,63,58,2282,388,871,90,238,298,633,228,270,75,217,292,171,110,58,135,183,1094
203,Jumaine Jones,SF,21,PHI,65,0,866,122,275,20,60,102,215,40,53,63,126,189,32,30,15,39,68,304
204,Popeye Jones,PF,30,WAS,45,1,638,60,153,1,6,59,147,41,55,83,137,220,31,19,8,21,95,162
205,Garth Joseph,C,27,TOT,4,0,16,1,5,0,0,1,5,0,2,2,0,2,1,0,1,2,1,2
206,Adam Keefe,PF,30,GSW,67,13,836,64,159,1,3,63,156,39,63,90,119,209,36,28,20,40,102,168
207,Shawn Kemp,PF,31,POR,68,3,1083,168,413,4,11,164,402,101,131,63,196,259,65,45,23,99,184,441
208,Steve Kerr,PG,35,SAS,55,1,650,67,159,33,77,34,82,14,15,6,29,35,57,16,1,21,30,181
209,Jerome Kersey,SF,38,MIL,22,2,243,32,69,0,1,32,68,8,16,8,37,45,15,14,8,6,36,72
210,Lari Ketner,PF,23,IND,3,0,7,0,0,0,0,0,0,0,0,0,0,0,1,0,0,2,0,0
211,Jason Kidd*,PG,27,PHO,77,76,3065,451,1097,69,232,382,865,328,403,91,403,494,753,166,23,286,171,1299
212,Gerard King,SF,28,WAS,45,3,706,90,176,0,0,90,176,36,45,39,90,129,31,14,11,47,94,216
213,Brevin Knight,PG,25,TOT,53,43,1457,139,371,1,10,138,361,54,66,23,145,168,311,101,4,91,155,333
214,Travis Knight,C,26,NYK,45,0,256,10,53,0,1,10,52,9,18,19,34,53,5,5,11,10,47,29
215,Toni Kukoč,SF,32,TOT,65,19,1597,275,582,70,157,205,425,101,160,66,193,259,199,48,11,111,98,721
217,Raef LaFrentz,C,24,DEN,78,74,2457,387,812,51,139,336,673,183,262,173,434,607,107,37,206,97,290,1008
218,Trajan Langdon,SG,24,CLE,65,5,1116,135,313,51,124,84,189,68,76,12,77,89,81,38,9,52,114,389
219,Dan Langhi,SF,23,HOU,33,0,241,37,99,0,1,37,98,16,29,13,28,41,4,7,1,8,16,90
220,Voshon Lenard,SG,27,DEN,80,58,2331,336,846,147,382,189,464,153,192,47,184,231,190,65,18,102,170,972
221,Quincy Lewis,SF,23,UTA,35,2,402,50,123,9,25,41,98,15,21,14,33,47,18,10,10,17,78,124
222,Rashard Lewis,PF,21,SEA,78,78,2720,426,887,123,285,303,602,176,213,143,398,541,125,91,45,129,191,1151
223,Randy Livingston,PG,25,GSW,2,0,7,0,2,0,1,0,1,0,0,0,1,1,1,0,0,0,0,0
224,Art Long,SF,28,SAC,9,0,20,0,4,0,0,0,4,0,2,2,6,8,1,0,3,2,5,0
225,Grant Long,PF,34,VAN,66,27,1507,140,319,4,15,136,304,112,157,76,198,274,83,72,15,62,160,396
226,Luc Longley,C,32,NYK,25,2,301,18,54,0,0,18,54,13,17,26,40,66,7,3,9,22,51,49
228,Tyronn Lue,PG,23,LAL,38,1,468,50,117,11,34,39,83,19,24,5,27,32,45,19,0,27,54,130
229,George Lynch,SF,30,PHI,82,80,2649,274,616,15,57,259,559,123,171,200,390,590,139,99,30,109,222,686
230,Todd MacCulloch,C,25,PHI,63,3,597,109,185,0,0,109,185,42,66,69,99,168,10,7,19,27,96,260
231,Don MacLean,SF,31,MIA,8,1,76,10,20,2,2,8,18,9,12,7,11,18,4,5,1,10,9,31
232,Mark Madsen,PF,25,LAL,70,3,641,55,113,1,1,54,112,26,37,74,78,152,24,8,8,27,111,137
233,Corey Maggette,SF,21,LAC,69,9,1359,225,487,17,56,208,431,223,288,88,203,291,82,35,9,106,140,690
234,Jamaal Magloire,C,22,CHH,74,0,1095,122,271,0,2,122,269,95,145,103,192,295,27,18,78,61,139,339
235,Dan Majerle,SG,35,MIA,53,19,1306,87,259,57,181,30,78,36,44,20,146,166,88,53,15,35,98,267
236,Karl Malone*,PF,37,UTA,81,81,2895,670,1345,2,5,668,1340,536,676,114,555,669,361,93,62,244,216,1878
237,Matt Maloney,PG,29,ATL,55,27,1403,146,348,51,142,95,206,26,34,14,103,117,154,56,5,70,94,369
238,Danny Manning,PF,34,UTA,82,0,1305,247,500,7,28,240,472,102,140,66,148,214,92,47,29,96,219,603
239,Stephon Marbury,PG,23,NJN,67,67,2557,563,1277,110,335,453,942,362,458,53,152,205,506,79,5,197,150,1598
240,Shawn Marion,SF,22,PHO,79,79,2857,557,1160,21,82,536,1078,234,289,220,628,848,160,132,108,129,211,1369
241,Donyell Marshall,SF,27,UTA,81,49,2326,427,849,41,128,386,721,205,273,172,394,566,133,85,78,128,196,1100
242,Darrick Martin,PG,29,SAC,31,0,176,29,76,14,27,15,49,31,35,2,14,16,14,7,0,10,27,103
243,Kenyon Martin,PF,23,NJN,68,68,2272,346,777,1,11,345,766,121,192,137,365,502,131,78,113,138,281,814
244,Jamal Mashburn,SF,28,CHH,76,76,2989,573,1388,103,289,470,1099,279,364,92,484,576,411,85,13,211,185,1528
245,Anthony Mason,PF,34,MIA,80,80,3254,460,954,0,0,460,954,370,474,169,601,770,248,80,25,179,231,1290
246,Desmond Mason,SF,23,SEA,78,14,1522,189,439,18,67,171,372,67,91,72,177,249,63,39,20,53,146,463
247,Tony Massenburg,PF,33,VAN,52,20,823,92,199,0,0,92,199,49,70,75,135,210,9,10,28,48,122,233
248,Vernon Maxwell,PG,35,TOT,43,6,660,73,223,34,111,39,112,21,32,4,62,66,49,21,3,35,64,201
249,Walter McCarty,PF,26,BOS,60,3,478,45,126,19,56,26,70,22,28,24,57,81,39,14,7,20,82,131
250,Dan McClintock,C,23,DEN,6,1,58,9,18,0,0,9,18,0,5,10,7,17,1,0,2,3,11,18
251,George McCloud,SF,33,DEN,76,8,2007,250,655,77,234,173,421,152,181,55,169,224,279,53,27,117,165,729
252,Jelani McCoy,C,23,SEA,70,44,1143,138,264,0,0,138,264,41,93,92,159,251,57,18,49,75,141,317
253,Antonio McDyess,PF,26,DEN,70,70,2555,577,1165,0,0,577,1165,304,434,240,605,845,146,43,102,162,220,1458
254,Tracy McGrady*,SG,21,ORL,77,77,3087,788,1724,59,166,729,1558,430,587,192,388,580,352,116,118,198,160,2065
255,Jim McIlvaine,C,28,NJN,18,3,193,10,28,0,0,10,28,8,12,8,27,35,4,7,15,9,35,28
256,Jeff McInnis,PG,26,LAC,81,81,2831,432,933,52,144,380,789,130,161,41,179,220,447,75,7,113,199,1046
257,Derrick McKey,SF,34,IND,66,20,987,60,136,4,20,56,116,21,27,49,127,176,74,48,13,47,136,145
258,Aaron McKie,SG,28,PHI,76,33,2394,338,714,53,170,285,544,149,194,33,278,311,377,106,8,203,178,878
259,Roshown McLeod,SF,25,TOT,35,25,922,145,332,2,22,143,310,45,51,38,82,120,58,23,8,58,90,337
260,Paul McPherson,PG,22,TOT,55,0,595,109,216,2,12,107,204,42,58,40,39,79,38,25,4,47,80,262
261,Stanislav Medvedenko,PF,21,LAL,7,0,39,12,25,1,1,11,24,7,12,1,8,9,2,1,1,3,9,32
262,Ron Mercer,SG,24,CHI,61,61,2535,500,1121,14,46,486,1075,188,228,72,164,236,201,78,27,129,148,1202
263,Chris Mihm,C,21,CLE,59,43,1166,173,391,0,1,173,390,100,126,106,174,280,16,20,53,80,156,446
264,Darius Miles,SF,19,LAC,81,21,2133,318,630,1,19,317,611,124,238,127,350,477,99,51,125,147,191,761
265,Andre Miller,PG,24,CLE,82,82,2848,452,999,17,64,435,935,375,450,94,266,360,657,119,28,265,229,1296
266,Anthony Miller,PF,29,TOT,4,0,11,1,2,0,0,1,2,0,0,0,2,2,0,0,0,1,1,2
267,Brad Miller,C,24,CHI,57,45,1434,168,386,1,5,167,381,168,226,144,275,419,107,33,38,73,176,505
268,Mike Miller,SF,20,ORL,82,62,2390,368,845,148,364,220,481,91,128,66,261,327,140,51,19,97,200,975
269,Reggie Miller*,SG,35,IND,81,81,3181,517,1176,170,464,347,712,323,348,38,247,285,260,81,15,133,162,1527
270,Chris Mills,SF,31,GSW,15,8,493,71,191,7,25,64,166,31,36,24,69,93,18,9,5,20,43,180
271,Terry Mills,PF,33,IND,14,0,113,11,34,3,17,8,17,0,0,4,17,21,5,3,1,10,20,25
272,Sam Mitchell,SF,37,MIN,82,4,983,118,289,9,43,109,246,40,55,28,95,123,57,26,10,36,117,285
273,Cuttino Mobley,SG,25,HOU,79,49,3002,527,1214,90,252,437,962,394,474,83,314,397,195,84,26,165,169,1538
274,Nazr Mohammed,C,23,TOT,58,22,912,176,369,0,1,176,368,89,126,115,192,307,19,29,35,64,113,441
275,Jérôme Moïso,C,22,BOS,24,0,135,12,30,0,1,12,29,11,26,12,30,42,3,3,4,18,29,35
276,Eric Montross,C,29,TOT,54,21,649,56,138,0,0,56,138,8,31,52,121,173,19,11,26,41,115,120
277,Mikki Moore,C,25,DET,81,2,1154,132,268,0,1,132,267,95,130,121,195,316,33,24,61,74,202,359
278,Hanno Möttölä,SF,24,ATL,73,3,989,123,277,0,3,123,274,73,90,49,125,174,25,11,9,67,163,319
279,Alonzo Mourning*,C,30,MIA,13,3,306,73,141,0,1,73,140,31,55,35,66,101,12,4,31,28,24,177
280,Chris Mullin*,SF,37,GSW,20,8,374,36,106,19,52,17,54,24,28,10,31,41,19,16,10,19,28,115
281,Lamond Murray,SF,27,CLE,78,46,2225,391,925,61,165,330,760,155,211,104,236,340,124,83,27,141,173,998
282,Tracy Murray,SF,29,TOT,51,1,588,94,248,36,103,58,145,33,42,22,59,81,23,12,7,26,53,257
283,Dikembe Mutombo*,C,34,TOT,75,75,2591,269,556,0,0,269,556,211,291,307,708,1015,76,29,203,144,204,749
284,Mamadou N'Diaye,C,25,TOR,3,0,10,1,4,0,0,1,4,2,2,1,1,2,0,0,0,0,3,4
285,Lee Nailon,SF,25,CHH,42,0,469,66,136,0,1,66,135,32,43,29,63,92,24,9,5,27,60,164
286,Eduardo Nájera,PF,24,DAL,40,4,431,58,111,1,3,57,108,14,33,41,54,95,27,13,8,17,48,131
287,Steve Nash*,PG,26,DAL,70,70,2387,386,792,89,219,297,573,231,258,46,177,223,509,72,5,205,158,1092
289,Rasho Nesterović,C,24,MIN,73,39,1233,147,319,0,1,147,318,34,65,99,187,286,45,25,63,55,189,328
290,Ira Newble,SF,26,SAS,27,6,184,21,55,4,9,17,46,8,16,13,22,35,6,2,4,7,18,54
291,Johnny Newman,SG,37,NJN,82,17,2049,291,695,59,176,232,519,254,297,34,142,176,115,63,10,106,229,895
292,Moochie Norris,PG,27,HOU,82,6,1654,184,413,25,89,159,324,151,194,44,154,198,283,69,2,107,84,544
293,Dirk Nowitzki,PF,22,DAL,82,82,3125,591,1247,151,390,440,857,451,538,119,635,754,173,79,101,156,245,1784
294,Jermaine O'Neal,C,22,IND,81,80,2641,404,868,0,5,404,863,233,388,249,545,794,98,49,228,161,280,1041
295,Shaquille O'Neal*,C,28,LAL,74,74,2924,813,1422,0,2,813,1420,499,972,291,649,940,277,47,204,218,256,2125
296,Charles Oakley,PF,37,TOR,78,77,2767,305,786,11,49,294,737,127,152,142,599,741,264,76,48,139,258,748
297,Lamar Odom,PF,21,LAC,76,74,2836,481,1046,80,253,401,793,262,386,110,482,592,392,74,122,264,236,1304
298,Hakeem Olajuwon*,C,38,HOU,58,55,1545,283,568,0,1,283,567,123,198,124,307,431,72,70,88,81,141,689
299,Kevin Ollie,PG,28,TOT,70,4,925,76,192,1,3,75,189,63,89,16,79,95,146,30,1,49,84,216
300,Michael Olowokandi,C,25,LAC,82,82,2127,308,708,0,0,308,708,85,156,168,357,525,46,30,108,169,250,701
301,Greg Ostertag,C,27,UTA,81,3,1491,139,281,1,2,138,279,84,151,164,251,415,22,22,142,63,215,363
302,Bo Outlaw,PF,29,ORL,80,69,2534,226,368,1,2,225,366,129,225,211,408,619,225,105,137,141,241,582
303,Doug Overton,PG,31,TOT,21,10,475,52,139,11,36,41,103,10,16,4,35,39,72,8,0,31,37,125
304,Billy Owens,PF,31,DET,45,14,793,88,230,3,20,85,210,19,40,84,121,205,55,32,12,39,93,198
305,Olumide Oyedeji,C,19,SEA,30,1,221,18,37,0,0,18,37,9,12,24,43,67,2,7,10,11,40,45
306,Robert Pack,PG,31,DEN,74,11,1260,181,426,12,31,169,395,105,137,30,107,137,293,65,1,135,114,479
307,Scott Padgett,PF,24,UTA,27,0,127,18,43,5,9,13,34,15,20,19,20,39,5,6,3,10,21,56
308,Milt Palacio,PG,22,BOS,58,6,1141,126,267,12,36,114,231,78,92,25,77,102,151,48,0,80,83,342
309,Andy Panko,SF,23,ATL,1,0,1,0,0,0,0,0,0,0,0,0,0,0,0,0,0,0,0,0
310,Cherokee Parks,C,28,TOT,65,31,1054,134,274,0,6,134,268,31,44,71,158,229,46,25,36,41,122,299
311,Ruben Patterson,SF,25,SEA,76,22,2059,370,749,2,36,368,713,246,361,183,199,382,161,103,45,155,176,988
312,Gary Payton*,PG,32,SEA,79,79,3244,725,1591,102,272,623,1319,271,354,73,288,361,642,127,26,209,184,1823
313,Anthony Peeler,SG,31,MIN,75,41,2126,308,732,100,256,208,476,75,87,44,148,192,192,91,18,105,166,791
314,Mike Penberthy,PG,26,LAL,53,0,851,92,222,55,139,37,83,28,31,10,53,63,71,22,2,34,57,267
315,Will Perdue,C,35,POR,13,0,58,6,9,0,0,6,9,2,4,6,12,18,2,3,2,0,8,14
316,Sam Perkins,PF,39,IND,64,41,999,86,226,38,110,48,116,32,38,32,136,168,41,33,18,19,61,242
317,Elliot Perry,PG,31,TOT,49,6,499,65,140,1,5,64,135,16,22,9,37,46,79,22,1,38,29,147
318,Wesley Person,SG,29,CLE,44,22,958,128,292,34,84,94,208,24,30,11,119,130,64,27,11,40,62,314
319,Morris Peterson,SG,23,TOR,80,49,1809,290,673,63,165,227,508,104,145,112,147,259,105,63,20,78,164,747
320,Eric Piatkowski,SG,30,LAC,81,40,2144,291,672,120,297,171,375,158,181,54,187,241,96,46,19,76,123,860
321,Paul Pierce,SF,23,BOS,82,82,3120,687,1513,147,384,540,1129,550,738,94,428,522,253,138,69,262,251,2071
322,Scottie Pippen*,SF,35,POR,64,60,2133,269,596,64,186,205,410,119,161,70,263,333,294,94,35,154,158,721
323,Scot Pollard,C,25,SAC,77,8,1658,185,395,0,2,185,393,128,171,173,292,465,47,48,97,66,206,498
324,Olden Polynice,C,36,UTA,81,79,1619,206,415,0,1,206,414,17,65,157,221,378,31,27,77,78,241,429
325,Mark Pope,PF,28,MIL,63,45,942,62,142,5,24,57,118,22,35,56,91,147,38,16,26,17,140,151
326,Chris Porter,SF,22,GSW,51,35,1147,173,445,0,5,173,440,94,141,89,100,189,61,45,6,59,111,440
327,Terry Porter,PG,37,SAS,80,42,1678,197,440,87,205,110,235,92,116,24,177,201,251,52,11,104,88,573
328,James Posey,SF,24,DEN,82,82,2255,243,590,65,217,178,373,115,141,125,306,431,163,93,40,102,226,666
329,Lavor Postell,SG,22,NYK,26,0,169,17,54,3,11,14,43,22,27,8,17,25,5,4,2,17,12,59
330,Vitaly Potapenko,C,25,BOS,82,7,1901,248,521,0,0,248,521,115,158,206,289,495,64,52,23,105,228,611
331,Brent Price,PG,32,VAN,6,0,30,3,11,1,4,2,7,6,7,1,3,4,5,2,0,4,8,13
332,Laron Profit,PG,23,WAS,35,12,605,56,142,7,26,49,116,33,45,18,46,64,89,36,11,46,43,152
333,Joel Przybilla,C,21,MIL,33,13,270,12,35,0,0,12,35,3,11,29,42,71,2,3,30,13,56,27
334,Theo Ratliff,C,27,PHI,50,50,1800,228,457,0,0,228,457,165,217,125,288,413,58,30,187,126,165,621
335,Eldridge Recasner,PG,33,CHH,43,0,403,38,114,13,39,25,75,14,18,13,37,50,39,6,1,27,30,103
336,Michael Redd,SG,21,MIL,6,0,35,5,19,0,3,5,16,3,6,3,1,4,1,1,0,1,2,13
337,Bryant Reeves,C,27,VAN,75,48,1832,254,552,1,4,253,548,113,142,132,320,452,80,43,54,90,243,622
338,Don Reid,PF,27,ORL,65,7,764,82,145,0,0,82,145,46,75,84,158,242,21,23,54,48,190,210
339,J.R. Reid,PF,32,CLE,6,0,39,2,5,0,0,2,5,6,8,5,3,8,1,2,1,1,4,10
340,Glen Rice,SF,33,NYK,75,25,2212,331,752,82,211,249,541,155,182,61,246,307,89,41,13,96,179,899
341,Quentin Richardson,SG,20,LAC,76,28,1358,232,525,50,151,182,374,99,158,105,152,257,62,42,7,64,98,613
342,Mitch Richmond*,SG,35,WAS,37,30,1216,205,504,45,133,160,371,143,160,15,94,109,111,43,7,84,86,598
343,Isaiah Rider,SG,29,LAL,67,6,1206,201,472,34,92,167,380,71,83,44,112,156,111,27,7,98,105,507
344,Terrance Roberson,SF,24,CHH,3,0,13,0,2,0,1,0,1,0,0,0,1,1,1,0,0,2,3,0
345,Clifford Robinson,PF,34,PHO,82,82,2751,501,1186,90,249,411,937,253,357,105,229,334,237,87,82,186,258,1345
346,David Robinson*,C,35,SAS,80,80,2371,400,823,0,1,400,822,351,470,208,483,691,116,80,197,122,212,1151
347,Eddie Robinson,SF,24,CHH,67,6,1201,216,407,2,4,214,403,64,88,60,138,198,59,50,32,43,66,498
348,Glenn Robinson,SF,28,MIL,76,74,2813,684,1460,55,184,629,1276,251,306,124,402,526,252,86,62,219,191,1674
349,Jamal Robinson,SF,27,MIA,6,0,72,3,22,0,2,3,20,0,0,3,8,11,2,6,0,3,7,6
350,James Robinson,PG,30,ORL,6,0,50,4,11,2,5,2,6,0,0,0,8,8,0,4,1,4,5,10
352,Carlos Rogers,C,29,HOU,39,0,544,75,110,0,1,75,109,29,52,48,91,139,9,10,18,17,33,179
353,Rodney Rogers,SF,29,PHO,82,3,2183,377,876,56,189,321,687,188,247,94,265,359,180,97,47,157,269,998
354,Sean Rooks,C,31,LAC,82,0,1553,169,395,1,2,168,393,107,143,91,212,303,77,34,64,73,197,446
355,Jalen Rose,SF,28,IND,72,72,2943,567,1242,59,174,508,1068,285,344,37,322,359,435,65,43,211,230,1478
356,Malik Rose,PF,26,SAS,57,9,1219,160,368,3,17,157,351,114,160,95,213,308,48,59,40,74,148,437
357,Michael Ruffin,PF,24,CHI,45,16,879,40,90,0,0,40,90,39,77,101,161,262,39,30,38,46,131,119
358,Bryon Russell,SF,30,UTA,78,46,2473,308,700,95,230,213,470,222,285,94,236,330,160,96,20,113,229,933
359,Arvydas Sabonis*,C,36,POR,61,42,1299,247,516,1,15,246,501,121,156,51,280,331,91,40,62,85,137,616
360,Soumaila Samake,C,22,NJN,34,0,226,18,48,0,0,18,48,10,24,22,31,53,1,2,14,4,23,46
361,Pepe Sánchez,PG,23,TOT,29,0,150,9,28,0,1,9,27,2,2,3,12,15,41,11,1,6,21,20
362,Daniel Santiago,C,24,PHO,54,2,581,64,134,0,0,64,134,42,61,35,67,102,11,17,21,47,101,170
363,Detlef Schrempf,SF,38,POR,26,0,397,39,95,3,8,36,87,23,27,17,61,78,44,7,3,28,43,104
364,Shawnelle Scott,C,28,SAS,27,1,144,17,41,0,0,17,41,9,22,23,27,50,4,5,6,11,23,43
365,Brian Shaw,SG,34,LAL,80,28,1833,164,411,42,135,122,276,51,64,48,256,304,258,49,27,97,159,421
366,Brian Skinner,PF,24,LAC,39,23,584,64,161,0,0,64,161,32,59,55,113,168,18,14,11,32,61,160
367,Reggie Slater,PF,30,MIN,55,16,686,90,175,0,0,90,175,74,110,78,108,186,26,18,9,43,126,254
368,Jabari Smith,C,23,SAC,9,0,66,11,22,0,0,11,22,4,6,1,7,8,6,4,0,3,7,26
369,Joe Smith,PF,25,DET,69,59,1941,308,765,0,5,308,760,231,287,160,331,491,79,47,50,88,258,847
370,Michael Smith,PF,28,WAS,79,29,1610,106,218,0,1,106,217,89,154,172,390,562,101,57,37,62,156,301
371,Mike Smith,SF,24,WAS,17,0,180,19,59,3,18,16,41,10,16,10,12,22,10,5,3,7,8,51
372,Steve Smith,SG,31,POR,81,36,2542,359,788,78,230,281,558,309,347,87,185,272,213,48,24,137,203,1105
373,Tony Smith,SG,32,ATL,6,0,78,8,23,0,2,8,21,1,2,2,1,3,10,7,0,9,12,17
374,Eric Snow,PG,27,PHI,50,50,1740,182,435,5,19,177,416,122,154,27,139,166,369,77,7,124,123,491
375,Felton Spencer,C,33,NYK,18,0,113,12,20,0,0,12,20,15,25,16,19,35,2,2,2,11,24,39
376,Latrell Sprewell,SF,30,NYK,77,77,3017,524,1219,41,135,483,1084,275,351,49,298,347,269,106,28,218,159,1364
377,Jerry Stackhouse,SG,26,DET,80,80,3215,774,1927,166,473,608,1454,666,810,99,216,315,410,97,54,326,160,2380
378,John Starks,SG,35,UTA,75,64,2122,273,686,64,182,209,504,89,111,29,125,154,178,73,10,94,217,699
379,Vladimir Stepania,C,24,NJN,29,0,280,28,88,1,4,27,84,25,34,35,74,109,16,10,11,19,47,82
380,DeShawn Stevenson,SG,19,UTA,40,2,293,31,91,1,12,30,79,26,38,9,19,28,18,10,2,28,29,89
381,Michael Stewart,C,25,TOR,26,0,123,11,34,0,0,11,34,11,18,16,13,29,2,4,3,5,19,33
382,Bryant Stith,SG,30,BOS,78,74,2504,245,611,91,242,154,369,175,207,65,219,284,168,93,14,90,182,756
383,John Stockton*,PG,38,UTA,82,82,2397,328,651,61,132,267,519,227,278,54,173,227,713,132,21,203,194,944
384,Peja Stojaković,SF,23,SAC,75,75,2905,559,1189,144,360,415,829,267,312,93,341,434,164,91,13,146,144,1529
385,Damon Stoudamire,PG,27,POR,82,82,2655,406,935,82,219,324,716,172,207,69,234,303,468,106,8,191,202,1066
386,Erick Strickland,PG,27,TOT,50,0,830,81,267,30,95,51,172,68,79,18,110,128,95,44,2,48,88,260
387,Mark Strickland,SF,30,TOT,55,2,719,103,239,1,2,102,237,45,70,54,107,161,24,16,22,34,72,252
388,Rod Strickland,PG,34,TOT,54,28,1371,182,429,4,17,178,412,130,173,36,104,140,303,53,5,107,76,498
389,Derek Strong,PF,32,LAC,28,8,491,45,117,0,1,45,116,28,37,34,74,108,7,14,1,22,30,118
390,Bruno Šundov,C,20,IND,11,4,120,20,41,0,4,20,37,3,5,4,19,23,2,2,4,3,21,43
391,Bob Sura,SG,27,GSW,53,42,1684,202,518,47,172,155,346,135,189,54,173,227,242,54,8,160,127,586
392,Stromile Swift,PF,21,VAN,80,6,1312,153,339,0,4,153,335,85,141,109,175,284,28,62,82,64,160,391
393,Wally Szczerbiak,SF,23,MIN,82,82,2856,469,920,26,77,443,843,181,208,133,314,447,260,59,33,138,226,1145
394,Žan Tabak,C,30,IND,55,14,777,98,186,0,0,98,186,20,47,65,148,213,33,10,30,57,125,216
395,Dragan Tarlać,C,27,CHI,43,12,598,39,99,0,0,39,99,25,33,37,85,122,31,7,19,38,95,103
396,Maurice Taylor,SF,24,HOU,69,69,1972,390,797,0,4,390,793,119,162,109,269,378,104,28,38,125,208,899
397,Jason Terry,SG,23,ATL,82,77,3089,596,1367,124,314,472,1053,303,358,42,227,269,403,104,12,239,204,1619
398,Jamel Thomas,SF,27,NJN,5,0,56,6,19,1,3,5,16,0,0,4,5,9,0,3,0,6,6,13
399,Kenny Thomas,PF,23,HOU,74,21,1820,206,465,25,92,181,373,91,126,122,295,417,77,40,43,116,178,528
400,Kurt Thomas,PF,28,NYK,77,29,2125,314,614,1,3,313,611,171,210,172,343,515,63,61,69,99,287,800
401,Tim Thomas,PF,23,MIL,76,16,2086,326,758,107,260,219,498,195,253,79,234,313,138,78,45,114,194,954
402,Otis Thorpe,PF,38,CHH,49,4,647,59,131,0,0,59,131,20,24,50,95,145,29,12,7,32,108,138
403,Robert Traylor,C,23,CLE,70,7,1212,161,324,0,2,161,322,80,141,124,176,300,63,49,76,98,204,402
404,Gary Trent,PF,26,DAL,33,4,319,57,130,0,1,57,129,19,36,39,53,92,10,13,8,22,52,133
405,Jake Tsakalidis,C,21,PHO,57,39,947,101,215,0,0,101,215,54,91,83,159,242,19,10,55,66,137,256
406,Hedo Türkoğlu,SF,21,SAC,74,7,1245,138,335,28,86,110,249,87,112,49,161,210,69,52,24,55,139,391
407,Nick Van Exel,PG,29,DEN,71,70,2688,460,1112,135,358,325,754,204,249,44,197,241,600,61,18,165,109,1259
408,Keith Van Horn,SF,25,NJN,49,47,1733,308,708,65,170,243,538,150,186,78,269,347,82,40,20,103,150,831
409,David Vanterpool,PG,27,WAS,22,0,411,46,110,0,6,46,104,30,50,15,22,37,66,23,3,37,44,122
410,Jacque Vaughn,PG,25,UTA,82,0,1620,170,393,30,78,140,315,128,164,18,132,150,323,48,3,129,145,498
411,Loy Vaught,PF,32,TOT,51,1,549,80,169,0,0,80,169,8,10,51,122,173,23,21,7,26,74,168
412,Jake Voskuhl,C,23,CHI,16,2,143,11,25,0,0,11,25,8,14,12,22,34,5,5,6,12,38,30
413,Antoine Walker,PF,24,BOS,81,81,3396,711,1720,221,603,490,1117,249,348,151,568,719,445,138,49,301,251,1892
414,Samaki Walker,PF,24,SAS,61,1,963,121,252,1,3,120,249,78,124,67,176,243,29,10,41,68,103,321
415,Ben Wallace,C,26,DET,80,80,2760,215,439,1,4,214,435,80,238,303,749,1052,123,107,186,117,192,511
416,John Wallace,SF,26,DET,40,0,527,100,236,2,15,98,221,35,45,25,58,83,23,13,16,36,72,237
417,Rasheed Wallace,PF,26,POR,77,75,2940,590,1178,52,162,538,1016,245,320,147,455,602,212,90,135,158,206,1477
418,Charlie Ward,PG,30,NYK,61,33,1492,155,373,67,175,88,198,56,70,32,127,159,273,70,10,112,132,433
419,Clarence Weatherspoon,PF,30,CLE,82,82,2774,347,692,0,0,347,692,230,291,223,573,796,103,85,105,112,171,924
420,Chris Webber,PF,27,SAC,70,70,2836,786,1635,2,28,784,1607,324,461,179,598,777,294,93,118,195,226,1898
421,Bonzi Wells,SF,24,POR,75,46,1995,387,726,17,50,370,676,159,240,120,247,367,208,94,20,169,203,950
422,David Wesley,SG,30,CHH,82,82,3106,523,1239,97,258,426,981,271,339,64,160,224,361,128,16,171,220,1414
423,Doug West,SG,33,VAN,15,6,171,11,38,0,2,11,36,6,7,4,11,15,14,3,4,4,21,28
424,Jahidi White,C,24,WAS,68,56,1609,203,408,0,1,203,407,177,312,178,343,521,20,32,111,136,211,583
425,Chris Whitney,PG,29,WAS,59,31,1532,182,470,93,248,89,222,101,113,12,94,106,248,55,3,103,150,558
426,Aaron Williams,PF,29,NJN,82,25,2336,297,650,0,2,297,648,244,310,211,379,590,88,59,113,132,319,838
427,Alvin Williams,SG,26,TOR,82,34,2394,330,767,33,108,297,659,109,145,50,162,212,407,123,26,103,171,802
428,Eric Williams,SF,28,BOS,81,11,1745,162,448,46,139,116,309,165,231,64,143,207,112,64,13,76,179,535
429,Jason Williams,PG,25,SAC,77,77,2290,281,690,98,311,183,379,60,76,19,166,185,416,94,9,160,114,720
430,Jerome Williams,PF,27,TOT,59,2,1182,136,294,0,3,136,291,100,135,133,249,382,45,57,20,63,124,372
431,Monty Williams,SF,29,ORL,82,0,1211,162,364,1,13,161,351,85,133,86,157,243,79,29,16,85,136,410
432,Scott Williams,C,32,MIL,66,31,1272,171,361,1,4,170,357,60,70,97,267,364,35,48,32,41,178,403
433,Shammond Williams,PG,25,SEA,69,6,1238,161,368,61,133,100,235,84,96,34,98,132,190,31,4,82,83,467
434,Walt Williams,SF,30,HOU,72,31,1583,202,513,98,248,104,265,97,126,31,214,245,97,30,28,73,153,599
435,Corliss Williamson,SF,27,TOT,69,40,1686,325,647,0,2,325,645,151,237,110,211,321,61,50,21,110,185,801
436,Kevin Willis,C,38,TOT,78,22,1830,304,690,1,6,303,684,113,147,177,355,532,50,57,52,87,216,722
437,David Wingate,SG,37,SEA,1,0,9,3,3,0,0,3,3,0,0,0,0,0,2,0,0,0,1,6
438,Rubén Wolkowyski,PF,27,SEA,34,1,305,25,79,0,2,25,77,25,34,12,34,46,3,6,18,12,38,75
439,Metta World Peace,SF,21,CHI,76,74,2363,327,815,43,148,284,667,210,280,59,235,294,228,152,45,159,254,907
440,Lorenzen Wright,C,25,ATL,71,46,1988,363,811,0,2,363,809,155,216,180,355,535,87,42,63,125,232,881
441,Wang Zhizhi,C,23,DAL,5,0,38,8,19,0,2,8,17,8,10,1,6,7,0,0,0,1,8,24
1,Tariq Abdul-Wahad,SG,27,TOT,24,12,441,55,147,1,2,54,145,24,33,41,43,84,24,20,10,27,56,135
2,Shareef Abdur-Rahim,PF,25,ATL,77,77,2980,598,1297,21,70,577,1227,419,523,198,498,696,239,98,81,250,214,1636
3,Courtney Alexander,SG,24,WAS,56,28,1325,223,474,5,18,218,456,98,121,43,105,148,86,35,7,60,113,549
4,Victor Alexander,C,32,DET,15,0,97,18,51,0,2,18,49,4,8,7,22,29,6,0,1,5,6,40
5,Malik Allen,PF,23,MIA,12,2,161,22,51,0,1,22,50,8,10,15,23,38,5,3,8,2,16,52
6,Ray Allen*,SG,26,MIL,69,67,2525,530,1148,229,528,301,620,214,245,81,231,312,271,88,18,159,157,1503
7,Rafer Alston,PG,25,MIL,50,7,600,66,191,27,71,39,120,18,29,10,62,72,143,32,2,40,42,177
8,John Amaechi,PF,31,UTA,54,0,586,54,166,0,0,54,166,67,105,52,57,109,29,7,10,55,64,175
9,Chris Andersen,C,23,DEN,24,1,262,25,74,0,4,25,70,22,28,38,38,76,7,7,28,13,35,72
10,Derek Anderson,SG,27,POR,70,27,1860,247,612,85,228,162,384,178,208,47,142,189,216,68,8,87,113,757
11,Kenny Anderson,PG,31,BOS,76,76,2430,312,716,9,33,303,683,98,132,57,218,275,403,141,10,119,210,731
12,Nick Anderson,SG,34,MEM,15,0,219,21,76,13,48,8,28,5,9,1,32,33,14,6,6,14,17,60
13,Shandon Anderson,SG,28,NYK,82,6,1596,149,373,39,141,110,232,74,107,57,192,249,76,48,15,97,134,411
14,Greg Anthony,PG,34,TOT,60,38,1514,183,475,48,163,135,312,60,91,22,110,132,282,77,5,94,114,474
15,Gilbert Arenas,PG,20,GSW,47,30,1155,174,384,39,113,135,271,124,160,41,91,132,174,69,11,97,115,511
16,Brandon Armstrong,SG,21,NJN,35,0,196,27,85,5,17,22,68,5,10,10,6,16,8,7,1,8,26,64
17,Darrell Armstrong,PG,33,ORL,82,79,2730,347,828,139,398,208,430,182,205,83,236,319,453,157,10,175,166,1015
18,Carlos Arroyo,PG,22,TOT,37,1,371,49,111,0,2,49,109,13,18,12,28,40,70,11,1,23,30,111
19,Chucky Atkins,PG,27,DET,79,62,2285,368,790,138,336,230,454,83,120,31,127,158,263,72,11,128,177,957
20,Stacey Augmon,SG,33,CHH,77,3,1319,140,328,0,3,140,325,77,101,59,166,225,103,56,12,54,115,357
21,Isaac Austin,C,32,MEM,21,8,307,36,92,0,3,36,89,4,4,11,60,71,13,9,5,11,36,76
22,William Avery,PG,22,MIN,28,0,258,26,90,6,35,20,55,13,19,4,20,24,36,7,0,19,17,71
23,Dalibor Bagarić,C,21,CHI,50,0,638,72,178,0,1,72,177,41,70,55,107,162,23,17,24,46,108,185
24,Vin Baker,C,30,SEA,55,41,1710,315,649,1,8,314,641,143,226,168,182,350,72,22,36,127,197,774
25,Erick Barkley,PG,23,POR,19,4,228,24,68,1,7,23,61,9,10,5,13,18,34,17,1,12,29,58
26,Dana Barros,PG,34,DET,29,20,582,74,192,24,71,50,121,21,27,1,56,57,78,14,2,33,37,193
27,Brent Barry,SG,30,SEA,81,81,3040,401,790,164,387,237,403,198,234,58,383,441,426,147,37,165,182,1164
28,Jon Barry,SG,32,DET,82,6,1985,255,522,121,258,134,264,108,116,42,192,234,274,94,20,111,134,739
29,Mengke Bateer,C,26,DEN,27,10,408,53,132,4,12,49,120,29,37,32,64,96,22,10,5,32,94,139
30,Tony Battie,C,25,BOS,74,73,1819,211,390,0,2,211,388,88,130,184,297,481,35,60,67,51,219,510
31,Shane Battier,SF,23,MEM,78,78,3097,412,961,103,276,309,685,198,283,180,238,418,216,121,81,155,215,1125
32,Charlie Bell,SG,22,TOT,7,0,44,3,11,0,6,3,5,2,2,2,3,5,2,0,0,5,3,8
33,Raja Bell,SG,25,PHI,74,12,890,103,240,12,44,91,196,36,48,31,80,111,71,21,4,48,109,254
34,Jonathan Bender,SF,21,IND,78,17,1647,198,460,45,125,153,335,140,181,64,180,244,62,19,49,96,147,581
35,Travis Best,PG,29,TOT,74,21,1747,228,518,21,59,207,459,104,116,20,131,151,324,89,7,99,173,581
36,Mike Bibby,PG,23,SAC,80,80,2659,446,985,51,138,395,847,155,193,37,185,222,403,87,15,134,133,1098
37,Chauncey Billups,PG,25,MIN,82,54,2355,348,823,124,315,224,508,207,234,35,191,226,450,66,17,138,169,1027
38,Mookie Blaylock,PG,34,GSW,35,0,599,50,146,15,42,35,104,4,8,8,44,52,114,24,4,37,20,119
39,Corie Blount,PF,33,PHI,72,21,1426,115,251,0,1,115,250,29,45,149,219,368,44,49,26,52,176,259
40,Mark Blount,C,26,BOS,44,0,415,32,76,0,0,32,76,30,37,26,59,85,10,16,19,23,59,94
41,Calvin Booth,C,25,SEA,15,15,279,35,82,0,0,35,82,23,24,20,34,54,16,6,13,16,47,93
42,Ruben Boumtje-Boumtje,C,23,POR,33,1,245,13,32,0,0,13,32,13,25,21,34,55,4,3,16,14,38,39
43,Cal Bowdler,PF,24,ATL,52,0,585,61,174,1,5,60,169,39,47,38,72,110,11,18,15,11,64,162
44,Bruce Bowen,SF,30,SAS,59,59,1699,155,398,56,148,99,250,46,96,42,120,162,88,62,25,66,116,412
45,Ryan Bowen,SF,26,DEN,75,21,1686,147,307,1,12,146,295,69,92,134,165,299,52,75,41,41,171,364
46,Ira Bowman,SG,28,PHI,3,0,29,5,7,0,1,5,6,0,0,0,1,1,1,2,0,0,3,10
47,Earl Boykins,PG,25,LAC,68,2,761,110,275,13,42,97,233,47,61,27,27,54,145,20,2,44,44,280
48,Michael Bradley,PF,22,TOR,26,0,118,13,25,0,2,13,23,4,8,7,17,24,3,0,6,6,10,30
49,Shawn Bradley,C,29,DAL,53,16,757,78,163,0,1,78,162,59,64,53,123,176,20,28,64,25,128,215
50,Elton Brand,PF,22,LAC,80,80,3020,532,1010,0,0,532,1010,389,524,396,529,925,191,80,163,173,254,1453
51,Terrell Brandon,PG,31,MIN,32,28,962,155,365,4,23,151,342,83,84,17,76,93,264,52,6,43,49,397
52,Jamison Brewer,SG,21,IND,13,0,43,2,5,0,1,2,4,0,0,2,6,8,9,2,0,3,3,4
53,Primož Brezec,C,22,IND,22,4,160,14,29,0,0,14,29,15,25,16,12,28,6,0,7,6,28,43
54,Chucky Brown,SF,33,SAC,18,0,92,10,27,0,0,10,27,1,2,10,23,33,6,2,4,5,12,21
55,Damone Brown,SF,22,PHI,17,0,67,8,21,0,1,8,20,7,8,2,2,4,2,1,1,9,11,23
56,Dee Brown,PG,33,ORL,7,0,65,3,20,1,12,2,8,0,0,0,9,9,2,3,1,4,4,7
57,Ernest Brown,C,22,MIA,3,0,21,1,6,0,0,1,6,1,4,1,5,6,0,0,1,3,4,3
58,Kedrick Brown,SF,20,BOS,29,5,245,23,70,5,27,18,43,12,20,11,39,50,15,18,7,7,18,63
59,Kwame Brown,PF,19,WAS,57,3,817,94,243,0,1,94,242,70,99,63,135,198,43,16,26,43,105,258
60,P.J. Brown,C,32,CHH,80,80,2563,250,527,0,0,250,527,169,197,273,513,786,107,59,78,85,222,669
61,Randy Brown,PG,33,BOS,1,0,6,0,1,0,0,0,1,0,0,0,0,0,2,0,1,0,1,0
62,Tierre Brown,SG,22,HOU,40,1,403,49,115,4,12,45,103,21,28,12,30,42,70,19,3,40,26,123
63,Rick Brunson,PG,29,POR,59,2,520,45,113,6,11,39,102,29,41,23,45,68,114,25,2,47,51,125
64,Kobe Bryant,SG,23,LAL,80,80,3063,749,1597,33,132,716,1465,488,589,112,329,441,438,118,35,223,228,2019
65,Mark Bryant,PF,36,SAS,30,3,206,25,55,0,0,25,55,6,8,25,19,44,10,7,2,6,38,56
66,Greg Buckner,SG,25,DAL,44,16,885,104,198,5,16,99,182,40,58,67,106,173,48,31,19,27,124,253
67,Jud Buechler,SF,33,TOT,66,2,684,44,118,21,60,23,58,2,4,29,87,116,32,21,8,15,53,111
68,Rodney Buford,SG,24,MEM,63,21,1769,258,593,17,70,241,523,58,80,52,220,272,71,42,12,63,110,591
69,Matt Bullard,PF,34,CHH,31,0,350,39,115,16,57,23,58,11,12,10,37,47,16,2,2,12,29,105
70,Mitchell Butler,SG,31,POR,11,0,90,10,23,1,3,9,20,8,12,6,8,14,5,0,1,5,10,29
71,Jason Caffey,PF,28,MIL,23,0,283,36,72,0,1,36,71,27,43,24,26,50,12,4,5,19,39,99
72,Marcus Camby,C,27,NYK,29,29,1007,130,290,0,1,130,289,62,99,89,233,322,33,34,50,42,107,322
73,Elden Campbell,PF,33,CHH,77,74,2156,384,794,0,2,384,792,306,384,133,397,530,102,60,137,138,264,1074
74,Brian Cardinal,PF,24,DET,8,0,43,6,13,3,7,3,6,2,2,2,4,6,2,1,0,0,5,17
75,Anthony Carter,PG,26,MIA,46,18,1050,89,260,1,19,88,241,19,36,19,98,117,214,50,3,72,85,198
76,Vince Carter,SG,25,TOR,60,60,2385,559,1307,121,313,438,994,245,307,138,175,313,239,94,43,154,191,1484
77,Sam Cassell,PG,32,MIL,74,73,2605,554,1197,71,204,483,993,282,328,54,258,312,493,90,12,177,208,1461
78,Kelvin Cato,C,27,HOU,75,73,1917,190,326,0,1,190,325,113,194,176,349,525,29,40,95,53,208,493
79,Tyson Chandler,C,19,CHI,71,31,1389,151,304,0,0,151,304,134,222,114,229,343,54,28,93,99,179,436
80,Calbert Cheaney,SG,30,DEN,68,47,1631,224,466,0,4,224,462,46,67,57,183,240,110,34,21,70,156,494
81,Chris Childs,PG,34,TOR,69,4,1576,97,296,33,120,64,176,58,71,18,136,154,351,56,5,123,177,285
82,Doug Christie,SG,31,SAC,81,81,2798,338,735,90,256,248,479,206,242,74,300,374,340,160,25,164,209,972
83,Keon Clark,C,26,TOR,81,31,2185,380,775,0,5,380,770,155,230,182,421,603,88,58,122,140,258,915
84,Speedy Claxton,PG,23,PHI,67,18,1528,181,452,4,33,177,419,114,136,46,114,160,198,95,6,95,145,480
85,Mateen Cleaves,PG,24,SAC,32,0,153,30,68,2,8,28,60,8,9,1,7,8,25,7,0,27,9,70
86,Derrick Coleman,PF,34,PHI,58,58,2080,331,735,28,83,303,652,185,227,167,342,509,98,42,51,119,158,875
87,Bimbo Coles,PG,33,CLE,47,1,693,56,146,4,20,52,126,33,37,12,43,55,107,13,4,31,59,149
88,Jason Collier,C,24,HOU,25,2,365,41,95,0,1,41,94,24,32,31,51,82,9,6,4,13,40,106
89,Jarron Collins,C,23,UTA,70,68,1440,158,343,0,1,158,342,134,181,138,158,296,58,29,22,56,234,450
90,Jason Collins,C,23,NJN,77,9,1407,117,278,1,2,116,276,115,164,132,169,301,81,29,47,72,173,350
91,Chris Crawford,PF,26,ATL,7,4,131,21,45,0,1,21,44,11,15,9,16,25,5,2,5,10,21,53
92,Jamal Crawford,PG,21,CHI,23,6,481,89,187,26,58,63,129,10,13,5,29,34,55,18,5,32,18,214
93,Joe Crispin,PG,22,TOT,21,0,156,26,68,15,39,11,29,12,13,2,9,11,26,5,0,10,10,79
94,Austin Croshere,PF,26,IND,76,1,1286,185,448,49,145,136,303,97,114,74,220,294,77,26,29,67,106,516
95,John Crotty,PG,32,UTA,41,0,802,98,208,31,69,67,139,57,66,16,59,75,141,19,1,51,77,284
96,Vonteego Cummings,PG,25,PHI,58,1,501,78,187,12,46,66,141,24,32,14,38,52,60,18,5,36,53,192
97,Dell Curry,SG,37,TOR,56,4,886,141,347,45,131,96,216,33,37,23,58,81,61,22,6,41,50,360
98,Eddy Curry,C,19,CHI,72,31,1150,189,377,0,0,189,377,105,160,111,161,272,25,16,53,69,173,483
99,Michael Curry,SG,33,DET,82,75,1912,125,276,7,26,118,250,72,91,15,153,168,127,47,10,60,207,329
100,Samuel Dalembert,C,20,PHI,34,0,177,22,50,0,0,22,50,7,18,25,43,68,5,6,13,14,30,51
101,Erick Dampier,C,26,GSW,73,46,1740,209,480,0,0,209,480,136,211,167,220,387,87,17,167,156,235,554
102,Antonio Daniels,SG,26,SAS,82,13,2175,269,612,57,196,212,416,158,210,23,153,176,228,48,12,70,104,753
103,Antonio Davis,PF,33,TOR,77,77,2978,410,963,0,1,410,962,293,358,254,486,740,155,54,83,159,225,1113
104,Baron Davis,PG,22,CHH,82,82,3318,559,1341,170,478,389,863,196,338,93,256,349,698,172,47,246,241,1484
105,Dale Davis,C,32,POR,78,77,2447,296,580,0,0,296,580,150,212,262,426,688,96,62,83,62,193,742
106,Emanual Davis,PG,33,ATL,28,20,774,70,198,29,85,41,113,16,18,19,55,74,68,27,5,52,68,185
107,Hubert Davis,SG,31,WAS,51,17,1231,146,326,57,126,89,200,16,21,7,70,77,107,28,3,44,58,365
108,Ricky Davis,SF,22,CLE,82,8,1954,376,781,11,35,365,746,196,248,63,180,243,178,69,23,148,145,959
109,Andrew DeClercq,C,28,ORL,61,14,633,67,149,0,0,67,149,28,50,74,89,163,22,23,24,34,130,162
110,Vinny Del Negro,PG,35,PHO,2,0,6,1,4,0,0,1,4,0,0,0,0,0,2,0,0,0,0,2
111,Tony Delk,SG,28,TOT,63,17,1447,226,588,67,214,159,374,78,97,58,145,203,132,53,10,59,98,597
112,Derrick Dial,SG,26,TOT,32,0,299,41,120,1,11,40,109,18,24,14,42,56,35,10,4,16,13,101
113,Michael Dickerson,SG,26,MEM,4,4,124,15,48,8,21,7,27,5,6,3,9,12,9,3,1,8,12,43
114,DeSagana Diop,C,20,CLE,18,1,109,12,29,0,0,12,29,1,5,5,12,17,5,1,10,12,19,25
115,Vlade Divac*,C,33,SAC,80,80,2420,338,716,3,13,335,703,209,340,205,466,671,297,79,94,158,229,888
116,Michael Doleac,C,24,CLE,42,15,705,78,187,0,0,78,187,38,46,47,121,168,25,15,11,37,98,194
117,Keyon Dooling,PG,21,LAC,14,0,155,22,57,4,14,18,43,10,12,0,3,3,12,4,3,10,20,58
118,Bryce Drew,PG,27,CHH,61,0,774,78,182,31,73,47,109,23,29,14,58,72,101,32,2,33,49,210
119,Predrag Drobnjak,C,26,SEA,64,12,1174,191,414,0,2,191,412,55,73,75,144,219,51,20,31,51,109,437
120,Chris Dudley,C,36,POR,43,2,327,20,50,0,2,20,48,8,15,27,53,80,13,3,14,14,42,48
121,Tim Duncan,PF,25,SAS,82,82,3329,764,1504,1,10,763,1494,560,701,268,774,1042,307,61,203,263,217,2089
122,Howard Eisley,PG,29,NYK,39,0,609,59,175,14,58,45,117,39,49,9,40,49,100,24,3,53,55,171
123,Obinna Ekezie,PF,26,LAC,29,1,152,13,39,0,0,13,39,28,40,12,22,34,3,2,6,10,16,54
124,LaPhonso Ellis,SF,31,MIA,66,14,1684,189,452,38,124,151,328,53,84,107,180,287,56,30,37,73,196,469
125,Evan Eschmeyer,C,26,DAL,31,6,299,21,50,0,0,21,50,20,33,35,63,98,9,10,9,16,60,62
126,Maurice Evans,SG,23,MIN,10,0,45,9,19,0,3,9,16,3,4,3,1,4,4,0,0,2,9,21
127,Patrick Ewing*,C,39,ORL,65,4,901,148,333,0,1,148,332,94,134,60,203,263,35,22,45,65,129,390
128,Danny Ferry,SF,35,SAS,50,2,799,76,177,43,99,33,78,34,36,15,75,90,48,16,9,22,70,229
129,Michael Finley,SF,28,DAL,69,69,2754,569,1228,76,224,493,1004,210,251,90,270,360,230,65,25,117,144,1424
130,Derek Fisher,PG,27,LAL,70,35,1974,274,666,144,349,130,317,94,111,15,131,146,181,66,9,62,121,786
131,Marcus Fizer,PF,23,CHI,76,20,1963,371,848,7,41,364,807,189,283,128,299,427,120,49,24,131,186,938
132,Isaac Fontaine,SG,26,MEM,6,0,75,3,14,1,5,2,9,4,6,0,5,5,4,0,0,4,6,11
133,Alton Ford,PF,20,PHO,53,0,452,61,118,0,0,61,118,42,57,32,75,107,7,6,7,32,99,164
134,Joseph Forte,SG,20,BOS,8,0,39,1,12,0,3,1,9,4,4,1,5,6,6,2,0,3,1,6
135,Danny Fortson,PF,25,GSW,77,76,2216,309,722,1,4,308,718,245,308,290,609,899,127,44,17,160,255,864
136,Greg Foster,PF,33,MIL,6,0,24,2,9,0,4,2,5,3,4,0,8,8,1,0,0,0,4,7
137,Jeff Foster,C,25,IND,82,48,1786,177,394,2,15,175,379,111,182,206,350,556,70,71,38,79,232,467
138,Antonis Fotsis,PF,20,MEM,28,1,320,42,104,7,23,35,81,17,20,25,37,62,10,9,11,21,22,108
139,Tremaine Fowlkes,SF,25,LAC,22,17,343,25,64,0,0,25,64,24,31,32,32,64,17,11,1,13,39,74
140,Rick Fox,SF,32,LAL,82,82,2289,255,605,65,208,190,397,70,85,90,299,389,283,67,21,132,244,645
141,Adonal Foyle,C,26,GSW,79,36,1485,171,385,0,0,171,385,37,93,150,234,384,41,36,168,76,179,379
142,Steve Francis,PG,24,HOU,57,56,2343,420,1007,68,210,352,797,326,422,102,299,401,362,71,25,221,172,1234
143,Lawrence Funderburke,PF,31,SAC,56,1,722,115,245,0,3,115,242,34,56,76,122,198,32,11,18,33,65,264
144,Kevin Garnett,PF,25,MIN,81,81,3175,659,1401,37,116,622,1285,359,448,243,738,981,422,96,126,229,184,1714
145,Dean Garrett,C,35,TOT,34,0,183,18,55,0,0,18,55,0,3,16,41,57,5,7,10,10,32,36
146,Pat Garrity,PF,25,ORL,80,43,2406,327,767,169,396,158,371,61,73,77,261,338,99,61,28,68,230,884
147,Pau Gasol,C,21,MEM,82,79,3007,551,1064,1,5,550,1059,338,477,238,492,730,223,41,169,224,195,1441
148,Chris Gatling,PF,34,MIA,54,1,809,131,293,1,8,130,285,82,117,71,135,206,25,17,11,58,109,345
149,Matt Geiger,C,32,PHI,4,0,36,1,8,0,0,1,8,1,2,3,3,6,0,0,2,2,2,3
150,Devean George,SF,24,LAL,82,1,1759,215,523,66,178,149,345,85,126,78,225,303,111,71,42,66,190,581
151,Eddie Gill,PG,23,MEM,23,5,384,39,92,7,22,32,70,31,39,7,21,28,49,11,3,34,38,116
152,Kendall Gill,SG,33,MIA,65,49,1410,162,422,6,44,156,378,42,62,29,155,184,100,44,8,55,140,372
153,Dion Glover,SG,23,ATL,55,25,1156,192,456,30,91,162,365,78,103,36,133,169,84,45,14,76,89,492
154,Steve Goodrich,SF,25,NJN,9,0,50,2,10,0,0,2,10,1,2,1,4,5,5,1,2,3,10,5
155,Brian Grant,PF,29,MIA,72,72,2256,286,610,0,2,286,608,101,119,168,407,575,137,48,31,122,236,673
156,Horace Grant,C,36,ORL,76,76,2210,264,515,0,0,264,515,80,111,159,322,481,104,57,49,51,118,608
157,Adrian Griffin,SG,27,DAL,58,34,1383,179,359,16,54,163,305,41,49,68,161,229,106,75,12,42,142,415
158,Eddie Griffin,PF,19,HOU,73,24,1896,244,666,90,273,154,393,64,86,117,299,416,53,17,134,47,117,642
159,Tom Gugliotta,PF,32,PHO,44,40,1129,127,301,3,9,124,292,28,37,59,162,221,77,39,30,61,116,285
160,A.J. Guyton,PG,23,CHI,45,6,607,88,244,46,123,42,121,22,27,12,32,44,81,10,7,37,23,244
161,Darvin Ham,SF,28,MIL,70,2,1208,120,211,1,7,119,204,62,123,91,111,202,73,25,37,83,175,303
162,Richard Hamilton,SG,23,WAS,63,57,2203,472,1084,16,42,456,1042,300,337,73,143,216,171,38,14,132,136,1260
163,Tang Hamilton,SF,23,MIA,9,2,98,10,19,0,1,10,18,0,1,6,12,18,5,4,0,2,10,20
164,Zendon Hamilton,PF,26,DEN,54,15,848,103,245,0,0,103,245,118,181,110,143,253,14,21,18,60,104,324
165,Anfernee Hardaway,SG,30,PHO,80,55,2462,389,931,23,83,366,848,158,195,98,252,350,324,122,32,189,184,959
166,Tim Hardaway,PG,35,TOT,68,16,1601,226,620,123,354,103,266,77,97,14,110,124,278,57,10,111,109,652
167,Matt Harpring,SF,25,PHI,81,81,2541,386,838,21,69,365,769,165,222,203,370,573,107,70,5,127,201,958
168,Al Harrington,PF,21,IND,44,1,1313,230,484,1,3,229,481,115,144,96,180,276,54,41,21,78,166,576
169,Othella Harrington,PF,28,NYK,77,4,1563,237,450,0,2,237,448,122,172,125,224,349,37,30,36,95,250,596
170,Lucious Harris,SG,31,NJN,74,0,1553,249,537,44,118,205,419,133,158,49,158,207,116,53,6,61,99,675
171,Jason Hart,PG,23,SAS,10,0,92,10,19,0,2,10,17,6,6,4,9,13,12,7,1,8,16,26
172,Antonio Harvey,PF,31,SEA,5,3,47,4,12,0,0,4,12,1,2,5,4,9,5,1,3,3,8,9
173,Donnell Harvey,PF,21,TOT,47,4,841,108,217,0,0,108,217,54,90,80,147,227,37,21,24,33,115,270
174,Trenton Hassell,SG,22,CHI,78,47,2237,267,628,60,165,207,463,87,114,65,190,255,172,55,44,101,184,681
175,Kirk Haston,PF,22,CHH,15,0,77,11,39,0,3,11,36,4,8,5,15,20,5,0,1,3,9,26
176,Brendan Haywood,C,22,WAS,62,2,1266,109,221,0,0,109,221,97,160,143,179,322,29,21,91,50,158,315
177,Alan Henderson,PF,29,ATL,26,1,422,59,116,1,1,58,115,24,45,31,66,97,11,11,15,21,40,143
178,Cedric Henderson,SF,26,GSW,12,0,70,15,31,2,4,13,27,4,7,1,2,3,4,6,2,8,4,36
179,Grant Hill*,SF,29,ORL,14,14,512,83,195,0,2,83,193,69,80,29,96,125,64,8,4,37,40,235
180,Tyrone Hill,PF,33,CLE,26,26,810,71,182,0,1,71,181,67,103,79,195,274,23,17,13,48,102,209
181,Fred Hoiberg,SG,29,CHI,79,8,1408,121,291,24,92,97,199,79,94,18,192,210,136,61,5,32,87,345
182,Robert Horry,PF,31,LAL,81,23,2140,183,460,76,203,107,257,108,138,130,349,479,232,77,89,88,208,550
183,Eddie House,PG,23,MIA,64,3,1230,209,524,54,157,155,367,42,49,17,93,110,123,43,5,80,98,514
184,Allan Houston,SG,30,NYK,77,77,2914,568,1301,136,346,432,955,295,339,37,215,252,190,54,10,170,182,1567
185,Juwan Howard,PF,28,TOT,81,72,2635,462,1005,0,2,462,1003,261,343,223,389,612,169,46,47,152,265,1185
186,Troy Hudson,PG,25,ORL,81,4,1854,354,815,66,187,288,628,176,201,30,115,145,255,57,6,163,119,950
187,Larry Hughes,SG,23,GSW,73,56,2049,343,810,18,93,325,717,191,259,83,162,245,316,113,23,171,150,895
188,Lindsey Hunter,PG,31,LAL,82,47,1616,187,490,79,208,108,282,20,40,18,103,121,129,66,19,55,120,473
189,Steven Hunter,C,20,ORL,53,21,516,67,147,0,0,67,147,55,94,40,57,97,5,5,43,16,81,189
190,Zydrunas Ilgauskas,C,26,CLE,62,23,1329,241,567,0,5,241,562,208,276,136,198,334,70,17,84,94,187,690
191,Allen Iverson*,SG,26,PHI,60,59,2622,665,1669,78,268,587,1401,475,585,44,225,269,331,168,13,237,102,1883
192,Bobby Jackson,PG,28,SAC,81,3,1750,334,754,79,219,255,535,149,184,82,169,251,164,73,11,93,145,896
193,Jaren Jackson,SG,34,ORL,9,0,144,15,37,7,20,8,17,2,4,1,16,17,8,5,0,8,13,39
194,Jermaine Jackson,SG,25,TOR,24,0,280,20,42,1,2,19,40,16,24,3,24,27,57,9,1,14,24,57
195,Jim Jackson,SF,31,MIA,55,19,1825,238,538,38,81,200,457,75,87,54,236,290,140,42,14,106,145,589
196,Marc Jackson,C,27,TOT,39,0,495,60,164,0,1,60,163,66,80,48,80,128,14,11,6,30,69,186
197,Mark Jackson,PG,36,NYK,82,82,2367,260,592,79,195,181,397,87,110,56,253,309,605,74,1,150,162,686
198,Stephen Jackson,SF,23,SAS,23,1,227,34,91,9,36,25,55,12,17,3,23,26,11,15,3,23,29,89
199,Jerome James,C,26,SEA,56,40,949,134,273,0,0,134,273,30,60,89,143,232,24,25,86,74,174,298
200,Mike James,PG,26,MIA,15,0,119,15,43,8,21,7,22,4,7,2,12,14,19,6,1,13,17,42
201,Tim James,SF,25,PHI,9,0,41,5,13,0,0,5,13,2,6,5,2,7,1,0,1,3,5,12
202,Antawn Jamison,SF,25,GSW,82,82,3033,614,1375,68,210,546,1165,323,440,211,345,556,161,70,45,161,187,1619
203,Harold Jamison,PF,25,LAC,25,2,176,22,43,0,0,22,43,10,15,24,15,39,6,5,1,6,23,54
204,Richard Jefferson,SF,21,NJN,79,9,1917,270,591,13,56,257,535,189,265,85,208,293,140,64,48,107,211,742
205,Anthony Johnson,SG,27,NJN,34,0,366,37,90,4,12,33,78,16,25,10,19,29,48,31,1,20,30,94
206,Avery Johnson,PG,36,TOT,68,13,1352,207,432,0,5,207,427,121,163,14,55,69,286,40,9,76,86,535
207,DerMarr Johnson,SF,21,ATL,72,46,1727,214,540,89,247,125,293,85,105,59,188,247,81,62,56,102,163,602
208,Ervin Johnson,C,34,MIL,81,9,1660,89,193,0,1,89,192,30,66,142,324,466,27,37,82,52,219,208
209,Joe Johnson,SG,20,TOT,77,60,1916,251,584,38,130,213,454,41,53,75,182,257,179,59,20,71,114,581
210,Alvin Jones,C,23,PHI,23,2,126,8,20,0,0,8,20,10,20,13,23,36,3,3,9,11,35,26
211,Damon Jones,PG,25,DET,67,0,1083,114,284,69,186,45,98,43,59,13,90,103,140,23,1,61,83,340
212,Eddie Jones,SG,30,MIA,81,81,3156,517,1198,149,382,368,816,297,355,61,317,378,262,117,77,148,258,1480
213,Jumaine Jones,PF,22,CLE,81,36,2142,287,640,52,168,235,472,45,68,125,365,490,116,75,46,79,184,671
214,Popeye Jones,PF,31,WAS,79,40,1920,222,508,4,11,218,497,106,130,233,345,578,127,50,19,88,209,554
215,Michael Jordan*,SF,38,WAS,60,53,2093,551,1324,10,53,541,1271,263,333,50,289,339,310,85,26,162,119,1375
216,Shawn Kemp,PF,32,POR,75,5,1232,175,407,0,4,175,403,104,131,90,198,288,52,43,33,81,184,454
217,Steve Kerr,PG,36,POR,65,0,775,102,217,26,66,76,151,39,40,6,54,60,63,13,1,24,49,269
218,Jason Kidd*,PG,28,NJN,82,82,3056,445,1138,117,364,328,774,201,247,130,465,595,808,175,20,286,136,1208
219,Andrei Kirilenko,SF,20,UTA,82,40,2151,285,633,25,100,260,533,285,371,149,253,402,94,116,159,108,156,880
220,Kerry Kittles,SG,27,NJN,82,82,2601,438,940,98,242,340,698,128,172,68,207,275,216,130,31,109,108,1102
221,Brevin Knight,PG,26,MEM,53,11,1151,141,334,2,8,139,326,87,115,11,98,109,302,79,7,111,135,371
222,Travis Knight,C,27,NYK,49,0,429,41,113,0,0,41,113,16,21,48,56,104,8,11,10,27,95,98
223,Toni Kukoč,SF,33,ATL,59,9,1494,211,504,53,171,158,333,109,153,43,175,218,210,48,17,113,91,584
224,Christian Laettner,PF,32,WAS,57,48,1441,168,362,2,10,166,352,66,76,74,227,301,151,60,25,85,129,404
225,Raef LaFrentz,C,25,TOT,78,76,2455,421,920,104,268,317,652,105,151,176,403,579,89,55,213,94,281,1051
226,Trajan Langdon,SG,25,CLE,44,0,477,70,176,27,74,43,102,42,46,13,42,55,60,13,5,40,49,209
227,Dan Langhi,SF,24,HOU,34,8,434,49,125,1,4,48,121,8,11,22,45,67,14,8,5,9,25,107
228,Rusty LaRue,PG,28,UTA,33,0,542,73,185,17,50,56,135,30,35,11,38,49,71,17,7,43,58,193
229,Voshon Lenard,SG,28,DEN,71,19,1665,315,769,89,240,226,529,94,120,38,145,183,130,59,25,91,105,813
230,Quincy Lewis,SG,24,UTA,36,19,490,64,143,3,18,61,125,13,20,10,33,43,36,23,9,32,89,144
231,Rashard Lewis,SF,22,SEA,71,70,2585,455,972,123,316,332,656,162,200,139,359,498,123,104,40,97,174,1195
232,Randy Livingston,PG,26,SEA,13,0,176,15,54,1,8,14,46,10,11,9,16,25,26,9,2,2,11,41
233,Art Long,PF,29,SEA,63,27,989,120,244,0,0,120,244,45,85,107,144,251,41,22,28,63,180,285
234,Grant Long,PF,35,MEM,66,56,1868,164,385,3,17,161,368,86,123,31,200,231,136,63,12,103,123,417
235,Felipe López,SG,27,MIN,67,0,581,59,156,14,33,45,123,37,55,29,51,80,39,18,1,36,73,169
236,Tyronn Lue,PG,24,WAS,71,0,1458,222,520,63,141,159,379,48,63,14,108,122,246,49,0,96,120,555
237,George Lynch,SF,31,CHH,45,18,893,73,198,1,6,72,192,25,40,70,116,186,54,40,14,41,75,172
238,Todd MacCulloch,C,26,NJN,62,61,1502,247,465,0,0,247,465,110,164,157,221,378,78,24,89,66,181,604
239,Sam Mack,SF,31,MIA,12,1,159,14,49,7,28,7,21,5,7,2,12,14,4,5,1,7,17,40
240,Mark Madsen,PF,26,LAL,59,5,650,66,146,0,2,66,144,35,54,89,73,162,44,16,13,22,104,167
241,Corey Maggette,SG,22,LAC,63,52,1615,235,530,46,139,189,391,201,251,54,177,231,112,41,19,116,155,717
242,Jamaal Magloire,C,23,CHH,82,8,1549,228,414,0,1,228,413,243,333,153,308,461,31,27,86,118,201,699
243,Dan Majerle,SG,36,PHO,65,1,1180,99,289,79,235,20,54,23,39,28,148,176,90,48,15,35,104,300
244,Karl Malone*,PF,38,UTA,80,80,3040,635,1399,9,25,626,1374,509,639,142,544,686,341,152,59,263,229,1788
245,Danny Manning,PF,35,DAL,41,10,552,71,149,1,7,70,142,22,33,25,83,108,30,21,21,25,80,165
246,Stephon Marbury,PG,24,PHO,82,80,3187,625,1413,71,248,554,1165,353,452,75,191,266,666,77,13,284,186,1674
247,Shawn Marion,SF,23,PHO,81,81,3109,654,1395,48,122,606,1273,191,226,211,592,803,162,149,86,144,214,1547
248,Sean Marks,C,26,MIA,21,6,319,38,88,0,0,38,88,20,34,19,56,75,8,5,10,19,40,96
249,Donny Marshall,SF,29,NJN,20,0,118,8,29,2,4,6,25,12,18,8,13,21,5,3,0,2,14,30
250,Donyell Marshall,SF,28,UTA,58,42,1750,343,661,13,42,330,619,160,226,158,285,443,101,50,67,124,150,859
251,Darrick Martin,PG,30,DAL,3,0,22,0,10,0,2,0,8,1,2,0,1,1,3,2,0,1,4,1
252,Kenyon Martin,PF,24,NJN,73,73,2504,445,962,15,67,430,895,181,267,113,275,388,192,90,121,172,261,1086
253,Jamal Mashburn,SF,29,CHH,40,40,1601,303,744,41,112,262,632,211,241,31,211,242,171,45,6,110,80,858
254,Anthony Mason,PF,35,MIL,82,82,3143,316,626,1,1,315,625,154,221,124,522,646,346,57,22,130,187,787
255,Desmond Mason,SF,24,SEA,75,20,2420,357,769,16,59,341,710,201,237,92,259,351,104,67,27,104,170,931
256,Tony Massenburg,PF,34,MEM,73,31,1247,159,349,1,1,158,348,84,117,100,224,324,26,30,31,65,174,403
257,Walter McCarty,PF,27,BOS,56,0,718,80,180,39,99,41,81,13,19,32,96,128,41,18,7,22,83,212
258,Amal McCaskill,C,28,SAS,27,0,153,20,49,0,0,20,49,12,26,16,20,36,4,6,10,14,23,52
259,George McCloud,SF,34,DEN,69,26,1830,206,576,60,222,146,354,132,163,67,184,251,204,58,19,144,175,604
260,Jelani McCoy,C,24,LAL,21,0,104,12,21,0,0,12,21,2,8,8,17,25,7,0,5,8,14,26
261,Antonio McDyess,PF,27,DEN,10,10,236,43,75,0,0,43,75,27,33,18,37,55,18,10,8,20,20,113
262,Tracy McGrady*,SG,22,ORL,76,76,2912,715,1586,103,283,612,1303,415,555,150,447,597,400,119,73,189,139,1948
263,Jeff McInnis,PG,27,LAC,81,80,3030,463,1121,75,234,388,887,183,219,45,168,213,500,63,6,147,202,1184
264,Derrick McKey,SF,35,PHI,41,1,784,52,122,5,12,47,110,10,14,48,79,127,45,41,4,22,90,119
265,Aaron McKie,SG,29,PHI,48,16,1471,220,490,51,128,169,362,96,122,26,166,192,179,56,14,93,74,587
266,Stanislav Medvedenko,C,22,LAL,71,6,729,145,304,0,4,145,300,41,62,85,73,158,43,29,11,42,119,331
267,Ron Mercer,SG,25,TOT,53,41,1716,311,784,18,62,293,722,95,119,50,128,178,128,32,13,88,108,735
268,Chris Mihm,C,22,CLE,74,60,1659,221,526,3,7,218,519,124,179,133,259,392,24,18,89,97,260,569
269,Darius Miles,SF,20,LAC,82,6,2227,309,642,3,19,306,623,158,255,109,344,453,184,71,103,160,184,779
270,Andre Miller,PG,25,CLE,81,81,3023,474,1045,22,87,452,958,365,447,108,271,379,882,126,34,245,228,1335
271,Brad Miller,C,25,TOT,76,75,2263,366,733,3,7,363,726,297,383,252,369,621,152,76,41,115,244,1032
272,Mike Miller,SF,21,ORL,63,53,2123,351,802,116,303,235,499,138,181,49,224,273,198,47,23,108,145,956
273,Reggie Miller*,SG,36,IND,79,79,2889,414,913,180,443,234,470,296,325,23,196,219,253,88,10,120,143,1304
274,Chris Mills,SF,32,GSW,66,0,1237,178,427,48,127,130,300,85,107,51,139,190,72,31,13,56,120,489
275,Sam Mitchell,SF,38,MIN,74,10,726,98,227,10,35,88,192,38,49,18,64,82,45,12,4,26,79,244
276,Cuttino Mobley,SG,26,HOU,74,74,3116,595,1358,149,377,446,981,267,314,63,237,300,187,109,37,180,189,1606
277,Nazr Mohammed,C,24,ATL,82,73,2168,329,713,0,1,329,712,137,222,242,409,651,33,63,61,118,252,795
278,Jérôme Moïso,C,23,CHH,15,0,76,8,20,0,0,8,20,0,0,4,21,25,4,3,2,8,12,16
279,Eric Montross,C,30,TOR,49,24,655,53,132,0,1,53,131,10,31,36,104,140,16,12,23,25,92,116
280,Mikki Moore,C,26,DET,30,0,217,29,61,1,2,28,59,20,26,22,31,53,11,7,9,14,35,79
281,Terence Morris,SF,23,HOU,68,12,1110,111,289,15,78,96,211,18,28,77,134,211,64,21,27,45,72,255
282,Hanno Möttölä,C,25,ATL,82,14,1371,169,384,1,13,168,371,57,76,81,187,268,50,20,19,70,174,396
283,Alonzo Mourning*,C,31,MIA,75,74,2455,447,866,1,3,446,863,283,431,182,450,632,87,27,186,182,258,1178
284,Troy Murphy,PF,21,GSW,82,4,1448,178,423,3,9,175,414,121,156,99,223,322,70,36,21,84,217,480
285,Lamond Murray,SF,28,CLE,71,68,2312,430,986,101,238,329,748,215,263,81,291,372,157,70,43,141,148,1176
286,Tracy Murray,SF,30,TOR,40,3,473,85,207,40,104,45,103,17,21,18,35,53,19,11,8,25,38,227
287,Dikembe Mutombo*,C,35,PHI,80,80,2907,321,641,0,0,321,641,278,364,254,609,863,83,29,190,156,242,920
288,Mamadou N'Diaye,C,26,TOR,5,0,46,6,10,0,0,6,10,8,10,6,5,11,0,0,2,1,6,20
289,Lee Nailon,SF,26,CHH,79,41,1912,369,764,1,2,368,762,112,150,103,188,291,94,59,17,96,175,851
290,Eduardo Nájera,PF,25,DAL,62,11,1357,150,300,0,2,150,298,100,148,149,193,342,38,56,30,40,156,400
291,Steve Nash*,PG,27,DAL,82,82,2837,525,1088,156,343,369,745,260,293,50,204,254,634,53,4,229,164,1466
292,Tyrone Nesby,SF,26,WAS,70,9,1498,183,421,13,47,170,374,64,93,105,213,318,91,61,22,49,164,443
293,Rasho Nesterović,C,25,MIN,82,82,2218,324,657,0,1,324,656,39,71,200,334,534,75,45,109,94,262,687
294,Ira Newble,SF,27,ATL,42,35,1273,131,263,1,7,130,256,75,88,80,142,222,45,38,20,49,117,338
295,Johnny Newman,SF,38,DAL,47,17,724,67,148,22,57,45,91,42,58,9,40,49,14,29,4,21,88,198
296,Moochie Norris,PG,28,HOU,82,26,2249,251,631,36,134,215,497,127,169,73,173,246,403,81,4,156,130,665
297,Dirk Nowitzki,C,23,DAL,76,76,2891,600,1258,139,350,461,908,440,516,120,635,755,186,83,77,145,222,1779
298,Jermaine O'Neal,PF,23,IND,72,72,2707,543,1133,1,14,542,1119,284,413,188,569,757,118,45,166,174,269,1371
299,Shaquille O'Neal*,C,29,LAL,67,66,2422,712,1229,0,1,712,1228,398,717,235,480,715,200,41,137,171,199,1822
300,Charles Oakley,PF,38,CHI,57,36,1383,97,263,1,6,96,257,21,28,72,271,343,114,49,11,87,175,216
301,Lamar Odom,SF,22,LAC,29,25,999,151,360,16,84,135,276,61,93,31,145,176,171,23,36,97,91,379
302,Hakeem Olajuwon*,C,39,TOR,61,37,1378,194,418,0,2,194,416,47,84,98,268,366,66,74,90,98,147,435
303,Dean Oliver,PG,23,GSW,20,0,139,17,46,2,13,15,33,6,9,0,8,8,21,3,0,11,16,42
304,Kevin Ollie,PG,29,TOT,81,17,1723,137,353,1,2,136,351,187,227,25,159,184,291,62,2,106,97,462
305,Michael Olowokandi,C,26,LAC,80,79,2568,384,886,0,0,384,886,117,188,164,547,711,90,55,145,175,217,885
306,Greg Ostertag,C,28,UTA,74,14,1107,91,201,0,0,91,201,63,130,125,188,313,50,15,109,51,152,245
307,Bo Outlaw,PF,30,TOT,83,36,1928,166,299,1,2,165,297,43,102,147,217,364,127,70,92,96,205,376
308,Doug Overton,PG,32,LAC,18,0,130,14,44,7,27,7,17,4,7,1,11,12,13,3,1,12,10,39
309,Olumide Oyedeji,C,20,SEA,36,1,221,22,41,0,0,22,41,11,18,27,52,79,4,4,2,14,36,55
310,Robert Pack,PG,32,MIN,16,0,252,25,68,1,4,24,64,11,15,7,16,23,49,13,0,20,32,62
311,Scott Padgett,PF,25,UTA,75,1,1295,188,395,49,113,139,282,75,102,111,174,285,82,43,13,69,140,500
313,Tony Parker,PG,19,SAS,77,72,2267,268,639,61,189,207,450,108,160,33,164,197,334,89,7,151,166,705
314,Cherokee Parks,C,29,SAS,42,1,234,30,83,0,0,30,83,3,8,24,34,58,10,7,8,14,34,63
315,Ruben Patterson,SF,26,POR,75,13,1765,319,619,9,36,310,583,192,274,155,143,298,107,79,37,114,140,839
316,Gary Payton*,PG,33,SEA,82,82,3301,737,1578,74,236,663,1342,267,335,80,316,396,737,131,26,209,179,1815
317,Anthony Peeler,SG,32,MIN,82,0,2060,288,684,111,283,177,401,50,58,37,169,206,177,61,11,76,137,737
318,Mike Penberthy,PG,27,LAL,3,0,12,1,2,0,0,1,2,3,4,0,2,2,2,2,0,0,0,5
319,Elliot Perry,PG,32,MEM,2,0,48,5,10,0,0,5,10,1,2,0,4,4,7,3,0,7,6,11
320,Wesley Person,SG,30,CLE,78,78,2793,467,944,143,322,324,622,99,124,50,244,294,173,77,37,74,93,1176
321,Morris Peterson,SF,24,TOR,63,56,1988,336,768,84,231,252,537,127,169,91,132,223,153,73,11,86,174,883
322,Eric Piatkowski,SG,31,LAC,71,64,1718,207,471,111,238,96,233,101,113,43,141,184,112,41,12,64,110,626
323,Paul Pierce,SG,24,BOS,82,82,3302,707,1598,210,520,497,1078,520,643,81,485,566,261,154,86,241,237,2144
324,Scottie Pippen*,SF,36,POR,62,60,1996,246,599,54,177,192,422,113,146,77,244,321,363,101,35,171,162,659
325,Scot Pollard,C,26,SAC,80,29,1881,197,358,0,0,197,358,115,166,188,377,565,53,70,76,68,202,509
326,Mark Pope,PF,29,MIL,45,12,426,36,91,4,25,32,66,11,21,20,53,73,17,11,11,15,47,87
327,Terry Porter,PG,38,SAS,72,0,1294,136,321,59,142,77,179,68,83,12,152,164,205,45,16,85,89,399
328,James Posey,SF,25,DEN,73,63,2238,277,736,67,237,210,499,161,203,109,320,429,180,114,39,127,224,782
329,Lavor Postell,SG,23,NYK,23,0,179,28,84,6,26,22,58,31,41,2,14,16,5,6,0,11,7,93
330,Vitaly Potapenko,C,26,BOS,79,9,1343,137,301,0,0,137,301,89,120,167,180,347,30,37,18,63,174,363
331,Brent Price,PG,33,SAC,20,0,89,9,27,4,15,5,12,9,13,4,4,8,9,3,1,10,13,31
332,Joel Przybilla,C,22,MIL,71,62,1128,76,142,0,1,76,141,38,90,78,205,283,21,20,118,43,199,190
333,Vladimir Radmanović,PF,21,SEA,61,16,1230,146,354,66,157,80,197,49,72,45,185,230,81,56,24,72,119,407
334,Zach Randolph,PF,20,POR,41,0,238,48,107,0,0,48,107,18,27,31,38,69,13,7,4,15,29,114
335,Theo Ratliff,C,28,ATL,3,2,82,10,20,0,0,10,20,6,11,5,11,16,1,1,8,7,8,26
336,Željko Rebrača,C,29,DET,74,4,1179,189,374,0,0,189,374,135,175,84,206,290,38,28,73,84,192,513
338,Michael Redd,SG,22,MIL,67,8,1417,294,609,88,198,206,411,91,115,77,147,224,91,42,7,57,96,767
339,Don Reid,PF,28,ORL,68,5,714,90,190,0,0,90,190,44,68,65,111,176,27,20,44,54,180,224
340,Glen Rice,SF,34,HOU,20,20,606,65,167,18,64,47,103,24,30,5,42,47,31,12,3,24,34,172
341,Jason Richardson,SG,21,GSW,80,75,2629,464,1090,82,246,382,844,141,210,124,216,340,236,106,31,160,195,1151
342,Norm Richardson,SG,22,TOT,11,0,67,10,26,4,8,6,18,6,9,3,5,8,2,0,0,3,5,30
343,Quentin Richardson,SG,21,LAC,81,0,2152,400,926,133,349,267,577,143,187,113,221,334,128,78,21,102,142,1076
344,Mitch Richmond*,SG,36,LAL,64,2,709,100,247,18,62,82,185,42,44,14,80,94,57,18,6,40,61,260
345,Isaiah Rider,SG,30,DEN,10,1,173,37,81,6,15,31,66,13,17,10,23,33,12,3,2,14,11,93
346,Clifford Robinson,PF,35,DET,80,80,2855,454,1069,115,304,339,765,143,206,79,307,386,202,89,95,151,243,1166
347,David Robinson*,C,36,SAS,78,78,2303,341,672,0,0,341,672,269,395,191,456,647,94,86,140,104,193,951
348,Eddie Robinson,SF,25,CHI,29,12,653,112,247,2,5,110,242,36,48,24,54,78,37,23,11,36,35,262
349,Glenn Robinson,SF,29,MIL,66,63,2346,536,1147,58,178,478,969,236,282,70,336,406,168,97,41,174,173,1366
350,Larry Robinson,SG,34,NYK,2,0,10,1,4,1,2,0,2,0,0,0,2,2,0,0,0,0,1,3
351,Carlos Rogers,C,30,IND,22,1,168,24,43,1,6,23,37,10,19,14,24,38,3,5,6,5,17,59
352,Rodney Rogers,SF,30,TOT,77,8,1880,356,756,88,235,268,521,117,149,129,219,348,112,66,29,108,226,917
353,Sean Rooks,C,32,LAC,61,2,728,81,194,0,0,81,194,21,29,32,92,124,25,12,21,20,114,183
354,Jalen Rose,SF,29,TOT,83,83,3153,663,1458,89,246,574,1212,281,335,43,330,373,355,78,45,201,251,1696
355,Malik Rose,PF,27,SAS,82,1,1725,293,633,1,12,292,621,185,257,172,320,492,61,70,42,140,208,772
356,Michael Ruffin,PF,25,PHI,15,0,169,7,26,0,0,7,26,2,8,23,28,51,5,5,8,11,23,16
357,Bryon Russell,SG,31,UTA,66,40,1998,222,584,77,226,145,358,115,140,79,216,295,136,64,19,110,205,636
358,Daniel Santiago,C,25,PHO,3,0,24,4,8,0,0,4,8,0,0,0,7,7,2,0,1,2,4,8
359,Jeryl Sasser,SG,22,ORL,7,0,36,3,14,0,0,3,14,4,5,3,4,7,2,3,0,2,3,10
360,Kenny Satterfield,PG,20,DEN,36,4,560,73,199,7,27,66,172,36,46,17,35,52,108,31,1,53,43,189
361,Brian Scalabrine,PF,23,NJN,28,0,290,23,67,3,10,20,57,11,15,12,39,51,21,9,2,24,39,60
362,Shawnelle Scott,C,29,DEN,21,10,252,37,75,0,0,37,75,8,20,53,50,103,8,3,6,15,49,82
363,Ansu Sesay,SF,25,SEA,9,0,142,22,44,0,0,22,44,14,20,7,13,20,8,3,2,2,18,58
364,Brian Shaw,PG,35,LAL,58,0,631,61,173,29,88,32,85,18,26,19,93,112,89,25,3,32,43,169
365,Bobby Simmons,SF,21,WAS,30,3,343,43,95,4,14,39,81,22,30,25,27,52,17,13,5,14,31,112
366,Dickey Simpkins,PF,29,ATL,1,0,3,0,0,0,0,0,0,0,0,0,0,0,1,0,0,0,0,0
367,Brian Skinner,PF,25,CLE,65,8,1107,88,162,0,0,88,162,48,79,93,188,281,17,24,61,42,130,224
368,Reggie Slater,PF,31,TOT,8,0,47,7,15,0,0,7,15,7,10,5,4,9,1,1,1,1,3,21
369,Charles Smith,SG,26,SAS,60,22,1141,182,428,35,131,147,297,42,65,34,99,133,80,52,44,59,114,441
370,Jabari Smith,C,24,TOT,23,0,181,26,63,0,3,26,60,21,32,8,20,28,11,6,6,5,31,73
371,Joe Smith,C,26,MIN,72,63,1922,297,581,2,3,295,578,171,206,152,301,453,82,39,59,86,250,767
372,Leon Smith,C,21,ATL,14,0,100,10,26,0,0,10,26,11,17,10,21,31,3,5,1,3,12,31
373,Steve Smith,SG,32,SAS,77,76,2211,310,682,116,246,194,436,159,181,45,148,193,151,54,15,108,158,895
374,Eric Snow,PG,28,PHI,61,61,2225,276,624,3,27,273,597,183,227,33,182,215,400,95,9,138,167,738
375,Will Solomon,SG,23,MEM,62,4,872,113,331,46,162,67,169,49,73,12,56,68,92,35,7,62,76,321
376,Felton Spencer,C,34,NYK,32,8,248,6,26,0,0,6,26,17,33,16,34,50,3,7,8,12,73,29
377,Latrell Sprewell,SF,31,NYK,81,81,3326,573,1419,145,403,428,1016,284,346,59,239,298,313,94,14,223,161,1575
378,Jerry Stackhouse,SF,27,DET,76,76,2685,524,1319,86,300,438,1019,495,577,77,238,315,403,77,37,266,163,1629
379,John Starks,SG,36,UTA,66,1,929,114,310,29,95,85,215,33,41,15,53,68,70,33,0,52,126,290
380,Vladimir Stepania,C,25,MIA,67,4,884,117,249,1,2,116,247,50,104,100,170,270,16,24,44,52,103,285
381,DeShawn Stevenson,SG,20,UTA,67,23,1134,143,371,2,25,141,346,37,53,44,87,131,116,29,24,68,82,325
382,Michael Stewart,C,26,TOR,11,0,93,8,23,0,0,8,23,6,11,12,13,25,3,4,3,4,22,22
383,Bryant Stith,SG,31,CLE,50,5,665,70,188,24,68,46,120,44,52,20,65,85,42,29,6,30,42,208
384,John Stockton*,PG,39,UTA,82,82,2566,401,775,25,78,376,697,275,321,59,204,263,674,152,24,208,209,1102
385,Peja Stojaković,SF,24,SAC,71,71,2649,547,1130,129,310,418,820,283,323,72,301,373,175,81,14,140,120,1506
386,Damon Stoudamire,PG,28,POR,75,71,2796,369,918,104,295,265,623,174,196,78,214,292,490,67,7,149,153,1016
387,Erick Strickland,PG,28,BOS,79,4,1643,190,488,95,247,95,241,131,155,22,191,213,184,56,1,94,145,606
388,Mark Strickland,SF,31,ATL,46,10,654,91,204,1,4,90,200,25,44,41,90,131,20,19,17,28,48,208
389,Rod Strickland,PG,35,MIA,76,64,2294,316,714,8,26,308,688,154,201,49,183,232,463,82,11,159,114,794
390,Bruno Šundov,C,21,IND,22,0,88,16,40,0,1,16,39,0,2,7,14,21,3,3,3,4,16,32
391,Bob Sura,PG,28,GSW,78,5,1780,250,590,42,133,208,457,236,328,89,167,256,275,88,17,133,160,778
392,Stromile Swift,PF,22,MEM,68,14,1805,293,611,0,3,293,608,217,305,161,269,430,50,53,113,122,178,803
393,Wally Szczerbiak,SF,24,MIN,82,82,3117,609,1200,87,191,522,1009,226,272,120,271,391,257,66,21,181,188,1531
394,Jason Terry,SG,24,ATL,78,78,2967,524,1219,172,444,352,775,284,340,40,230,270,444,144,13,181,156,1504
395,Etan Thomas,C,23,WAS,47,0,618,81,151,0,0,81,151,41,74,55,126,181,6,17,35,26,76,203
396,Kenny Thomas,PF,24,HOU,72,71,2484,396,829,0,16,396,813,223,336,158,358,516,137,85,66,143,195,1015
397,Kurt Thomas,C,29,NYK,82,82,2771,463,938,1,6,462,932,216,265,214,533,747,87,71,79,153,341,1143
398,Tim Thomas,SF,24,MIL,74,22,1987,316,753,95,291,221,462,142,179,64,236,300,105,65,32,127,200,869
399,Jamaal Tinsley,PG,23,IND,80,78,2442,289,760,42,175,247,585,131,186,78,220,298,647,138,40,270,248,751
400,Óscar Torres,SG,25,HOU,65,13,1075,135,341,37,126,98,215,82,105,47,75,122,40,25,9,49,64,389
401,Robert Traylor,PF,24,CHH,61,1,678,87,204,1,1,86,203,53,84,67,120,187,37,24,37,45,127,228
402,Gary Trent,PF,27,MIN,64,10,1140,193,381,0,2,193,379,92,144,104,166,270,60,21,27,58,160,478
403,Jeff Trepagnier,SG,22,CLE,12,0,77,7,23,0,1,7,22,4,7,3,9,12,12,8,4,11,8,18
404,Jake Tsakalidis,C,22,PHO,67,47,1582,190,400,0,1,190,399,111,159,130,244,374,23,23,69,78,193,491
405,Hedo Türkoğlu,SF,22,SAC,80,10,1970,290,687,63,171,227,516,167,230,63,300,363,163,57,31,81,184,810
407,Keith Van Horn,SF,26,NJN,81,81,2465,471,1089,101,293,370,796,156,195,137,472,609,164,63,42,146,221,1199
408,Ratko Varda,C,22,DET,1,0,6,2,3,0,0,2,3,1,1,0,1,1,0,0,0,1,3,5
409,Jacque Vaughn,PG,26,ATL,82,16,1856,206,438,24,54,182,384,104,126,18,150,168,349,65,2,112,183,540
410,Jake Voskuhl,C,24,PHO,59,34,900,107,193,0,0,107,193,82,109,103,147,250,18,11,23,48,139,296
411,Antoine Walker,PF,25,BOS,81,81,3406,666,1689,222,645,444,1044,240,324,150,564,714,407,122,38,251,237,1794
412,Samaki Walker,PF,25,LAL,69,63,1655,187,365,0,0,187,365,86,129,129,352,481,64,28,88,53,170,460
413,Ben Wallace,C,27,DET,80,80,2921,255,480,0,3,255,477,99,234,318,721,1039,115,138,278,70,178,609
414,Gerald Wallace,SF,19,SAC,54,1,430,75,175,0,7,75,168,23,46,49,40,89,27,19,6,22,46,173
415,John Wallace,SF,27,PHO,46,0,490,93,214,5,13,88,201,40,46,27,58,85,29,11,9,29,60,231
416,Rasheed Wallace,PF,27,POR,79,79,2963,603,1287,114,317,489,970,201,274,136,509,645,152,101,101,131,212,1521
417,Charlie Ward,PG,31,NYK,63,0,1058,113,303,53,164,60,139,47,58,15,112,127,203,68,14,75,100,326
418,Earl Watson,PG,22,SEA,64,0,964,96,212,16,44,80,168,23,36,31,52,83,125,60,5,51,93,231
419,Clarence Weatherspoon,PF,31,NYK,56,41,1728,189,452,0,0,189,452,116,146,149,311,460,60,37,48,47,132,494
420,Chris Webber,PF,28,SAC,54,54,2071,532,1075,5,19,527,1056,253,338,150,396,546,258,90,76,158,181,1322
421,Bonzi Wells,SG,25,POR,74,69,2348,487,1039,66,172,421,867,215,290,121,323,444,204,113,25,191,208,1255
422,David Wesley,SG,31,CHH,67,63,2487,364,910,85,256,279,654,138,188,44,99,143,236,74,15,119,147,951
423,Jahidi White,C,25,WAS,71,69,1346,150,279,0,0,150,279,83,154,159,285,444,17,25,75,65,163,383
424,Rodney White,SF,21,DET,16,0,129,21,60,2,9,19,51,12,14,2,16,18,12,9,2,14,6,56
425,Chris Whitney,PG,30,WAS,82,81,2171,274,656,131,323,143,333,154,175,11,141,152,314,72,6,85,182,833
426,Aaron Williams,PF,30,NJN,82,13,1546,231,439,0,2,231,437,130,186,115,224,339,77,29,76,79,212,592
427,Alvin Williams,PG,27,TOR,82,82,2927,403,971,62,193,341,778,103,140,58,223,281,468,135,26,150,191,971
428,Eric Williams,SF,29,BOS,74,30,1747,144,385,24,86,120,299,160,219,58,163,221,109,77,8,95,179,472
429,Jason Williams,PG,26,MEM,65,65,2236,376,985,127,430,249,555,80,101,22,173,195,519,111,7,214,102,959
430,Jerome Williams,PF,28,TOR,68,32,1641,190,388,0,0,190,388,138,204,165,221,386,75,78,25,68,153,518
431,Monty Williams,SF,30,ORL,68,19,1284,198,362,0,4,198,358,88,134,80,155,235,96,49,17,86,134,484
432,Scott Williams,PF,33,DEN,41,16,737,86,217,0,2,86,215,30,41,82,127,209,13,17,33,35,98,202
433,Shammond Williams,SG,26,SEA,50,2,603,81,193,28,75,53,118,31,39,16,47,63,83,21,2,35,35,221
434,Walt Williams,SF,31,HOU,48,25,1117,166,396,78,183,88,213,40,51,37,125,162,69,18,10,53,106,450
435,Corliss Williamson,SF,28,DET,78,7,1701,411,806,1,5,410,801,240,298,117,202,319,94,49,26,137,226,1063
436,Kevin Willis,PF,39,HOU,52,5,865,125,284,0,1,125,283,65,87,105,194,299,14,25,23,41,98,315
437,Loren Woods,C,23,MIN,60,0,516,33,96,0,2,33,94,44,60,46,76,122,22,17,34,36,60,110
438,Metta World Peace,SF,22,TOT,55,50,1642,269,636,53,170,216,466,136,204,73,198,271,127,141,39,118,217,727
439,Lorenzen Wright,C,26,MEM,43,33,1251,223,486,0,2,223,484,70,123,130,275,405,44,30,23,72,126,516
440,Wang Zhizhi,C,24,DAL,55,0,600,109,248,48,116,61,132,42,57,19,92,111,22,11,18,25,84,308
1,Tariq Abdul-Wahad,SG,28,DAL,14,0,204,27,58,0,1,27,57,3,6,14,26,40,21,6,3,7,26,57
2,Shareef Abdur-Rahim,PF,26,ATL,81,81,3087,566,1183,21,60,545,1123,455,541,175,502,677,242,87,38,212,240,1608
3,Courtney Alexander,PG,25,NOH,66,7,1360,193,505,19,57,174,448,118,146,39,79,118,79,31,6,68,125,523
4,Malik Allen,PF,24,MIA,80,73,2318,335,790,0,4,335,786,97,121,134,291,425,54,37,78,128,234,767
5,Ray Allen*,SG,27,TOT,76,75,2880,598,1363,201,533,397,830,316,345,94,287,381,334,103,14,198,220,1713
6,Rafer Alston,PG,26,TOR,47,4,980,139,335,51,130,88,205,37,54,21,86,107,192,38,15,86,120,366
7,John Amaechi,C,32,UTA,50,1,474,37,118,0,0,37,118,25,52,26,51,77,21,14,7,34,50,99
8,Chris Andersen,C,24,DEN,59,3,907,114,285,0,1,114,284,77,140,109,165,274,32,30,60,60,90,305
9,Derek Anderson,PG,28,POR,76,76,2556,355,832,116,331,239,501,231,269,53,211,264,325,90,16,128,141,1057
10,Kenny Anderson,PG,32,TOT,61,2,1135,163,382,1,7,162,375,45,57,31,101,132,198,58,5,75,106,372
11,Shandon Anderson,SF,29,NYK,82,9,1731,248,537,52,140,196,397,139,190,64,190,254,87,73,20,114,177,687
12,Robert Archibald,PF,22,MEM,12,0,72,6,20,0,0,6,20,7,18,6,11,17,3,0,3,7,9,19
13,Gilbert Arenas,PG,21,GSW,82,82,2866,509,1180,109,313,400,867,370,468,97,289,386,514,124,17,290,260,1497
14,Brandon Armstrong,SG,22,NJN,17,0,69,9,27,1,6,8,21,5,6,0,4,4,2,3,1,5,8,24
15,Darrell Armstrong,PG,34,ORL,82,23,2350,263,643,78,232,185,411,165,188,91,204,295,323,135,13,160,167,769
16,Carlos Arroyo,PG,23,UTA,44,0,287,50,109,3,7,47,102,18,22,11,15,26,53,12,1,30,28,121
17,Chucky Atkins,PG,28,DET,65,7,1398,168,465,86,242,82,223,40,49,21,75,96,175,27,4,77,108,462
18,Stacey Augmon,SG,34,NOH,70,3,862,79,192,0,7,79,185,54,72,26,93,119,69,27,9,40,80,212
19,Dalibor Bagarić,C,22,CHI,10,0,76,8,26,0,0,8,26,3,4,7,13,20,4,3,3,5,11,19
20,Vin Baker,C,31,BOS,52,9,942,99,207,0,4,99,203,72,107,90,108,198,29,22,30,61,146,270
21,Brent Barry,SG,31,SEA,75,68,2480,264,577,118,293,146,284,128,161,48,253,301,384,113,15,142,199,774
22,Jon Barry,SG,33,DET,80,0,1473,191,424,87,214,104,210,86,100,33,147,180,206,63,14,81,104,555
23,Maceo Baston,PF,27,TOR,16,0,106,15,25,0,0,15,25,10,12,4,19,23,0,4,11,6,16,40
24,Mengke Bateer,C,27,SAS,12,0,46,4,17,1,3,3,14,0,2,2,8,10,4,0,0,6,14,9
25,Mike Batiste,PF,25,MEM,75,2,1248,197,467,18,81,179,386,69,88,82,175,257,52,42,16,69,120,481
26,Tony Battie,C,26,BOS,67,62,1683,199,369,1,5,198,364,88,118,148,285,433,49,33,81,48,197,487
27,Shane Battier,SF,24,MEM,78,47,2383,275,569,86,216,189,353,120,145,128,217,345,105,102,88,68,207,756
28,Lonny Baxter,C,24,CHI,55,0,682,96,206,0,2,96,204,70,103,65,100,165,16,9,22,46,135,262
29,Raja Bell,SG,26,DAL,75,32,1173,93,211,21,51,72,160,23,34,47,98,145,57,52,8,43,134,230
30,Jonathan Bender,SF,22,IND,46,2,819,112,254,19,53,93,201,60,84,42,91,133,42,8,56,42,86,303
31,Corey Benjamin,SG,24,ATL,9,0,152,13,43,2,13,11,30,12,16,10,21,31,10,1,2,6,20,40
32,Travis Best,PG,30,MIA,72,52,1807,231,583,36,109,195,474,105,123,26,121,147,255,44,7,106,174,603
33,Mike Bibby,PG,24,SAC,55,55,1835,329,700,56,137,273,563,161,187,34,113,147,285,72,8,127,93,875
34,Chauncey Billups,PG,26,DET,74,74,2327,366,870,149,380,217,490,318,362,38,235,273,287,63,15,134,136,1199
35,Corie Blount,C,34,CHI,50,3,836,65,134,0,0,65,134,20,35,68,137,205,50,33,19,43,121,150
36,Mark Blount,C,27,TOT,81,31,1403,150,347,0,0,150,347,101,139,111,197,308,56,42,68,103,187,401
37,Calvin Booth,C,26,SEA,47,0,575,52,119,0,2,52,117,34,47,32,77,109,12,11,33,22,74,138
38,Carlos Boozer,PF,21,CLE,81,54,2049,331,618,0,1,331,617,148,192,202,407,609,106,59,50,103,224,810
39,Ruben Boumtje-Boumtje,C,24,POR,2,0,5,0,1,0,0,0,1,0,0,1,0,1,1,1,0,0,0,0
40,Bruce Bowen,SF,31,SAS,82,82,2566,223,479,101,229,122,250,36,89,59,180,239,113,66,42,72,195,583
41,Ryan Bowen,SG,27,DEN,62,31,996,97,197,2,7,95,190,27,41,78,79,157,54,65,29,43,82,223
42,Earl Boykins,PG,26,GSW,68,0,1321,199,464,29,77,170,387,173,200,35,53,88,221,38,4,73,75,600
43,Michael Bradley,PF,23,TOR,67,11,1314,151,314,1,6,150,308,35,67,162,247,409,67,16,32,76,125,338
44,Shawn Bradley,C,30,DAL,81,39,1731,201,375,0,1,201,374,141,175,151,325,476,54,65,170,67,242,543
45,Elton Brand,PF,23,LAC,62,61,2454,451,899,0,1,451,898,244,356,283,420,703,157,71,158,161,204,1146
46,J.R. Bremer,PG,22,BOS,64,41,1503,171,464,101,286,70,178,85,111,18,127,145,164,38,3,59,80,528
47,Jamison Brewer,PG,22,IND,10,0,80,9,17,0,2,9,15,4,9,5,4,9,18,2,1,6,11,22
48,Primož Brezec,C,23,IND,22,1,111,15,38,0,1,15,37,12,20,13,10,23,4,2,4,7,16,42
49,Damone Brown,PF,23,TOR,5,3,115,11,35,0,2,11,33,6,8,3,12,15,3,1,0,6,14,28
50,Devin Brown,SG,24,TOT,10,2,93,12,35,0,1,12,34,6,8,8,10,18,7,4,1,9,14,30
51,Kedrick Brown,SF,21,BOS,51,5,666,61,171,3,39,58,132,20,32,45,95,140,20,34,13,23,68,145
52,Kwame Brown,C,20,WAS,80,20,1773,224,502,0,3,224,499,145,217,128,298,426,58,50,80,110,159,593
53,P.J. Brown,PF,33,NOH,78,78,2609,319,601,0,3,319,598,194,232,243,458,701,147,67,80,98,203,832
54,Randy Brown,PG,34,PHO,32,0,262,16,43,0,0,16,43,9,12,3,23,26,35,17,2,17,36,41
55,Tierre Brown,PG,23,CLE,15,0,168,27,59,0,1,27,58,11,14,8,22,30,39,13,0,22,9,65
56,Rick Brunson,PG,30,CHI,17,0,196,23,50,4,6,19,44,10,12,4,15,19,36,10,3,17,20,60
57,Kobe Bryant,SG,24,LAL,82,82,3401,868,1924,124,324,744,1600,601,713,106,458,564,481,181,67,288,218,2461
58,Mark Bryant,PF,37,TOT,16,0,100,5,19,0,0,5,19,3,4,8,12,20,4,1,1,7,18,13
59,Greg Buckner,SG,26,PHI,75,5,1514,185,398,15,55,170,343,65,81,72,144,216,96,72,16,62,203,450
60,Pat Burke,C,29,ORL,62,8,783,113,296,1,7,112,289,40,58,57,89,146,23,19,25,47,99,267
61,Caron Butler,SF,22,MIA,78,78,2858,429,1032,34,107,395,925,309,375,135,262,397,213,137,31,192,230,1201
62,Rasual Butler,SG,23,MIA,72,28,1514,207,572,50,171,157,401,76,104,29,157,186,93,21,43,77,105,540
63,Jason Caffey,PF,29,MIL,51,16,894,113,248,0,0,113,248,69,106,68,108,176,38,19,15,56,122,295
64,Marcus Camby,C,28,DEN,29,9,616,93,227,2,5,91,222,33,50,75,133,208,47,20,40,27,69,221
65,Elden Campbell,C,34,TOT,56,1,869,117,295,0,1,117,294,109,136,47,134,181,51,33,39,50,129,343
66,Brian Cardinal,PF,25,WAS,5,0,15,1,4,0,1,1,3,2,2,3,2,5,1,0,0,1,0,4
67,Anthony Carter,PG,27,MIA,49,26,912,83,233,0,8,83,225,33,50,12,71,83,203,45,5,81,70,199
68,Vince Carter,SG,26,TOR,43,42,1471,355,760,45,131,310,629,129,160,59,129,188,143,48,41,74,121,884
69,Sam Cassell,PG,33,MIL,78,77,2700,546,1162,59,163,487,999,385,447,57,285,342,450,88,14,177,216,1536
70,Kelvin Cato,C,28,HOU,73,5,1247,133,256,0,4,133,252,66,124,132,296,428,20,38,85,56,176,332
71,Tyson Chandler,C,20,CHI,75,68,1827,257,484,0,0,257,484,177,291,169,345,514,76,37,106,135,220,691
72,Calbert Cheaney,SG,31,UTA,81,74,2351,325,651,10,25,315,626,40,69,73,211,284,163,65,13,108,225,700
73,Chris Childs,PG,35,NJN,12,0,106,6,20,1,6,5,14,2,3,3,2,5,16,8,1,6,17,15
74,Doug Christie,SG,32,SAC,80,80,2710,267,557,73,185,194,372,141,174,61,281,342,376,180,37,144,186,748
75,Keon Clark,C,27,SAC,80,11,1780,226,451,0,4,226,447,84,128,138,313,451,80,38,150,94,227,536
76,Speedy Claxton,PG,24,SAS,30,0,471,67,145,0,11,67,134,39,57,22,34,56,75,22,7,35,43,173
77,Mateen Cleaves,PG,25,SAC,12,0,55,6,23,1,1,5,22,3,4,1,7,8,10,2,0,14,6,16
78,Derrick Coleman,C,35,PHI,64,35,1742,223,498,22,67,201,431,134,171,151,299,450,87,53,69,96,171,602
79,Bimbo Coles,PG,34,TOT,35,11,691,56,168,7,32,49,136,35,42,11,48,59,72,17,4,28,60,154
80,Jason Collier,C,25,HOU,13,3,104,17,36,0,0,17,36,2,2,12,17,29,1,2,1,2,10,36
81,Jarron Collins,C,24,UTA,22,7,421,38,86,0,1,38,85,44,62,32,28,60,14,5,6,19,70,120
82,Jason Collins,C,24,NJN,81,66,1900,140,338,0,4,140,334,180,236,136,232,368,87,47,44,85,252,460
83,Chris Crawford,PF,27,ATL,5,0,38,8,13,1,3,7,10,7,8,3,4,7,1,2,3,2,7,24
84,Jamal Crawford,PG,22,CHI,80,31,1992,334,808,86,242,248,566,104,129,21,164,185,334,77,25,134,126,858
85,Austin Croshere,PF,27,IND,49,0,633,86,209,27,69,59,140,53,65,40,115,155,56,6,13,28,48,252
86,John Crotty,PG,33,DEN,12,0,180,14,41,4,13,10,28,9,15,1,14,15,29,3,0,9,16,41
87,Eddy Curry,C,20,CHI,81,48,1571,335,573,0,0,335,573,179,287,116,237,353,37,18,62,137,226,849
88,Michael Curry,SF,34,DET,78,77,1555,92,229,16,54,76,175,36,45,16,111,127,104,44,4,43,163,236
89,Erick Dampier,C,27,GSW,82,82,1978,259,522,0,2,259,520,155,222,248,295,543,58,27,154,112,242,673
90,Antonio Daniels,SG,27,POR,67,2,872,84,186,18,59,66,127,65,76,11,61,72,85,33,9,32,43,251
91,Antonio Davis,C,34,TOR,53,52,1894,261,641,0,0,261,641,216,280,130,307,437,131,23,62,118,150,738
92,Baron Davis,PG,23,NOH,50,47,1889,332,798,99,283,233,515,93,131,56,130,186,320,91,22,140,148,856
93,Dale Davis,C,33,POR,78,78,2282,237,438,0,0,237,438,105,166,233,331,564,94,51,70,71,189,579
94,Emanual Davis,SG,34,ATL,24,1,340,32,88,7,29,25,59,17,22,5,38,43,36,12,2,25,28,88
95,Hubert Davis,SG,32,DET,43,1,328,31,79,12,36,19,43,5,6,6,30,36,29,5,0,11,23,79
96,Ricky Davis,SG,23,CLE,79,76,3131,602,1470,74,204,528,1266,348,465,97,293,390,436,125,36,277,180,1626
97,Andrew DeClercq,C,29,ORL,77,21,1327,149,279,0,0,149,279,67,104,142,197,339,52,39,36,84,258,365
98,Tony Delk,PG,29,BOS,67,39,1873,233,560,120,304,113,256,68,87,41,191,232,146,72,10,69,124,654
99,Dan Dickau,PG,24,ATL,50,0,515,70,170,22,61,48,109,21,26,9,34,43,85,14,2,53,66,183
100,Michael Dickerson,SG,27,MEM,6,1,87,10,24,4,11,6,13,5,5,1,5,6,8,5,1,6,16,29
101,DeSagana Diop,PF,21,CLE,80,1,943,54,154,0,0,54,154,11,30,63,152,215,43,33,81,56,148,119
102,Vlade Divac*,C,34,SAC,80,80,2384,305,655,6,25,299,630,179,251,157,417,574,274,83,105,152,239,795
103,Juan Dixon,PG,24,WAS,42,3,647,104,271,25,84,79,187,37,46,13,59,72,40,26,3,42,54,270
104,Michael Doleac,C,25,NYK,75,0,1041,146,343,0,0,146,343,36,46,65,154,219,42,16,16,49,150,328
105,Keyon Dooling,SG,22,LAC,55,1,969,128,329,50,139,78,190,44,57,9,63,72,89,24,6,60,93,350
106,Bryce Drew,PG,28,NOH,13,0,79,8,27,3,7,5,20,0,0,4,9,13,11,2,0,3,2,19
107,Predrag Drobnjak,C,27,SEA,82,69,1984,325,789,30,85,295,704,91,115,111,209,320,86,48,38,65,180,771
108,Chris Dudley,C,37,POR,3,0,11,0,1,0,0,0,1,0,0,2,0,2,0,0,0,0,3,0
109,Tim Duncan,PF,26,SAS,81,81,3181,714,1392,6,22,708,1370,450,634,259,784,1043,316,55,237,248,231,1884
110,Mike Dunleavy,SF,22,GSW,82,3,1305,168,417,52,150,116,267,78,100,66,148,214,106,53,19,86,120,466
111,Howard Eisley,PG,30,NYK,82,76,2243,262,628,131,337,131,291,89,105,24,162,186,444,71,9,149,222,744
112,LaPhonso Ellis,PF,32,MIA,55,3,784,100,262,27,107,73,155,50,66,44,113,157,15,15,15,31,88,277
113,Melvin Ely,C,24,LAC,52,7,802,92,186,0,0,92,186,52,74,64,110,174,15,10,32,50,95,236
114,Evan Eschmeyer,C,27,DAL,17,3,135,7,19,0,0,7,19,3,4,10,19,29,6,10,7,6,35,17
115,Reggie Evans,PF,22,SEA,67,60,1365,66,140,0,0,66,140,80,154,167,278,445,34,38,11,52,173,212
116,Danny Ferry,SF,36,SAS,64,1,601,44,124,21,60,23,64,10,13,20,55,75,21,7,9,27,55,119
117,Michael Finley,SF,29,DAL,69,69,2642,507,1193,119,322,388,871,198,230,107,295,402,205,76,21,114,105,1331
118,Derek Fisher,PG,28,LAL,82,82,2829,339,775,85,212,254,563,100,125,40,199,239,298,93,15,94,195,863
119,Marcus Fizer,PF,24,CHI,38,0,809,178,383,1,6,177,377,88,134,80,136,216,48,14,17,57,89,445
120,Alton Ford,PF,21,PHO,11,0,31,3,9,0,0,3,9,1,3,0,6,6,1,0,0,2,7,7
121,Joseph Forte,SG,21,SEA,17,0,86,10,35,0,3,10,32,4,6,4,7,11,11,4,0,10,6,24
122,Danny Fortson,PF,26,GSW,17,0,223,20,54,0,1,20,53,19,29,28,45,73,12,9,0,15,43,59
123,Greg Foster,C,34,TOR,29,9,539,47,122,1,4,46,118,26,32,30,72,102,13,1,9,30,82,121
124,Jeff Foster,C,26,IND,77,2,802,64,178,0,2,64,176,34,63,118,161,279,51,28,21,34,103,162
125,Tremaine Fowlkes,SF,26,LAC,37,10,573,56,128,2,9,54,119,50,59,41,62,103,23,25,2,20,63,164
126,Rick Fox,SF,33,LAL,76,75,2181,262,621,105,280,157,341,52,69,64,259,323,253,69,14,121,215,681
127,Adonal Foyle,C,27,GSW,82,0,1787,185,345,0,1,185,344,70,104,176,314,490,37,40,205,73,214,440
128,Steve Francis,PG,25,HOU,81,81,3318,571,1312,85,240,486,1072,476,595,159,340,499,502,141,41,299,251,1703
129,Lawrence Funderburke,PF,32,SAC,27,0,229,32,72,0,0,32,72,10,17,17,38,55,8,1,11,6,25,74
130,Dan Gadzuric,C,24,MIL,49,30,760,70,145,0,1,70,144,29,56,66,131,197,9,22,52,27,125,169
131,Kevin Garnett,PF,26,MIN,82,82,3321,743,1481,20,71,723,1410,377,502,244,858,1102,495,113,129,229,199,1883
132,Pat Garrity,PF,26,ORL,81,53,2584,312,744,161,407,151,337,83,100,72,234,306,121,62,20,77,255,868
133,Pau Gasol,PF,22,MEM,82,82,2948,569,1116,1,10,568,1106,416,565,192,528,720,229,34,148,213,220,1555
134,Devean George,SF,25,LAL,71,7,1613,180,461,49,132,131,329,83,105,91,195,286,92,56,38,65,180,492
135,Kendall Gill,SG,34,MIN,82,34,2068,286,677,19,59,267,618,123,161,51,197,248,156,78,15,108,176,714
136,Manu Ginóbili,SG,25,SAS,69,5,1431,174,397,51,148,123,249,126,171,47,114,161,138,96,17,100,170,525
138,Dion Glover,SG,24,ATL,76,42,1890,277,648,56,158,221,490,127,162,62,220,282,141,71,15,108,146,737
139,Anthony Goldwire,PG,31,TOT,15,0,85,9,25,3,9,6,16,4,7,0,6,6,4,3,0,6,6,25
141,Brian Grant,C,30,MIA,82,82,2641,344,676,0,0,344,676,158,205,241,596,837,104,63,47,129,300,846
142,Horace Grant,PF,37,ORL,5,1,85,13,25,0,0,13,25,0,0,2,6,8,7,3,0,1,5,26
143,Adrian Griffin,SG,28,DAL,74,48,1373,146,337,6,24,140,313,27,32,88,176,264,105,77,6,47,157,325
144,Eddie Griffin,PF,20,HOU,77,66,1890,271,678,64,192,207,486,58,94,138,323,461,86,52,111,76,136,664
145,Tom Gugliotta,PF,33,PHO,27,11,447,60,132,0,1,60,131,9,9,25,75,100,31,14,5,31,35,129
146,A.J. Guyton,PG,24,GSW,2,0,9,0,4,0,1,0,3,0,0,0,0,0,2,1,0,1,0,0
147,Marcus Haislip,PF,22,MIL,39,8,441,66,153,3,12,63,141,26,38,21,32,53,9,7,18,21,55,161
148,Darvin Ham,SG,29,ATL,75,1,926,71,159,0,3,71,156,38,79,73,80,153,38,16,19,65,127,180
149,Richard Hamilton,SG,24,DET,82,82,2640,570,1286,32,119,538,1167,440,528,88,230,318,208,64,13,200,249,1612
150,Zendon Hamilton,C,27,TOR,3,0,12,2,5,0,0,2,5,2,2,1,3,4,0,1,0,1,2,6
151,Anfernee Hardaway,SG,31,PHO,58,51,1777,256,573,26,73,230,500,77,97,66,192,258,235,66,26,145,150,615
152,Tim Hardaway,PG,36,IND,10,0,127,18,49,11,31,7,18,2,4,1,14,15,24,9,0,11,8,49
153,Matt Harpring,SF,26,UTA,78,69,2557,521,1020,66,160,455,860,262,331,190,324,514,133,73,17,160,217,1370
154,Adam Harrington,SG,22,TOT,19,0,111,11,37,5,14,6,23,3,4,1,7,8,12,2,1,2,8,30
155,Al Harrington,SF,22,IND,82,37,2467,389,896,13,46,376,850,211,274,159,352,511,125,71,33,163,280,1002
156,Junior Harrington,PG,22,DEN,82,51,2003,169,467,7,28,162,439,73,112,44,206,250,277,80,15,157,250,418
157,Othella Harrington,PF,29,NYK,74,64,1850,225,443,0,0,225,443,123,150,165,311,476,62,12,23,90,231,573
158,Lucious Harris,SG,32,NJN,77,25,1973,298,721,47,136,251,585,152,189,63,169,232,155,53,8,71,95,795
159,Antonio Harvey,PF,32,ATL,4,0,32,2,5,0,0,2,5,0,0,1,5,6,0,1,4,3,7,4
160,Donnell Harvey,SF,22,DEN,77,27,1613,246,551,1,7,245,544,118,176,125,284,409,100,48,27,123,203,611
161,Trenton Hassell,SG,23,CHI,82,53,1999,144,392,13,40,131,352,41,55,37,218,255,151,45,61,83,197,342
162,Kirk Haston,SF,23,NOH,12,0,57,2,17,0,3,2,14,2,4,0,7,7,3,0,5,7,10,6
163,Juaquin Hawkins,SG,29,HOU,58,10,685,57,148,10,24,47,124,10,20,16,62,78,47,29,6,29,57,134
164,Brendan Haywood,C,23,WAS,81,69,1930,173,339,0,0,173,339,155,245,192,212,404,29,32,119,65,225,501
165,Alan Henderson,C,30,ATL,82,3,1494,153,327,0,2,153,325,88,138,156,242,398,41,33,32,61,168,394
166,Nenê Hilário,C,20,DEN,80,53,2258,321,619,0,3,321,616,197,341,208,283,491,149,127,65,181,295,839
167,Grant Hill*,SF,30,ORL,29,29,843,151,307,1,4,150,303,118,144,40,166,206,122,28,13,84,46,421
168,Tyrone Hill,PF,34,TOT,56,43,1351,129,306,0,0,129,306,54,80,126,265,391,41,46,26,68,172,312
169,Fred Hoiberg,SG,30,CHI,63,0,784,49,126,5,21,44,105,41,50,11,126,137,70,40,5,25,59,144
170,Robert Horry,PF,32,LAL,80,26,2343,184,476,51,177,133,299,103,134,181,333,514,233,96,61,112,247,522
171,Eddie House,SG,24,MIA,55,7,1025,172,444,36,120,136,324,31,36,17,84,101,87,44,1,46,73,411
172,Allan Houston,SG,31,NYK,82,82,3108,652,1465,178,450,474,1015,363,395,26,205,231,220,54,7,178,191,1845
173,Juwan Howard,PF,29,DEN,77,77,2730,567,1261,2,4,565,1257,282,351,181,404,585,234,77,27,189,239,1418
174,Troy Hudson,PG,26,MIN,79,74,2600,409,956,97,266,312,690,208,231,42,141,183,452,60,7,182,160,1123
175,Nate Huffman,C,27,TOR,7,0,76,9,25,0,0,9,25,5,8,9,14,23,5,1,3,3,13,23
176,Larry Hughes,PG,24,WAS,67,56,2137,346,741,29,79,317,662,136,186,67,241,308,205,86,24,136,149,857
177,Ryan Humphrey,PF,23,TOT,48,1,444,35,120,0,0,35,120,23,39,34,65,99,11,9,18,23,75,93
178,Lindsey Hunter,PG,32,TOR,29,0,673,106,302,34,107,72,195,34,47,15,44,59,71,35,5,57,50,280
179,Steven Hunter,C,21,ORL,33,5,447,56,103,0,0,56,103,18,44,38,55,93,6,9,36,15,56,130
180,Zydrunas Ilgauskas,C,27,CLE,81,81,2432,495,1122,0,5,495,1117,400,512,240,371,611,127,56,152,210,274,1390
181,Allen Iverson*,SG,27,PHI,82,82,3485,804,1940,84,303,720,1637,570,736,68,276,344,454,225,13,286,149,2262
182,Bobby Jackson,PG,29,SAC,59,26,1676,340,732,89,235,251,497,126,149,57,162,219,182,71,3,106,126,895
183,Jermaine Jackson,SG,26,TOT,53,1,559,40,110,1,10,39,100,40,55,19,38,57,74,19,6,34,51,121
184,Jim Jackson,SF,32,SAC,63,0,1309,204,462,32,71,172,391,47,55,84,178,262,118,31,4,80,132,487
185,Marc Jackson,C,28,MIN,77,0,1041,153,349,1,1,152,348,114,149,86,139,225,37,24,30,59,137,421
186,Mark Jackson,PG,37,UTA,82,0,1467,147,369,27,95,120,274,61,80,34,142,176,375,48,3,152,90,382
187,Stephen Jackson,SG,24,SAS,80,58,2254,356,818,95,297,261,521,139,183,66,220,286,183,125,30,176,202,946
188,Casey Jacobsen,SF,21,PHO,72,0,1147,122,327,52,165,70,162,72,105,29,54,83,73,35,6,55,90,368
189,Jerome James,C,27,SEA,51,16,766,111,232,0,0,111,232,54,92,78,138,216,27,12,82,75,166,276
190,Mike James,PG,27,MIA,78,8,1722,218,585,67,228,151,357,104,142,26,123,149,246,64,5,108,176,607
191,Antawn Jamison,SF,26,GSW,82,82,3226,691,1471,65,209,626,1262,375,475,195,383,578,156,76,45,177,197,1822
192,Marko Jarić,SF,24,LAC,66,12,1379,179,446,53,166,126,280,79,105,35,125,160,193,97,11,103,125,490
193,Chris Jefferies,SF,22,TOR,51,10,666,75,194,18,54,57,140,29,43,16,43,59,22,19,16,45,56,197
194,Richard Jefferson,SF,22,NJN,80,80,2879,456,911,6,24,450,887,324,436,150,364,514,201,80,44,156,216,1242
195,Jared Jeffries,SF,21,WAS,20,1,292,30,63,3,6,27,57,16,29,26,32,58,16,8,5,21,28,79
196,Anthony Johnson,PG,28,NJN,66,2,842,103,231,13,35,90,196,51,74,13,65,78,86,37,5,41,93,270
197,Avery Johnson,PG,37,DAL,48,0,430,63,150,0,2,63,148,30,39,10,21,31,64,15,1,29,26,156
198,Ervin Johnson,C,35,MIL,69,17,1170,61,135,0,0,61,135,30,44,117,177,294,24,34,63,34,178,152
199,Joe Johnson,SG,21,PHO,82,34,2255,316,796,75,205,241,591,96,124,57,207,264,210,62,19,108,143,803
200,Ken Johnson,C,24,MIA,16,0,156,15,37,0,0,15,37,2,6,4,28,32,0,1,12,6,20,32
201,Damon Jones,PG,26,SAC,49,1,709,80,210,44,121,36,89,20,27,11,59,70,80,18,4,23,42,224
202,Eddie Jones,SG,31,MIA,47,47,1789,291,688,98,241,193,447,189,230,35,191,226,173,64,31,85,137,869
203,Fred Jones,SG,23,IND,19,1,115,9,24,2,7,7,17,3,4,4,5,9,5,6,1,6,13,23
204,Jumaine Jones,SF,23,CLE,80,12,2204,308,710,111,314,197,396,57,83,106,299,405,112,67,22,107,176,784
205,Popeye Jones,PF,32,DAL,26,0,222,24,62,0,0,24,62,5,11,29,30,59,8,5,1,15,31,53
206,Michael Jordan*,SF,39,WAS,82,67,3031,679,1527,16,55,663,1472,266,324,71,426,497,311,123,39,173,171,1640
207,Shawn Kemp,C,33,ORL,79,55,1633,211,505,0,1,211,504,115,155,147,304,451,55,66,33,102,239,537
208,Steve Kerr,PG,37,SAS,75,0,952,110,256,49,124,61,132,30,34,12,48,60,70,27,3,35,49,299
209,Jason Kidd*,PG,29,NJN,80,80,2989,515,1244,126,370,389,874,339,403,110,394,504,711,179,25,296,127,1495
210,Andrei Kirilenko,SF,21,UTA,80,11,2213,315,642,37,114,278,528,296,370,147,273,420,138,118,175,136,185,963
211,Kerry Kittles,SG,28,NJN,65,57,1951,332,711,78,219,254,492,106,135,52,200,252,170,101,30,55,110,848
212,Brevin Knight,PG,27,MEM,55,4,928,97,228,2,8,95,220,20,37,15,66,81,233,69,2,94,123,216
213,Travis Knight,C,28,NYK,32,0,287,25,65,0,1,25,64,10,13,18,44,62,14,8,9,10,44,60
214,Toni Kukoč,PF,34,MIL,63,0,1704,249,577,95,263,154,314,137,194,67,199,266,230,81,29,122,134,730
215,Christian Laettner,PF,33,WAS,76,66,2215,255,516,2,16,253,500,120,144,114,388,502,235,82,40,87,206,632
216,Raef LaFrentz,C,26,DAL,69,43,1611,266,514,47,116,219,398,60,88,125,205,330,54,35,91,46,264,639
217,Sean Lampley,SF,23,MIA,35,0,487,56,129,0,4,56,125,57,82,26,57,83,31,7,3,25,43,169
218,Dan Langhi,SF,25,PHO,60,0,541,81,202,9,31,72,171,12,20,19,68,87,21,15,6,16,58,183
219,Voshon Lenard,SG,29,TOR,63,24,1929,325,809,92,252,233,557,156,194,48,164,212,144,59,21,103,156,898
220,Rashard Lewis,SF,23,SEA,77,77,3044,519,1149,75,217,444,932,283,345,152,351,503,133,99,35,143,205,1396
221,Randy Livingston,PG,27,NOH,2,0,12,2,4,0,0,2,4,2,2,0,0,0,1,0,0,0,0,6
222,Art Long,SF,30,TOT,26,0,211,28,75,2,3,26,72,2,10,21,39,60,6,5,11,20,35,60
223,Grant Long,PF,36,BOS,41,1,488,27,70,0,3,27,67,18,23,24,59,83,25,9,1,19,62,72
224,Tyronn Lue,PG,25,WAS,75,24,1986,248,573,60,176,188,397,91,104,22,127,149,263,47,1,77,151,647
225,George Lynch,SG,32,NOH,81,32,1497,147,359,28,79,119,280,41,74,139,214,353,104,66,19,52,136,363
226,Todd MacCulloch,C,27,PHI,42,35,812,123,238,0,0,123,238,53,79,66,130,196,20,19,32,35,107,299
227,Tito Maddox,SG,21,HOU,9,0,35,3,12,0,3,3,9,5,8,1,6,7,5,3,1,3,4,11
228,Mark Madsen,PF,27,LAL,54,22,781,69,163,0,0,69,163,36,61,86,73,159,38,15,19,27,116,174
229,Corey Maggette,SG,23,LAC,64,57,2006,343,773,62,177,281,596,325,405,77,245,322,123,55,16,147,194,1073
230,Jamaal Magloire,C,24,NOH,82,82,2443,305,635,0,3,305,632,231,322,260,464,724,88,49,111,158,276,841
231,Karl Malone*,PF,39,UTA,81,81,2936,595,1289,3,14,592,1275,474,621,113,515,628,379,136,31,210,204,1667
232,Matt Maloney,PG,31,ATL,14,0,103,8,25,5,15,3,10,3,5,1,6,7,17,4,0,5,9,24
233,Danny Manning,PF,36,DET,13,0,89,13,32,3,8,10,24,5,6,7,11,18,7,9,3,7,11,34
234,Stephon Marbury,PG,25,PHO,81,81,3240,671,1530,89,296,582,1234,375,467,53,210,263,654,108,20,263,200,1806
235,Shawn Marion,SF,24,PHO,81,81,3373,662,1466,141,364,521,1102,251,295,199,574,773,198,185,95,157,208,1716
236,Sean Marks,PF,27,MIA,23,0,223,22,59,0,1,22,58,10,15,8,27,35,3,5,6,14,37,54
237,Donny Marshall,SF,30,NJN,3,0,6,0,3,0,1,0,2,0,0,0,3,3,0,0,0,1,0,0
238,Donyell Marshall,PF,29,CHI,78,53,2378,421,918,33,87,388,831,167,221,234,465,699,137,95,85,135,234,1042
239,Kenyon Martin,PF,25,NJN,77,77,2628,509,1082,9,43,500,1039,256,392,164,476,640,185,98,70,192,294,1283
240,Jamal Mashburn,SF,30,NOH,82,81,3321,670,1586,119,306,551,1280,313,369,66,432,498,462,83,17,230,196,1772
241,Anthony Mason,C,36,MIL,65,58,2119,191,393,0,1,191,392,84,117,90,326,416,209,32,12,79,147,466
242,Desmond Mason,SF,25,TOT,80,40,2763,457,1017,21,72,436,945,212,283,154,369,523,163,67,32,115,210,1147
243,Roger Mason,SF,22,CHI,17,0,113,11,31,6,18,5,13,2,2,2,10,12,12,4,0,5,20,30
244,Tony Massenburg,C,35,UTA,58,1,792,104,232,0,0,104,232,65,84,59,97,156,17,17,19,50,144,273
245,Walter McCarty,SF,28,BOS,82,8,1949,173,418,91,248,82,170,61,98,64,224,288,106,78,28,67,188,498
246,Amal McCaskill,C,29,ATL,11,0,70,4,17,0,0,4,17,3,4,7,15,22,5,3,1,2,13,11
247,Jelani McCoy,C,25,TOR,67,25,1367,194,395,0,0,194,395,69,126,95,260,355,43,28,60,96,162,457
248,Tracy McGrady*,SG,23,ORL,75,74,2954,829,1813,173,448,656,1365,576,726,121,367,488,411,124,59,195,156,2407
249,Jeff McInnis,PG,28,POR,75,1,1311,188,423,6,35,182,388,50,67,22,75,97,170,21,2,75,117,432
250,Aaron McKie,SF,30,PHI,80,40,2374,286,666,37,112,249,554,112,134,61,289,350,278,131,9,109,177,721
251,Stanislav Medvedenko,PF,23,LAL,58,10,620,112,258,0,2,112,256,31,43,66,75,141,18,11,8,37,118,255
252,Ron Mercer,SG,26,IND,72,3,1671,244,597,3,16,241,581,65,81,32,122,154,112,49,14,54,123,556
253,Chris Mihm,C,23,CLE,52,0,809,116,287,0,3,116,284,76,105,93,138,231,28,18,38,48,124,308
254,Darius Miles,SF,21,CLE,67,62,2008,263,642,0,14,263,628,92,155,113,250,363,176,67,69,178,159,618
255,Andre Miller,PG,26,LAC,80,80,2913,377,928,23,108,354,820,311,391,84,232,316,537,99,11,206,203,1088
256,Brad Miller,C,26,IND,73,72,2270,329,667,5,16,324,651,292,357,185,418,603,193,65,43,118,203,955
257,Mike Miller,SF,22,TOT,65,52,2186,373,859,109,300,264,559,156,186,46,295,341,170,42,21,125,173,1011
258,Reggie Miller*,SG,37,IND,70,70,2117,281,637,113,318,168,319,207,230,21,151,172,170,62,4,66,89,882
259,Chris Mills,PF,33,GSW,21,0,262,39,106,7,25,32,81,16,18,19,31,50,22,7,3,10,29,101
260,Yao Ming*,C,22,HOU,82,72,2382,401,805,1,2,400,803,301,371,196,479,675,137,31,147,173,230,1104
261,Cuttino Mobley,SG,27,HOU,73,73,3044,463,1067,112,318,351,749,242,282,70,233,303,208,95,36,166,185,1280
262,Nazr Mohammed,C,25,ATL,35,0,445,67,159,0,0,67,159,26,41,47,82,129,6,16,21,25,79,160
263,Jérôme Moïso,C,24,NOH,51,1,644,89,171,0,0,89,171,27,41,59,119,178,22,19,44,46,87,205
264,Mikki Moore,C,27,TOT,8,0,43,5,13,0,0,5,13,8,10,6,2,8,3,0,4,2,7,18
265,Terence Morris,SF,24,HOU,49,0,632,82,176,7,32,75,144,11,14,40,88,128,25,8,17,29,35,182
266,Troy Murphy,PF,22,GSW,79,79,2510,338,749,3,14,335,735,244,290,228,578,806,106,65,30,111,246,923
267,Ronald Murray,SG,23,TOT,14,0,62,11,31,0,5,11,26,5,8,0,4,4,5,4,0,8,0,27
268,Tracy Murray,SF,31,LAL,31,0,193,23,71,8,38,15,33,7,9,5,18,23,12,5,3,14,22,61
269,Dikembe Mutombo*,C,36,NJN,24,16,514,49,131,0,0,49,131,40,55,54,99,153,19,4,37,34,54,138
270,Mamadou N'Diaye,C,27,TOR,22,8,364,43,96,0,0,43,96,34,47,29,53,82,7,8,32,21,58,120
271,Boštjan Nachbar,SF,22,HOU,14,1,77,11,31,2,10,9,21,5,10,3,8,11,3,2,2,6,13,29
272,Lee Nailon,SF,27,NYK,38,0,405,84,190,0,1,84,189,42,51,32,38,70,26,6,3,32,46,210
273,Eduardo Nájera,SF,26,DAL,48,12,1103,129,231,0,1,129,230,62,91,90,133,223,47,40,22,23,129,320
274,Steve Nash*,PG,28,DAL,82,82,2711,518,1114,111,269,407,845,308,339,63,171,234,598,85,6,192,134,1455
275,Rasho Nesterović,C,26,MIN,77,77,2337,400,762,0,2,400,760,61,95,146,358,504,114,39,116,99,256,861
276,Ira Newble,SF,28,ATL,73,45,1931,231,467,32,84,199,383,70,90,86,185,271,99,50,26,69,174,564
277,Moochie Norris,PG,29,HOU,82,3,1375,134,330,11,45,123,285,78,114,37,122,159,196,55,4,86,72,357
278,Dirk Nowitzki,PF,24,DAL,80,80,3117,690,1489,148,390,542,1099,483,548,81,710,791,239,111,82,152,206,2011
279,Jermaine O'Neal,PF,24,IND,77,76,2864,610,1260,7,21,603,1239,373,510,202,594,796,155,66,178,180,277,1600
280,Shaquille O'Neal*,C,30,LAL,67,66,2535,695,1211,0,0,695,1211,451,725,259,483,742,206,38,159,196,229,1841
281,Charles Oakley,C,39,WAS,42,1,514,23,55,0,0,23,55,28,34,37,70,107,40,13,6,21,90,74
282,Lamar Odom,SF,23,LAC,49,47,1679,268,611,42,129,226,482,136,175,59,267,326,178,42,41,140,181,714
283,Mehmet Okur,PF,23,DET,72,9,1366,180,423,38,112,142,311,96,131,117,218,335,71,25,39,66,167,494
284,Dean Oliver,PG,24,GSW,15,0,93,7,29,1,6,6,23,7,8,8,8,16,23,7,0,10,9,22
285,Kevin Ollie,PG,30,TOT,82,5,1897,199,441,2,6,197,435,134,178,25,157,182,291,69,5,72,122,534
286,Michael Olowokandi,C,27,LAC,36,36,1369,186,436,0,0,186,436,69,105,57,271,328,47,18,79,98,110,441
287,Greg Ostertag,C,29,UTA,81,74,1926,169,326,0,0,169,326,100,196,180,323,503,55,20,147,104,235,438
288,Bo Outlaw,C,31,PHO,80,20,1800,153,278,0,2,153,276,72,116,134,234,368,112,50,71,76,194,378
289,Chris Owens,SF,23,MEM,1,0,6,2,3,0,0,2,3,0,0,1,0,1,0,0,0,1,0,4
290,Olumide Oyedeji,C,21,ORL,27,3,145,10,23,0,0,10,23,7,11,10,40,50,5,5,3,5,30,27
291,Robert Pack,PG,33,NOH,28,4,440,52,129,0,5,52,124,41,55,11,40,51,81,25,0,40,35,145
292,Scott Padgett,PF,26,UTA,82,2,1321,170,423,45,133,125,290,81,107,83,189,272,86,41,24,70,148,466
293,Milt Palacio,PG,24,CLE,80,46,1976,162,388,8,37,154,351,65,87,48,187,235,259,68,16,131,168,397
294,Jannero Pargo,PG,23,LAL,34,0,342,37,93,7,24,30,69,4,4,9,28,37,39,13,2,23,45,85
295,Smush Parker,PG,21,CLE,66,18,1103,136,338,38,118,98,220,98,118,29,90,119,162,48,12,133,106,408
296,Tony Parker,PG,20,SAS,82,82,2774,484,1043,82,243,402,800,219,290,33,183,216,432,71,4,198,174,1269
297,Cherokee Parks,PF,30,LAC,30,18,648,82,163,1,2,81,161,23,38,46,86,132,21,16,20,18,52,188
298,Ruben Patterson,SF,27,POR,78,17,1655,254,516,3,20,251,496,138,220,120,144,264,101,73,29,117,161,649
299,Gary Payton*,PG,34,TOT,80,80,3208,665,1466,54,182,611,1284,250,352,79,255,334,663,133,20,187,181,1634
300,Anthony Peeler,SG,33,MIN,82,39,2245,252,609,87,212,165,397,39,50,40,201,241,244,72,13,82,161,630
301,Wesley Person,SG,31,MEM,66,44,1941,274,601,100,231,174,370,79,97,24,168,192,112,42,19,56,64,727
302,Morris Peterson,SF,25,TOR,82,80,2949,421,1073,116,344,305,729,195,247,97,266,363,188,88,32,128,232,1153
303,Eric Piatkowski,SG,32,LAC,62,26,1360,210,446,80,201,130,245,101,122,44,112,156,70,33,9,56,92,601
304,Paul Pierce,SG,25,BOS,79,79,3096,663,1592,118,391,545,1201,604,753,106,472,578,349,139,62,288,227,2048
305,Scottie Pippen*,SF,37,POR,64,58,1911,265,597,38,133,227,464,121,148,57,221,278,285,105,25,164,149,689
306,Scot Pollard,C,27,SAC,23,0,325,40,87,0,0,40,87,23,38,46,60,106,6,13,15,15,50,103
307,James Posey,SF,26,TOT,83,71,2518,309,752,70,229,239,523,205,246,90,336,426,184,106,15,144,197,893
308,Lavor Postell,SG,24,NYK,12,0,98,14,38,2,7,12,31,13,15,1,3,4,3,2,0,7,9,43
309,Vitaly Potapenko,C,27,SEA,26,2,403,41,93,0,0,41,93,22,29,25,64,89,4,9,8,25,46,104
310,Tayshaun Prince,SF,22,DET,42,5,435,53,118,20,47,33,71,11,17,5,40,45,24,10,14,21,25,137
311,Joel Przybilla,C,23,MIL,32,17,546,18,46,0,0,18,46,12,24,48,97,145,12,10,45,19,85,48
312,Vladimir Radmanović,PF,22,SEA,72,16,1910,274,668,104,293,170,375,72,102,76,247,323,97,64,22,100,136,724
313,Igor Rakočević,PG,24,MIN,42,0,244,22,58,5,12,17,46,29,36,4,13,17,33,4,0,23,25,78
314,Zach Randolph,PF,21,POR,77,11,1301,264,515,0,5,264,510,122,161,139,204,343,41,42,14,62,141,650
315,Theo Ratliff,C,29,ATL,81,81,2518,276,595,0,0,276,595,154,214,154,453,607,73,56,262,137,271,706
316,Željko Rebrača,C,30,DET,30,12,488,80,145,0,0,80,145,38,48,27,65,92,9,6,17,29,79,198
317,Michael Redd,SG,23,MIL,82,14,2316,455,971,182,416,273,555,149,185,98,273,371,117,100,13,74,143,1241
318,Don Reid,PF,29,DET,1,0,10,0,3,0,0,0,3,1,2,0,0,0,0,0,0,0,4,1
319,Efthimi Rentzias,C,27,PHI,35,0,144,20,59,4,8,16,51,8,9,10,16,26,7,6,2,4,21,52
320,Glen Rice,SF,35,HOU,62,26,1532,196,457,101,254,95,203,63,83,28,126,154,65,23,5,55,99,556
321,Jason Richardson,SG,22,GSW,82,82,2698,476,1161,123,334,353,827,207,271,111,267,378,247,90,23,179,201,1282
322,Quentin Richardson,SG,22,LAC,59,13,1368,203,546,61,198,142,348,85,124,98,183,281,52,35,10,64,92,552
323,Antoine Rigaudeau,SG,31,DAL,11,0,91,8,35,1,5,7,30,0,0,4,4,8,6,3,0,6,11,17
324,Clifford Robinson,PF,36,DET,81,69,2825,372,935,87,259,285,676,161,238,81,237,318,268,87,88,158,259,992
325,David Robinson*,C,37,SAS,64,64,1676,197,420,0,0,197,420,152,214,163,345,508,61,52,111,83,126,546
326,Eddie Robinson,SF,26,CHI,64,18,1355,155,315,3,14,152,301,51,63,76,124,200,66,62,13,52,120,364
327,Glenn Robinson,SF,30,ATL,69,68,2591,539,1248,90,263,449,985,268,306,86,371,457,205,91,26,248,183,1436
328,Rodney Rogers,PF,31,NJN,68,0,1303,183,455,44,132,139,323,68,90,61,202,263,107,50,31,91,192,478
329,Sean Rooks,C,33,LAC,70,38,1344,125,297,0,1,125,296,47,58,53,163,216,69,34,44,66,174,297
330,Jalen Rose,SF,30,CHI,82,82,3351,642,1583,133,359,509,1224,399,467,68,283,351,395,72,23,285,271,1816
331,Malik Rose,PF,28,SAS,79,13,1933,289,630,2,5,287,625,242,306,148,358,506,124,57,40,170,206,822
332,Guy Rucker,PF,25,GSW,3,0,4,0,0,0,0,0,0,0,0,0,1,1,1,0,0,0,1,0
333,Kareem Rush,PG,22,LAL,76,0,872,96,244,19,68,77,176,16,23,26,68,94,68,10,11,63,71,227
334,Bryon Russell,SF,32,WAS,70,23,1388,108,306,46,140,62,166,53,69,43,165,208,72,70,7,55,130,315
335,Arvydas Sabonis*,C,38,POR,78,1,1209,172,361,3,6,169,355,129,164,88,247,335,142,61,49,75,141,476
336,John Salmons,PG,23,PHI,64,1,504,48,116,10,31,38,85,26,35,16,43,59,47,17,6,29,53,132
337,Soumaila Samake,C,24,LAL,13,1,77,10,24,0,0,10,24,2,2,10,13,23,4,0,5,2,13,22
338,Jamal Sampson,PF,19,MIL,5,0,8,0,2,0,0,0,2,0,0,1,1,2,1,1,0,0,0,0
339,Pepe Sánchez,PG,25,DET,9,0,37,0,5,0,0,0,5,0,0,4,2,6,8,5,0,2,3,0
340,Jeryl Sasser,SG,23,ORL,75,4,1025,64,207,13,44,51,163,53,78,64,120,184,65,45,12,39,91,194
341,Kenny Satterfield,PG,21,TOT,39,6,502,55,183,5,28,50,155,17,25,16,27,43,68,20,2,43,36,132
342,Predrag Savović,SG,26,DEN,27,0,256,29,93,4,26,25,67,21,29,9,16,25,22,14,1,21,33,83
343,Brian Scalabrine,PF,24,NJN,59,7,724,68,169,14,39,54,130,30,36,40,101,141,46,16,18,46,77,180
344,Ansu Sesay,SF,26,SEA,45,4,448,41,107,0,0,41,107,12,21,34,39,73,23,14,5,25,62,94
345,Brian Shaw,PG,36,LAL,72,0,900,101,261,38,109,63,152,10,15,20,99,119,103,32,13,54,62,250
346,Paul Shirley,PF,25,ATL,2,0,5,0,4,0,0,0,4,0,0,0,1,1,0,0,0,0,0,0
347,Bobby Simmons,SG,22,WAS,36,2,378,44,112,0,5,44,107,32,35,33,44,77,20,10,3,8,51,120
348,Brian Skinner,PF,26,PHI,77,9,1381,182,331,0,0,182,331,97,161,136,230,366,19,47,53,62,176,461
349,Reggie Slater,PF,32,MIN,26,0,141,27,50,0,0,27,50,27,45,18,13,31,4,6,1,9,31,81
350,Tamar Slay,SG,22,NJN,36,0,274,39,103,7,25,32,78,7,10,8,23,31,14,14,3,20,31,92
351,Charles Smith,SG,27,POR,3,0,13,1,4,0,1,1,3,3,4,0,0,0,1,1,0,1,3,5
352,Joe Smith,SF,27,MIN,54,21,1117,151,328,0,2,151,326,102,131,111,159,270,38,14,55,43,171,404
353,Steve Smith,SG,33,SAS,53,18,1032,113,291,39,118,74,173,95,114,21,78,99,70,28,9,43,79,360
354,Eric Snow,PG,29,PHI,82,82,3108,361,799,7,32,354,767,325,379,71,230,301,544,133,11,194,235,1054
355,Latrell Sprewell,SF,32,NYK,74,73,2859,454,1127,134,360,320,767,173,218,45,240,285,332,102,22,172,134,1215
356,Jerry Stackhouse,SG,28,WAS,70,70,2747,491,1201,71,245,420,956,455,518,61,197,258,316,65,28,193,130,1508
357,Vladimir Stepania,C,26,MIA,79,6,1594,185,427,0,0,185,427,71,134,211,343,554,24,45,40,69,169,441
358,DeShawn Stevenson,SG,21,UTA,61,8,760,114,284,4,12,110,272,47,68,22,63,85,40,22,8,49,57,279
359,Michael Stewart,PF,27,CLE,47,0,251,14,37,0,0,14,37,8,12,19,36,55,6,2,15,10,42,36
360,John Stockton*,PG,40,UTA,82,82,2275,309,640,29,80,280,560,237,287,51,150,201,629,137,16,182,184,884
361,Peja Stojaković,SF,25,SAC,72,72,2450,497,1034,155,406,342,628,231,264,61,336,397,141,72,5,101,143,1380
362,Damon Stoudamire,PG,29,POR,59,27,1315,156,415,44,114,112,301,53,67,40,115,155,204,39,6,82,67,409
363,Amar'e Stoudemire,PF,20,PHO,82,71,2570,392,830,2,10,390,820,320,484,250,471,721,78,62,87,189,269,1106
364,Erick Strickland,SG,29,IND,71,10,1275,163,380,62,160,101,220,70,87,23,122,145,209,38,7,98,111,458
365,Mark Strickland,SF,32,DAL,4,0,13,2,5,0,0,2,5,0,0,5,2,7,0,0,0,1,1,4
366,Rod Strickland,PG,36,MIN,47,8,956,120,278,1,11,119,267,79,107,20,75,95,215,46,6,76,55,320
367,Bruno Šundov,C,22,BOS,26,0,138,14,56,4,16,10,40,0,2,8,20,28,7,6,3,9,24,32
368,Bob Sura,SG,29,GSW,55,0,1130,135,328,28,85,107,243,103,148,58,109,167,177,45,2,82,108,401
369,Stromile Swift,PF,23,MEM,67,26,1478,235,489,0,2,235,487,177,245,114,270,384,45,55,104,99,152,647
370,Wally Szczerbiak,SF,25,MIN,52,42,1836,351,729,61,145,290,584,150,173,53,188,241,136,44,22,87,123,913
371,Maurice Taylor,PF,26,HOU,67,9,1377,231,535,0,2,231,533,100,138,95,143,238,66,22,22,100,151,562
372,Jason Terry,PG,25,ATL,81,81,3081,488,1141,160,431,328,710,259,292,37,242,279,600,126,14,249,175,1395
373,Etan Thomas,PF,24,WAS,38,0,513,61,124,0,0,61,124,60,94,70,95,165,3,8,23,33,66,182
374,Kenny Thomas,PF,25,TOT,66,42,1978,260,559,0,0,260,559,147,197,185,344,529,112,62,28,116,169,667
375,Kurt Thomas,C,30,NYK,81,81,2577,497,1028,2,3,495,1025,138,184,160,477,637,162,81,97,138,344,1134
376,Tim Thomas,SF,25,MIL,80,70,2358,412,930,97,265,315,665,145,186,97,292,389,102,70,49,133,257,1066
377,Jamaal Tinsley,PG,24,IND,73,69,2237,220,556,46,166,174,390,80,112,58,202,260,548,125,18,192,201,566
378,Óscar Torres,SG,26,GSW,17,0,109,16,36,7,13,9,23,14,20,3,9,12,3,4,2,8,9,53
379,Robert Traylor,C,25,NOH,69,0,851,105,237,1,3,104,234,57,88,108,154,262,50,45,37,53,153,268
380,Gary Trent,SF,28,MIN,80,22,1222,208,389,0,2,208,387,60,101,106,185,291,77,32,23,59,142,476
381,Jeff Trepagnier,SG,23,DEN,8,0,97,17,40,4,8,13,32,7,7,8,8,16,6,8,0,8,5,45
382,Cezary Trybański,C,23,MEM,15,0,86,5,20,0,0,5,20,4,10,6,8,14,1,0,6,8,13,14
383,Jake Tsakalidis,C,23,PHO,33,27,543,61,135,0,0,61,135,39,58,45,77,122,13,6,17,26,80,161
384,Nikoloz Tskitishvili,SF,19,DEN,81,16,1320,115,393,37,152,78,241,48,65,64,117,181,91,31,29,84,136,315
385,Hedo Türkoğlu,SF,23,SAC,67,11,1175,165,391,29,78,136,313,88,110,35,153,188,87,25,12,50,125,447
386,Nick Van Exel,SG,31,DAL,73,1,2026,342,831,118,312,224,519,110,144,35,173,208,312,42,4,123,86,912
387,Keith Van Horn,PF,27,PHI,74,73,2337,459,952,65,176,394,776,193,240,159,365,524,93,63,30,150,251,1176
388,Jacque Vaughn,PG,27,ORL,80,48,1686,184,411,8,34,176,377,97,125,26,92,118,232,64,2,97,169,473
389,Jake Voskuhl,C,25,PHO,65,1,947,92,163,0,0,92,163,64,96,97,128,225,36,18,29,48,172,248
390,Dajuan Wagner,SG,19,CLE,47,24,1385,223,605,55,174,168,431,128,160,20,62,82,130,38,7,85,107,629
391,Antoine Walker,PF,26,BOS,78,78,3235,603,1554,188,582,415,972,176,286,99,464,563,373,116,31,260,221,1570
392,Samaki Walker,C,26,LAL,67,39,1243,115,274,0,1,115,273,66,101,115,253,368,64,20,55,56,143,296
393,Ben Wallace,C,28,DET,73,73,2873,210,437,1,6,209,431,85,189,293,833,1126,120,104,230,88,179,506
394,Gerald Wallace,SF,20,SAC,47,7,571,90,183,1,4,89,179,39,74,38,90,128,23,24,15,44,68,220
395,Rasheed Wallace,PF,28,POR,74,74,2684,515,1094,110,307,405,787,200,272,113,435,548,153,70,77,140,223,1340
396,Charlie Ward,PG,32,NYK,66,6,1465,165,414,101,267,64,147,41,53,25,152,177,306,78,11,95,146,472
397,Earl Watson,PG,23,MEM,79,2,1366,170,391,31,91,139,300,62,86,46,118,164,225,89,14,88,138,433
398,Clarence Weatherspoon,PF,32,NYK,79,19,2024,186,414,0,0,186,414,149,194,214,385,599,68,69,36,63,174,521
399,Chris Webber,PF,29,SAC,67,67,2622,661,1433,5,21,656,1412,215,354,160,544,704,364,106,88,215,204,1542
400,Bonzi Wells,SG,26,POR,75,65,2396,437,990,38,130,399,860,226,313,98,296,394,246,123,18,215,220,1138
401,Jiří Welsch,SF,23,GSW,37,0,234,19,75,1,4,18,71,22,29,12,16,28,27,8,2,19,32,61
402,David Wesley,SG,32,NOH,73,73,2710,449,1037,134,316,315,721,185,237,38,137,175,251,109,9,132,173,1217
403,Jahidi White,C,26,WAS,16,8,230,25,53,0,0,25,53,17,25,37,36,73,2,1,12,9,33,67
404,Rodney White,SG,22,DEN,72,19,1563,260,638,32,134,228,504,98,125,43,170,213,121,45,32,156,134,650
405,Chris Whitney,PG,31,TOT,51,21,1052,124,349,50,164,74,185,57,69,3,64,67,145,29,2,71,92,355
406,Chris Wilcox,PF,20,LAC,46,3,479,73,140,0,0,73,140,25,50,32,72,104,21,7,12,26,65,171
408,Aaron Williams,C,31,NJN,81,0,1597,199,439,0,1,199,438,102,130,137,194,331,88,27,57,85,206,500
409,Alvin Williams,PG,28,TOR,78,78,2638,396,905,48,146,348,759,187,239,55,190,245,416,111,21,128,170,1027
410,Brandon Williams,SF,27,ATL,6,0,19,1,7,0,1,1,6,0,0,2,0,2,0,2,0,3,4,2
411,Eric Williams,SF,30,BOS,82,79,2350,254,575,37,110,217,465,201,268,143,239,382,140,86,19,97,234,746
412,Frank Williams,PG,22,NYK,21,0,167,9,33,6,16,3,17,4,6,3,15,18,34,7,2,17,20,28
413,Jason Williams,PG,27,MEM,76,76,2407,333,859,143,404,190,455,110,131,25,187,212,631,91,10,168,130,919
414,Jay Williams,PG,21,CHI,75,54,1961,273,685,65,202,208,483,103,161,27,168,195,350,86,17,171,179,714
415,Jerome Williams,PF,29,TOR,71,63,2346,267,535,1,6,266,529,156,281,231,419,650,95,116,26,98,197,691
416,Monty Williams,SF,31,PHI,21,2,276,34,80,0,2,34,78,24,32,12,33,45,26,12,5,17,33,92
417,Scott Williams,C,34,PHO,69,33,872,120,292,0,2,120,290,33,42,72,121,193,22,27,21,32,159,273
418,Shammond Williams,PG,27,TOT,78,11,1881,228,579,93,261,135,318,78,102,24,147,171,266,77,6,114,140,627
419,Walt Williams,SF,32,DAL,66,1,1161,134,341,64,171,70,170,31,50,53,154,207,59,42,26,35,141,363
420,Corliss Williamson,SF,29,DET,82,1,2061,374,826,2,11,372,815,237,300,147,211,358,104,44,27,126,238,987
421,Kevin Willis,C,40,SAS,71,6,840,123,257,0,2,123,255,51,83,83,143,226,24,20,20,60,120,297
422,Rubén Wolkowyski,PF,29,BOS,7,0,24,2,4,0,1,2,3,1,4,0,1,1,1,0,0,1,3,5
423,Loren Woods,C,24,MIN,38,11,353,29,76,1,3,28,73,21,27,27,68,95,19,10,13,23,37,80
424,Qyntel Woods,PF,21,POR,53,0,334,59,118,3,9,56,109,7,20,15,38,53,12,15,1,23,36,128
425,Metta World Peace,SF,23,IND,69,67,2317,362,846,71,211,291,635,273,371,101,261,362,198,159,50,145,242,1068
426,Lorenzen Wright,C,27,MEM,70,49,1982,325,716,0,5,325,711,147,223,170,358,528,80,51,54,110,209,797
427,Vincent Yarbrough,SG,21,DEN,59,39,1381,168,428,21,78,147,350,49,62,36,126,162,130,57,33,81,145,406
428,Wang Zhizhi,C,25,LAC,41,1,412,62,162,16,47,46,115,42,58,26,51,77,10,8,10,31,41,182
1,Shareef Abdur-Rahim,PF,27,TOT,85,56,2684,501,1054,9,34,492,1020,373,429,189,450,639,174,68,37,184,222,1384
2,Malik Allen,PF,25,MIA,45,6,616,83,198,0,0,83,198,25,33,42,77,119,16,12,28,27,81,191
3,Ray Allen*,SG,28,SEA,56,56,2152,447,1017,148,378,299,639,245,271,69,217,286,268,71,11,156,132,1287
4,Rafer Alston,PG,27,MIA,82,28,2581,287,764,161,434,126,330,103,134,26,200,226,372,114,18,128,212,838
5,Chris Andersen,PF,25,DEN,71,0,1029,90,203,0,1,90,202,63,107,89,209,298,35,34,114,48,119,243
6,Derek Anderson,SG,29,POR,51,46,1810,230,612,79,259,151,353,155,188,26,156,182,228,66,3,90,79,694
7,Kenny Anderson,PG,33,IND,44,31,905,113,256,1,4,112,252,35,48,19,62,81,125,26,5,50,73,262
8,Shandon Anderson,SG,30,NYK,80,37,1974,238,564,36,128,202,436,123,161,53,169,222,122,68,17,118,182,635
9,Carmelo Anthony,SF,19,DEN,82,82,2995,624,1465,69,214,555,1251,408,525,183,315,498,227,97,41,247,225,1725
11,Gilbert Arenas,PG,22,WAS,55,52,2066,358,914,125,333,233,581,237,317,55,199,254,275,103,12,226,176,1078
12,Brandon Armstrong,SG,23,NJN,56,0,434,65,175,19,52,46,123,2,4,12,31,43,14,12,2,24,49,151
13,Darrell Armstrong,PG,35,NOH,79,22,2247,291,736,135,429,156,307,123,144,63,163,226,311,133,16,155,148,840
14,Carlos Arroyo,PG,24,UTA,71,71,2008,339,768,38,117,301,651,181,225,41,144,185,355,63,5,156,165,897
15,Chucky Atkins,PG,29,TOT,64,24,1544,192,484,81,241,111,243,73,97,9,84,93,223,45,2,92,102,538
16,Stacey Augmon,SF,35,NOH,69,24,1416,143,347,1,7,142,340,110,139,52,122,174,85,55,15,76,114,397
17,Vin Baker,PF,32,TOT,54,33,1313,208,432,1,3,207,429,114,157,112,168,280,66,29,32,77,160,531
18,Marcus Banks,PG,22,BOS,81,2,1385,177,442,27,86,150,356,99,131,30,103,133,175,88,13,125,171,480
19,Leandro Barbosa,PG,21,PHO,70,46,1500,210,470,83,210,127,260,47,61,23,100,123,165,93,7,120,184,550
20,Matt Barnes,SF,23,LAC,38,9,724,63,138,2,13,61,125,43,61,53,98,151,48,27,3,44,76,171
21,Dana Barros,SG,36,BOS,1,0,11,2,3,0,0,2,3,2,2,0,0,0,0,0,0,0,2,6
22,Brent Barry,SG,32,SEA,59,53,1803,215,427,114,252,101,175,91,110,21,183,204,342,85,16,139,121,635
23,Jon Barry,SG,34,DEN,57,9,1101,120,297,51,138,69,159,60,71,25,98,123,147,57,8,53,66,351
24,Mengke Bateer,C,28,TOR,7,0,40,4,7,0,0,4,7,0,0,5,3,8,1,1,0,2,10,8
25,Tony Battie,C,27,TOT,73,7,1478,170,384,2,9,168,375,66,89,118,241,359,58,26,67,63,159,408
26,Shane Battier,SF,25,MEM,79,1,1947,242,543,65,186,177,357,120,164,102,201,303,101,101,58,56,187,669
28,Jerome Beasley,PF,23,MIA,2,0,5,1,3,0,0,1,3,0,0,0,1,1,0,0,0,0,0,2
29,Raja Bell,SG,27,UTA,82,4,2020,329,805,62,166,267,639,195,248,60,181,241,107,63,13,111,262,915
30,Troy Bell,PG,23,MEM,6,0,34,4,18,0,4,4,14,3,3,3,1,4,4,1,0,6,6,11
31,Jonathan Bender,SF,23,IND,21,0,271,50,106,9,22,41,84,39,47,9,31,40,9,5,11,33,23,148
32,Travis Best,PG,31,DAL,61,1,762,64,172,3,20,61,152,40,46,17,51,68,112,31,4,33,66,171
33,Mike Bibby,PG,25,SAC,82,82,2980,527,1170,148,378,379,792,304,373,67,210,277,444,112,18,175,146,1506
34,Chauncey Billups,PG,27,DET,78,78,2758,392,996,130,335,262,661,404,460,35,241,276,446,84,8,189,177,1318
35,Steve Blake,PG,23,WAS,75,14,1392,157,407,75,202,82,205,55,67,18,99,117,209,57,7,128,100,444
37,Mark Blount,C,28,BOS,82,73,2402,342,604,0,0,342,604,159,221,207,382,589,75,80,106,150,253,843
38,Keith Bogans,SF,23,ORL,73,36,1787,183,454,67,187,116,267,65,103,106,211,317,98,46,10,75,128,498
39,Calvin Booth,C,27,SEA,71,35,1206,135,290,0,2,135,288,75,94,86,194,280,28,17,101,45,150,345
40,Carlos Boozer,PF,22,CLE,75,75,2592,471,900,1,6,470,894,219,285,230,627,857,148,74,55,134,199,1162
41,Curtis Borchardt,C,23,UTA,16,0,258,22,56,0,1,22,55,14,18,13,41,54,15,4,14,18,40,58
42,Chris Bosh,C,19,TOR,75,63,2510,327,712,5,14,322,698,202,288,191,366,557,78,59,106,107,215,861
43,Ruben Boumtje-Boumtje,C,25,POR,9,0,26,1,5,0,0,1,5,2,2,0,1,1,1,0,1,0,2,4
44,Bruce Bowen,SF,32,SAS,82,82,2624,211,502,77,212,134,290,66,114,45,208,253,113,84,33,90,166,565
45,Ryan Bowen,PF,28,DEN,52,1,392,18,53,0,0,18,53,10,12,39,48,87,18,18,16,6,47,46
46,Earl Boykins,SG,27,DEN,82,3,1849,321,766,55,171,266,595,142,162,42,101,143,295,51,3,100,84,839
48,Shawn Bradley,C,31,DAL,66,5,773,89,188,0,1,89,187,41,49,72,101,173,20,33,74,17,130,219
49,Torraye Braggs,PF,27,TOT,15,0,154,16,33,0,0,16,33,8,12,18,21,39,7,4,2,13,29,40
50,Elton Brand,PF,24,LAC,69,68,2670,484,982,0,1,484,981,411,532,269,445,714,227,64,154,193,229,1379
51,J.R. Bremer,PG,23,TOT,36,2,443,43,158,19,74,24,84,13,20,9,27,36,51,18,4,24,32,118
52,Jamison Brewer,PG,23,IND,13,1,160,13,35,5,14,8,21,1,6,2,9,11,17,7,0,10,9,32
53,Primož Brezec,C,24,IND,18,0,72,12,26,0,0,12,26,4,6,5,10,15,3,0,3,6,13,28
54,Damone Brown,PF,24,NJN,3,0,17,1,10,0,0,1,10,1,2,3,2,5,0,2,0,1,2,3
55,Devin Brown,SG,25,SAS,58,0,627,85,196,4,14,81,182,60,74,38,92,130,33,15,4,38,61,234
56,Kedrick Brown,SF,22,TOT,55,26,969,117,254,38,99,79,155,17,27,41,105,146,64,30,7,29,80,289
57,Kwame Brown,PF,21,WAS,74,57,2239,288,589,1,2,287,587,228,334,178,372,550,112,66,52,140,144,805
58,P.J. Brown,PF,34,NOH,80,80,2753,339,712,0,1,339,711,158,185,237,453,690,155,78,73,101,203,836
59,Tierre Brown,PG,24,NOH,3,0,17,2,4,0,0,2,4,2,4,0,1,1,2,0,0,7,1,6
60,Rick Brunson,PG,31,TOT,40,0,412,40,105,11,23,29,82,27,31,9,28,37,82,25,3,33,44,118
61,Kobe Bryant,SG,25,LAL,65,64,2447,516,1178,71,217,445,961,454,533,103,256,359,330,112,28,171,176,1557
62,Greg Buckner,SG,27,PHI,53,3,703,66,175,12,44,54,131,20,27,28,75,103,45,21,4,34,77,164
63,Rodney Buford,SF,26,SAC,22,0,141,19,56,0,2,19,54,3,6,6,9,15,7,6,1,4,9,41
64,Caron Butler,SF,23,MIA,68,56,2030,240,631,10,42,230,589,133,176,92,234,326,126,75,13,91,162,623
65,Mitchell Butler,SG,33,WAS,41,4,552,54,124,11,30,43,94,15,24,24,47,71,32,22,4,24,54,134
66,Rasual Butler,SF,24,MIA,45,0,675,119,250,50,108,69,142,16,21,4,57,61,23,10,13,28,72,304
67,Žarko Čabarkapa,PF,22,PHO,49,4,570,81,197,6,32,75,165,35,53,26,73,99,40,10,13,54,75,203
68,Marcus Camby,C,29,DEN,72,72,2162,262,549,0,2,262,547,98,136,211,516,727,132,86,187,98,239,622
69,Elden Campbell,C,35,DET,65,27,892,138,314,0,0,138,314,85,124,52,157,209,45,21,50,63,137,361
70,Brian Cardinal,PF,26,GSW,76,11,1634,220,466,55,124,165,342,238,271,100,217,317,103,66,20,84,206,733
71,Matt Carroll,SG,23,TOT,16,0,70,7,16,1,3,6,13,4,6,1,5,6,2,1,0,6,8,19
72,Anthony Carter,PG,28,SAS,5,2,87,11,37,0,3,11,34,0,0,2,9,11,12,4,0,12,9,22
73,Maurice Carter,SG,27,TOT,10,0,110,11,35,4,11,7,24,16,20,2,9,11,4,0,0,9,10,42
74,Vince Carter,SG,27,TOR,73,73,2785,608,1457,93,243,515,1214,336,417,95,254,349,348,88,65,223,212,1645
75,Sam Cassell,PG,34,MIN,81,81,2838,620,1270,74,186,546,1084,289,331,44,227,271,592,102,18,220,247,1603
76,Kelvin Cato,PF,29,HOU,69,67,1743,161,360,0,0,161,360,96,142,153,319,472,72,52,96,84,203,418
77,Tyson Chandler,PF,21,CHI,35,8,782,67,158,0,1,67,157,79,118,82,188,270,23,17,43,38,87,213
78,Calbert Cheaney,SF,32,GSW,79,7,2067,278,578,0,10,278,568,47,77,77,183,260,136,60,12,85,184,603
79,Doug Christie,SG,33,SAC,82,82,2780,317,688,49,142,268,546,148,172,69,260,329,347,151,41,155,186,831
80,Keon Clark,PF,28,UTA,2,0,27,2,6,0,0,2,6,0,0,1,6,7,1,1,0,0,1,4
81,Speedy Claxton,PG,25,GSW,60,29,1595,224,524,4,22,220,502,182,224,38,118,156,267,97,9,102,146,634
82,Mateen Cleaves,PG,26,CLE,4,2,92,7,23,0,1,7,22,1,2,1,6,7,19,4,2,5,13,15
83,Derrick Coleman,C,36,PHI,34,30,843,107,259,8,36,99,223,49,65,45,147,192,46,23,26,57,79,271
84,Bimbo Coles,PG,35,MIA,22,1,170,12,34,0,0,12,34,4,6,2,8,10,15,3,0,9,27,28
85,Jason Collier,C,26,ATL,20,16,545,79,165,1,4,78,161,67,85,36,75,111,17,11,11,31,71,226
86,Jarron Collins,C,25,UTA,81,31,1732,147,295,0,1,147,294,188,262,117,199,316,77,26,18,79,255,482
87,Jason Collins,C,25,NJN,78,78,2220,163,384,0,2,163,382,136,184,143,257,400,153,67,56,97,251,462
88,Brian Cook,C,23,LAL,35,2,442,67,141,0,5,67,136,21,28,31,70,101,20,16,16,17,64,155
89,Omar Cook,PG,22,POR,17,0,139,7,27,0,1,7,26,0,0,3,3,6,24,10,0,10,14,14
90,Chris Crawford,PF,28,ATL,56,25,1207,211,471,44,113,167,358,103,119,58,117,175,45,37,20,55,131,569
91,Jamal Crawford,SG,23,CHI,80,73,2811,509,1318,165,521,344,797,200,240,46,237,283,405,111,29,193,161,1383
92,Austin Croshere,PF,28,IND,77,0,1051,119,307,56,144,63,163,93,104,60,183,243,52,24,14,55,101,387
93,Eddy Curry,PF,21,CHI,73,63,2154,417,840,1,1,416,839,235,350,143,308,451,68,24,83,177,258,1070
94,Michael Curry,SF,35,TOR,70,15,1229,76,196,3,15,73,181,49,58,22,65,87,53,23,5,48,153,204
95,Samuel Dalembert,C,22,PHI,82,53,2197,270,499,0,1,270,498,112,174,194,432,626,21,44,189,86,273,652
96,Erick Dampier,C,28,GSW,74,74,2403,348,650,0,2,348,648,217,332,344,543,887,60,33,137,131,227,913
97,Antonio Daniels,PG,28,SEA,71,32,1512,187,398,42,116,145,282,155,184,23,119,142,298,45,6,61,64,571
98,Marquis Daniels,SG,23,DAL,56,15,1039,203,411,11,36,192,375,60,78,66,80,146,116,53,12,44,51,477
99,Antonio Davis,C,35,TOT,80,79,2570,266,660,0,0,266,660,176,230,207,464,671,137,37,65,114,206,708
100,Baron Davis,PG,24,NOH,67,66,2686,554,1402,187,582,367,820,237,352,66,221,287,501,158,27,215,178,1532
101,Dale Davis,C,34,POR,76,37,1682,133,281,0,0,133,281,65,106,158,240,398,72,43,62,40,154,331
102,Hubert Davis,SG,33,TOT,17,0,78,1,11,0,1,1,10,2,2,2,6,8,4,2,0,3,12,4
103,Josh Davis,PF,23,ATL,4,1,23,2,5,0,2,2,3,1,1,1,4,5,0,0,0,2,3,5
105,Andrew DeClercq,C,30,ORL,71,53,1211,93,195,0,0,93,195,44,54,131,186,317,44,47,32,54,217,230
106,Tony Delk,SG,30,DAL,33,11,509,70,184,20,66,50,118,37,44,16,43,59,28,27,7,17,46,197
107,Derrick Dial,SG,28,ORL,9,0,86,9,28,2,9,7,19,6,8,5,8,13,2,6,0,1,6,26
108,Boris Diaw,SG,21,ATL,76,37,1919,140,313,6,26,134,287,56,93,111,231,342,182,59,37,126,191,342
109,Dan Dickau,PG,25,TOT,43,0,294,37,98,10,30,27,68,11,14,7,19,26,38,17,0,26,44,95
110,Kaniel Dickens,PF,25,POR,3,0,12,3,3,0,0,3,3,1,2,2,0,2,0,0,0,1,3,7
111,DeSagana Diop,C,22,CLE,56,3,730,57,147,0,0,57,147,12,20,72,127,199,34,26,51,29,116,126
112,Vlade Divac*,C,35,SAC,81,81,2317,314,668,2,13,312,655,170,260,136,327,463,432,57,77,173,222,800
113,Juan Dixon,SG,25,WAS,71,16,1478,247,637,59,198,188,439,111,139,30,118,148,137,82,4,104,111,664
114,Michael Doleac,C,26,TOT,72,0,1029,140,322,0,0,140,322,45,52,88,177,265,44,23,36,48,142,325
115,Keyon Dooling,PG,23,LAC,58,24,1137,137,352,8,46,129,306,78,94,17,62,79,130,45,6,65,108,360
116,Bryce Drew,PG,29,NOH,15,0,78,4,18,1,7,3,11,3,3,0,6,6,13,4,0,8,1,12
117,Predrag Drobnjak,C,28,LAC,61,14,949,149,379,11,36,138,343,73,86,54,142,196,39,22,24,48,85,382
118,Tim Duncan,PF,27,SAS,69,68,2527,592,1181,2,12,590,1169,352,588,227,632,859,213,62,185,183,164,1538
119,Mike Dunleavy,SF,23,GSW,75,69,2336,323,720,94,254,229,466,137,185,87,355,442,220,68,13,143,169,877
120,Ronald Dupree,SF,23,CHI,47,8,893,111,282,4,9,107,273,66,105,55,112,167,55,32,18,51,134,292
121,Ndudi Ebi,SF,19,MIN,17,0,32,6,14,0,0,6,14,1,4,2,1,3,3,0,4,3,6,13
122,Howard Eisley,PG,31,TOT,67,23,1457,166,451,52,163,114,288,76,89,20,109,129,273,56,5,98,137,460
123,Francisco Elson,C,27,DEN,62,14,875,94,199,0,1,94,198,30,45,65,138,203,32,35,39,35,145,218
124,Melvin Ely,PF,25,LAC,42,2,510,66,153,0,1,66,152,25,42,48,53,101,22,9,17,20,68,157
125,Reggie Evans,PF,23,SEA,75,27,1280,67,165,0,3,67,162,83,148,156,252,408,33,54,10,65,176,217
126,Desmond Ferguson,SF,26,POR,7,0,32,5,12,3,8,2,4,0,2,0,4,4,1,0,0,1,0,13
127,Michael Finley,SG,30,DAL,72,72,2778,514,1159,150,370,364,789,164,193,78,247,325,212,84,39,83,118,1342
128,Derek Fisher,SG,29,LAL,82,3,1769,203,576,52,179,151,397,122,153,30,122,152,187,103,4,79,115,580
129,Marcus Fizer,SF,25,CHI,46,2,738,134,350,2,17,132,333,90,120,61,141,202,43,16,8,51,97,360
130,Alton Ford,PF,22,HOU,9,0,41,6,11,0,0,6,11,3,6,3,8,11,3,0,1,3,9,15
131,T.J. Ford,PG,20,MIL,55,55,1472,153,398,5,21,148,377,80,98,37,140,177,356,60,3,139,123,391
132,Danny Fortson,C,27,DAL,56,20,625,71,139,0,0,71,139,75,92,114,136,250,9,12,11,37,148,217
133,Jeff Foster,C,27,IND,82,79,1961,197,362,0,4,197,358,103,154,248,362,610,64,71,27,60,189,497
134,Tremaine Fowlkes,SF,27,DET,36,0,261,15,48,1,8,14,40,13,18,18,35,53,14,9,3,12,37,44
135,Rick Fox,SF,34,LAL,38,34,846,73,186,15,61,58,125,22,30,29,73,102,98,29,4,48,99,183
136,Adonal Foyle,C,28,GSW,44,8,572,59,130,0,0,59,130,19,35,54,113,167,17,6,46,21,68,137
137,Richie Frahm,SF,26,SEA,54,0,469,63,139,34,92,29,47,23,26,12,44,56,24,16,4,7,50,183
138,Steve Francis,PG,26,HOU,79,79,3194,450,1117,73,250,377,867,337,435,116,317,433,493,139,35,294,257,1310
139,Hiram Fuller,PF,22,ATL,4,0,43,3,8,0,0,3,8,2,6,4,7,11,2,0,1,4,5,8
140,Dan Gadzuric,C,25,MIL,75,0,1260,183,349,0,1,183,348,58,118,126,220,346,28,51,105,45,186,424
141,Reece Gaines,PG,23,ORL,38,1,364,25,86,3,10,22,76,16,25,8,31,39,40,11,2,18,22,69
142,Alex Garcia,SG,23,SAS,2,0,13,1,7,0,0,1,7,1,2,0,0,0,0,2,0,1,0,3
143,Kevin Garnett,PF,27,MIN,82,82,3231,804,1611,11,43,793,1568,368,465,245,894,1139,409,120,178,212,202,1987
144,Pat Garrity,PF,27,ORL,2,0,22,1,3,0,0,1,3,0,0,0,0,0,1,0,0,0,2,2
145,Pau Gasol,PF,23,MEM,78,78,2458,506,1049,4,15,502,1034,365,511,206,394,600,198,44,132,187,185,1381
146,Devean George,SF,26,LAL,82,48,1951,233,571,65,186,168,385,73,96,87,245,332,112,81,38,88,189,604
147,Eddie Gill,PG,25,POR,22,0,157,15,36,3,8,12,28,17,20,4,13,17,16,9,1,12,16,50
148,Kendall Gill,SG,35,CHI,56,35,1411,215,548,9,38,206,510,100,136,61,129,190,89,65,16,83,107,539
149,Manu Ginóbili,SG,26,SAS,77,38,2260,330,789,88,245,242,544,239,298,86,258,344,291,136,16,161,181,987
151,Dion Glover,SG,25,TOT,69,30,1643,230,589,40,119,190,470,120,156,58,208,266,130,50,19,102,123,620
152,Anthony Goldwire,PG,32,TOT,11,0,85,7,22,2,8,5,14,1,1,1,6,7,11,5,0,3,5,17
153,Drew Gooden,PF,22,ORL,79,17,2134,369,829,9,42,360,787,167,262,160,356,516,89,62,72,126,196,914
154,Brian Grant,C,31,MIA,76,76,2303,289,613,0,1,289,612,86,110,174,350,524,69,51,35,82,254,664
155,Horace Grant,PF,38,LAL,55,10,1106,92,224,0,1,92,223,39,54,79,154,233,71,24,21,29,70,223
156,Paul Grant,C,30,UTA,10,0,98,11,23,0,0,11,23,3,8,7,10,17,3,1,1,7,17,25
157,Willie Green,SG,22,PHI,53,0,767,143,357,19,61,124,296,59,81,16,49,65,53,26,5,59,83,364
158,Adrian Griffin,SG,29,HOU,19,1,133,5,18,1,2,4,16,0,4,1,18,19,10,7,2,3,17,11
159,Tom Gugliotta,PF,34,TOT,55,27,819,70,203,1,4,69,199,20,28,65,122,187,63,31,12,39,81,161
160,Marcus Haislip,PF,23,MIL,31,0,263,36,74,1,2,35,72,20,28,21,32,53,4,6,12,9,25,93
161,Darvin Ham,SF,30,DET,54,2,484,37,75,1,2,36,73,21,35,47,46,93,16,13,8,31,63,96
162,Richard Hamilton,SG,25,DET,78,78,2772,530,1166,18,68,512,1098,297,342,78,201,279,310,103,17,210,222,1375
163,Zendon Hamilton,C,28,PHI,46,0,473,51,95,0,0,51,95,67,96,49,97,146,13,8,8,27,74,169
164,Ben Handlogten,C,30,UTA,17,0,172,25,47,0,0,25,47,18,27,22,33,55,6,3,4,10,32,68
165,Travis Hansen,SF,25,ATL,41,4,507,46,130,9,30,37,100,22,27,30,40,70,19,10,9,15,67,123
166,Anfernee Hardaway,SG,32,TOT,76,14,2095,279,679,30,79,249,600,111,138,69,218,287,176,70,20,107,146,699
167,Matt Harpring,SF,27,UTA,31,31,1134,193,410,8,33,185,377,108,157,91,156,247,63,22,2,65,102,502
168,Al Harrington,PF,23,IND,79,15,2441,421,909,21,77,400,832,185,252,163,345,508,131,80,22,163,250,1048
169,Othella Harrington,PF,30,NYK,56,3,872,100,202,0,0,100,202,58,78,58,119,177,29,12,14,65,134,258
170,Lucious Harris,PG,33,NJN,69,15,1504,187,463,38,101,149,362,66,78,39,101,140,135,41,2,53,74,478
171,Jason Hart,PG,25,SAS,53,5,660,71,159,2,9,69,150,33,43,10,69,79,81,28,5,29,59,177
172,Donnell Harvey,PF,23,TOT,60,8,783,89,201,0,3,89,198,61,83,48,116,164,21,24,27,45,129,239
173,Udonis Haslem,PF,23,MIA,75,24,1795,205,447,0,3,205,444,140,183,189,284,473,51,33,24,74,197,550
174,Trenton Hassell,SG,24,MIN,81,74,2264,177,381,4,13,173,368,48,61,68,189,257,133,36,54,46,200,406
175,Jarvis Hayes,SF,22,WAS,70,42,2044,278,695,40,131,238,564,77,98,71,193,264,106,71,11,110,157,673
176,Brendan Haywood,C,24,WAS,77,59,1484,200,388,0,1,200,387,137,234,186,201,387,43,32,100,80,154,537
177,Shane Heal,PG,33,SAS,6,0,72,7,24,4,18,3,6,4,5,1,3,4,5,1,0,5,2,22
178,Alan Henderson,PF,31,ATL,6,0,68,10,21,0,0,10,21,4,6,11,10,21,2,1,2,3,1,24
179,Nenê Hilário,PF,21,DEN,77,77,2504,334,630,0,2,334,628,240,352,154,349,503,168,116,41,183,280,908
180,Tyrone Hill,PF,35,MIA,5,0,38,3,5,0,0,3,5,3,4,5,3,8,0,0,1,2,10,9
181,Kirk Hinrich,PG,23,CHI,76,66,2706,318,823,144,369,174,454,135,168,42,217,259,517,101,21,204,276,915
182,Fred Hoiberg,SG,31,MIN,79,3,1804,178,383,76,172,102,211,98,116,21,247,268,109,66,10,44,136,530
183,Robert Horry,PF,33,SAS,81,1,1290,141,348,41,108,100,240,69,107,108,164,272,101,48,49,55,165,392
184,Eddie House,SG,25,LAC,60,10,1188,161,449,51,136,110,313,36,45,28,110,138,148,65,4,63,92,409
185,Allan Houston,SG,32,NYK,50,50,1799,340,781,87,202,253,579,157,172,20,101,121,99,38,2,102,105,924
186,Josh Howard,SF,23,DAL,67,29,1589,229,532,20,66,209,466,97,138,149,219,368,97,69,54,67,168,575
187,Juwan Howard,PF,30,ORL,81,77,2877,529,1169,0,1,529,1168,318,393,171,399,570,158,54,22,178,284,1376
188,Troy Hudson,PG,27,MIN,29,1,503,80,207,31,77,49,130,27,33,4,31,35,70,7,0,34,32,218
189,Larry Hughes,SG,25,WAS,61,61,2061,401,1009,79,232,322,777,267,335,96,230,326,148,95,26,152,147,1148
190,Ryan Humphrey,PF,24,MEM,2,0,11,1,4,0,1,1,3,0,0,2,1,3,1,1,0,2,3,2
191,Brandon Hunter,PF,23,BOS,36,12,406,53,116,0,3,53,113,19,43,50,68,118,19,13,1,22,40,125
192,Lindsey Hunter,SG,33,DET,33,8,661,49,143,14,50,35,93,5,8,13,54,67,85,39,6,34,45,117
193,Steven Hunter,C,22,ORL,59,23,789,82,155,0,0,82,155,23,69,54,116,170,12,5,73,29,101,187
194,Zydrunas Ilgauskas,C,28,CLE,81,81,2539,466,965,2,7,464,958,303,406,279,374,653,109,39,201,163,277,1237
195,Allen Iverson*,SG,28,PHI,48,47,2040,435,1125,57,199,378,926,339,455,34,144,178,324,115,5,209,87,1266
196,Bobby Jackson,SG,30,SAC,50,0,1185,263,592,81,219,182,373,82,109,55,119,174,105,49,8,63,106,689
197,Jim Jackson,SF,33,HOU,80,80,3119,382,900,162,405,220,495,107,127,52,435,487,226,86,23,175,227,1033
198,Marc Jackson,PF,29,PHI,22,13,598,71,171,0,1,71,170,64,81,45,81,126,18,12,6,24,45,206
199,Mark Jackson,PG,38,HOU,42,3,577,34,100,7,41,27,59,28,39,10,60,70,119,17,1,53,41,103
200,Stephen Jackson,SF,25,ATL,80,78,2940,536,1261,145,427,391,834,233,297,97,273,370,244,142,20,223,216,1450
201,Casey Jacobsen,SF,22,PHO,78,13,1828,150,360,75,180,75,180,91,111,42,159,201,98,48,9,68,144,466
202,Jerome James,C,28,SEA,65,24,990,129,259,0,0,129,259,66,100,78,152,230,32,20,60,82,180,324
203,LeBron James,SG,19,CLE,79,79,3122,622,1492,63,217,559,1275,347,460,99,333,432,465,130,58,273,149,1654
204,Mike James,PG,28,TOT,81,55,2196,272,657,106,281,166,376,103,127,28,206,234,339,96,3,124,156,753
205,Antawn Jamison,SF,27,DAL,82,2,2376,488,913,16,40,472,873,220,294,233,287,520,70,83,30,81,174,1212
206,Marko Jarić,PG,25,LAC,58,50,1760,185,477,51,150,134,327,74,101,44,131,175,281,93,20,115,132,495
208,Richard Jefferson,SF,23,NJN,82,82,3133,555,1115,48,132,507,983,357,468,109,355,464,315,92,28,198,224,1515
209,Jared Jeffries,PF,22,WAS,82,38,1913,177,469,5,30,172,439,105,171,180,244,424,93,48,28,107,212,464
210,Britton Johnsen,C,24,ORL,20,4,290,17,59,1,12,16,47,7,16,15,30,45,12,7,1,14,28,42
211,Anthony Johnson,PG,29,IND,73,7,1598,167,411,41,122,126,289,75,94,28,102,130,202,64,8,75,138,450
212,Avery Johnson,PG,38,GSW,46,1,637,80,199,0,3,80,196,52,78,3,30,33,111,26,3,51,34,212
213,DerMarr Johnson,SF,23,NYK,21,1,287,36,97,13,36,23,61,28,31,5,34,39,11,8,7,16,32,113
214,Ervin Johnson,C,36,MIN,66,47,965,55,103,0,1,55,102,17,28,61,171,232,24,27,43,30,156,127
215,Joe Johnson,SG,22,PHO,82,77,3331,555,1291,83,272,472,1019,174,232,80,305,385,362,93,26,199,177,1367
216,Linton Johnson,SF,23,CHI,41,20,734,72,203,7,33,65,170,22,37,59,124,183,27,37,32,37,90,173
217,Dahntay Jones,SG,23,MEM,20,0,154,15,53,1,4,14,49,5,11,7,16,23,12,5,6,12,23,36
218,Damon Jones,PG,27,MIL,82,26,2016,210,524,98,273,112,251,55,72,15,155,170,478,30,4,103,92,573
219,Eddie Jones,SG,32,MIA,81,81,2998,473,1156,177,479,296,677,278,333,38,270,308,258,92,34,129,226,1401
220,Fred Jones,SG,24,IND,81,2,1508,123,311,27,89,96,222,124,149,25,101,126,173,65,18,73,132,397
221,James Jones,SF,23,IND,6,0,26,2,9,1,4,1,5,2,2,0,2,2,0,1,0,0,1,7
222,Jumaine Jones,SG,24,BOS,42,2,373,33,96,13,44,20,52,14,23,24,44,68,14,12,9,19,48,93
223,Popeye Jones,PF,33,GSW,5,0,10,0,2,0,0,0,2,0,0,1,0,1,0,0,0,0,2,0
224,Chris Kaman,C,21,LAC,82,61,1843,200,435,0,2,200,433,99,142,126,335,461,85,23,73,155,211,499
225,Jason Kapono,SF,22,CLE,41,3,427,52,129,21,44,31,85,20,24,19,36,55,14,13,2,21,41,145
226,Jason Kidd*,PG,30,NJN,67,66,2450,368,959,94,293,274,666,206,249,85,343,428,618,122,14,214,110,1036
227,Andrei Kirilenko,PF,22,UTA,78,78,2895,412,931,68,201,344,730,392,496,226,403,629,244,150,215,215,174,1284
228,Kerry Kittles,SG,29,NJN,82,82,2842,434,959,97,276,337,683,107,136,56,271,327,206,125,40,95,144,1072
229,Brevin Knight,PG,28,TOT,56,13,1037,105,246,2,8,103,238,49,65,14,98,112,204,84,1,72,107,261
230,Kyle Korver,SF,22,PHI,74,0,882,115,327,81,207,34,120,19,24,30,81,111,40,25,8,41,102,330
231,Toni Kukoč,PF,35,MIL,73,0,1522,211,506,49,168,162,338,145,199,60,211,271,200,59,21,110,110,616
232,Christian Laettner,PF,34,WAS,48,18,984,119,256,6,21,113,235,40,50,50,182,232,89,37,28,42,102,284
233,Raef LaFrentz,C,27,BOS,17,1,328,57,124,8,40,49,84,10,13,30,49,79,24,8,13,11,47,132
234,Maciej Lampe,C,18,PHO,21,0,224,43,88,0,4,43,84,10,13,9,35,44,9,3,3,15,28,96
235,Sean Lampley,SF,24,GSW,10,0,63,13,20,0,0,13,20,8,12,2,9,11,2,0,1,3,2,34
236,Dan Langhi,SF,26,TOT,6,0,37,5,14,1,2,4,12,2,2,0,4,4,0,0,0,2,7,13
237,Rusty LaRue,PG,30,GSW,4,0,22,1,3,1,1,0,2,1,2,0,3,3,2,2,0,4,2,4
238,Voshon Lenard,SG,30,DEN,73,70,2233,394,933,106,289,288,644,144,182,46,154,200,151,61,12,101,177,1038
239,Quincy Lewis,SF,26,MIN,14,0,65,7,20,2,5,5,15,0,0,1,6,7,2,2,2,3,10,16
240,Rashard Lewis,SF,24,SEA,80,80,2931,535,1229,145,386,390,843,206,270,133,385,518,175,99,54,135,233,1421
241,Randy Livingston,PG,28,LAC,4,0,48,2,10,0,3,2,7,4,6,2,5,7,4,2,0,4,7,8
242,Raül López,PG,23,UTA,82,11,1617,223,517,25,85,198,432,101,117,24,131,155,305,62,2,174,200,572
243,Tyronn Lue,PG,26,ORL,76,69,2332,309,714,80,209,229,505,101,131,26,161,187,317,61,5,124,185,799
244,George Lynch,SF,33,NOH,78,51,1701,149,375,43,139,106,236,34,51,96,216,312,117,48,18,64,159,375
245,Mark Madsen,C,28,MIN,72,12,1246,101,204,0,6,101,198,57,118,134,138,272,28,33,18,47,175,259
246,Corey Maggette,SF,24,LAC,73,72,2628,453,1013,76,231,377,782,526,620,96,334,430,224,65,16,207,217,1508
247,Jamaal Magloire,C,25,NOH,82,82,2777,383,809,0,1,383,808,353,470,268,579,847,86,43,101,201,278,1119
248,Karl Malone*,PF,40,LAL,42,42,1373,193,400,0,1,193,399,168,225,61,306,367,163,50,20,103,116,554
249,Stephon Marbury,PG,26,TOT,81,81,3254,598,1386,87,274,511,1112,356,436,58,205,263,719,129,9,249,172,1639
250,Shawn Marion,SF,25,PHO,79,79,3217,590,1341,90,265,500,1076,228,268,212,525,737,214,167,104,156,203,1498
251,Donyell Marshall,PF,30,TOT,82,74,2988,470,1020,131,325,339,695,134,182,210,598,808,122,93,124,117,247,1205
252,Darrick Martin,PG,32,MIN,16,0,172,20,67,6,26,14,41,9,9,2,5,7,23,2,1,7,23,55
253,Kenyon Martin,PF,26,NJN,65,62,2252,439,900,7,25,432,875,201,294,133,484,617,160,95,82,168,230,1086
254,Jamal Mashburn,SF,31,NOH,19,18,730,156,398,19,67,137,331,65,80,19,98,117,47,14,5,37,42,396
255,Desmond Mason,SF,26,MIL,82,31,2534,409,867,9,39,400,828,356,463,93,266,359,152,60,24,148,191,1183
256,Roger Mason,SG,23,TOT,26,3,328,32,98,13,39,19,59,19,22,1,30,31,26,11,6,20,36,96
257,Tony Massenburg,PF,36,SAC,59,0,789,104,219,0,1,104,218,43,63,57,131,188,29,14,18,45,144,251
258,Walter McCarty,PF,29,BOS,77,23,1900,203,523,137,366,66,157,62,82,28,211,239,124,72,22,91,179,605
259,Amal McCaskill,C,30,PHI,59,3,636,47,117,0,1,47,116,19,27,48,85,133,20,12,20,25,89,113
260,Jelani McCoy,C,26,CLE,2,0,12,0,0,0,0,0,0,0,0,1,3,4,0,0,0,1,4,0
261,Antonio McDyess,PF,29,TOT,42,20,927,126,268,0,0,126,268,38,69,70,187,257,36,37,24,57,117,290
262,Tracy McGrady*,SG,24,ORL,67,67,2675,653,1566,174,513,479,1053,398,500,95,307,402,370,93,42,179,129,1878
264,Aaron McKie,SF,31,PHI,75,41,2112,265,577,75,172,190,405,84,111,45,208,253,195,85,23,103,142,689
265,Keith McLeod,PG,24,MIN,33,0,391,27,82,1,10,26,72,33,43,5,29,34,59,16,1,29,39,88
266,Stanislav Medvedenko,PF,24,LAL,68,38,1442,237,537,0,3,237,534,89,116,148,195,343,57,38,18,59,191,563
267,Ron Mercer,SG,27,SAS,39,0,516,90,211,2,7,88,204,13,17,10,39,49,22,14,5,26,37,195
269,Darius Miles,SF,22,TOT,79,56,2079,365,753,7,40,358,713,124,193,112,247,359,162,67,61,130,168,861
270,Darko Miličić,C,18,DET,34,0,159,17,65,0,1,17,64,14,24,11,32,43,7,7,15,13,33,48
271,Andre Miller,PG,27,DEN,82,82,2838,430,941,12,65,418,876,342,411,127,239,366,501,142,25,215,194,1214
272,Brad Miller,PF,27,SAC,72,53,2621,373,731,12,38,361,693,256,329,191,552,743,312,68,86,144,247,1014
273,Mike Miller,SF,23,MEM,65,65,1770,270,616,80,215,190,401,102,141,42,174,216,232,59,14,107,162,722
274,Oliver Miller,C,33,MIN,48,1,506,53,100,0,1,53,99,15,23,46,84,130,36,19,26,33,91,121
275,Reggie Miller*,SG,38,IND,80,80,2254,260,594,134,334,126,260,146,165,18,170,188,249,65,11,68,96,800
276,Yao Ming*,C,23,HOU,82,82,2692,535,1025,0,2,535,1023,361,446,197,538,735,122,22,156,204,273,1431
277,Cuttino Mobley,SG,28,HOU,80,80,3229,460,1081,164,420,296,661,176,217,40,322,362,258,107,33,180,179,1260
278,Nazr Mohammed,C,26,TOT,80,24,1611,246,472,0,0,246,472,100,169,178,296,474,36,55,52,96,195,592
279,Jérôme Moïso,PF,25,TOR,35,1,417,40,84,0,1,40,83,22,38,41,72,113,8,17,12,25,42,102
281,Alonzo Mourning*,C,33,NJN,12,0,215,33,71,0,0,33,71,30,34,8,19,27,8,2,6,10,32,96
282,Troy Murphy,PF,23,GSW,28,0,610,107,243,5,17,102,226,60,80,48,125,173,20,12,17,34,58,279
283,Lamond Murray,SF,30,TOR,33,4,518,76,215,21,60,55,155,24,35,14,76,90,28,15,7,38,47,197
284,Ronald Murray,PG,24,SEA,82,18,2021,389,915,67,229,322,686,168,235,45,159,204,205,81,28,149,158,1013
285,Tracy Murray,SF,32,POR,7,0,35,3,12,2,5,1,7,0,1,3,2,5,1,1,0,2,3,8
286,Dikembe Mutombo*,C,37,NYK,65,56,1494,141,295,0,0,141,295,81,119,145,292,437,25,17,123,54,141,363
287,Mamadou N'Diaye,C,28,TOT,28,1,366,27,69,0,0,27,69,44,59,43,69,112,0,8,25,18,59,98
288,Boštjan Nachbar,SF,23,HOU,45,3,516,47,132,23,63,24,69,21,29,8,62,70,30,14,14,23,72,138
290,Eduardo Nájera,SF,27,DAL,58,7,720,72,162,2,4,70,158,30,46,67,89,156,25,35,19,29,90,176
291,Steve Nash*,PG,29,DAL,78,78,2612,397,845,104,257,293,588,230,251,59,173,232,687,67,8,209,139,1128
292,Rasho Nesterović,C,27,SAS,82,82,2353,328,700,0,0,328,700,54,114,257,376,633,114,51,165,107,247,710
293,Ira Newble,SF,29,CLE,64,25,1245,108,276,2,19,106,257,36,46,65,90,155,72,25,19,54,109,254
294,Moochie Norris,PG,30,TOT,66,0,847,80,217,20,58,60,159,54,71,10,55,65,121,44,5,64,51,234
295,Dirk Nowitzki,C,25,DAL,77,77,2915,605,1310,99,290,506,1020,371,423,90,580,670,207,92,104,135,216,1680
296,Jermaine O'Neal,PF,25,IND,78,78,2788,608,1400,2,18,606,1382,348,460,193,585,778,164,59,199,181,248,1566
297,Shaquille O'Neal*,C,31,LAL,67,67,2464,554,948,0,0,554,948,331,676,246,523,769,196,34,166,195,225,1439
298,Charles Oakley,PF,40,HOU,7,0,25,2,6,0,0,2,6,5,6,0,5,5,2,0,0,1,8,9
299,Lamar Odom,PF,24,MIA,80,80,3003,485,1127,61,205,424,922,340,458,160,616,776,327,85,71,236,273,1371
300,Mehmet Okur,PF,24,DET,71,33,1580,251,542,18,48,233,494,162,209,160,261,421,69,36,63,101,138,682
301,Kevin Ollie,PG,31,CLE,82,7,1401,95,257,4,9,91,248,147,176,23,147,170,234,51,8,81,119,341
302,Michael Olowokandi,C,28,MIN,43,25,925,121,285,0,0,121,285,36,61,78,167,245,24,16,68,54,137,278
303,Greg Ostertag,C,30,UTA,78,51,2153,208,437,0,1,208,436,113,195,221,357,578,123,30,139,99,228,529
304,Bo Outlaw,PF,32,MEM,82,1,1606,159,312,0,4,159,308,61,116,125,217,342,90,73,70,69,170,379
305,Travis Outlaw,PF,19,POR,8,0,19,3,7,0,0,3,7,2,4,2,2,4,1,1,0,1,1,8
306,Doug Overton,PG,34,TOT,61,11,1033,99,245,3,23,96,222,23,31,16,70,86,138,26,2,58,89,224
307,Zaza Pachulia,C,19,ORL,59,2,664,68,175,0,0,68,175,58,90,69,105,174,13,21,12,34,87,194
308,Robert Pack,PG,34,NJN,26,0,220,22,52,0,0,22,52,5,6,4,14,18,27,12,1,16,20,49
309,Scott Padgett,PF,27,HOU,58,5,547,74,167,28,65,46,102,24,32,46,93,139,23,12,13,22,73,200
310,Milt Palacio,PG,25,TOR,59,13,1211,104,298,4,26,100,272,45,68,15,87,102,184,41,11,87,90,257
311,Jannero Pargo,PG,24,TOT,31,1,479,81,199,22,62,59,137,23,27,8,29,37,70,13,6,47,50,207
312,Tony Parker,PG,21,SAS,75,75,2577,423,946,62,199,361,747,191,272,43,194,237,411,61,7,179,148,1099
313,Cherokee Parks,C,31,GSW,12,0,64,4,10,0,0,4,10,4,6,4,6,10,1,0,3,2,7,12
314,Ruben Patterson,SF,28,POR,73,1,1651,200,395,2,12,198,383,105,190,129,139,268,139,84,21,105,152,507
315,Sasha Pavlović,SF,20,UTA,79,14,1144,149,376,19,70,130,306,65,84,44,115,159,60,41,16,67,187,382
316,Gary Payton*,PG,35,LAL,82,82,2825,482,1024,55,165,427,859,180,252,72,270,342,449,96,19,151,169,1199
317,Anthony Peeler,SG,34,SAC,75,0,1391,156,348,68,141,88,207,51,61,31,122,153,120,56,10,77,103,431
318,Desmond Penigar,PF,22,ORL,10,0,89,14,28,0,0,14,28,4,4,6,18,24,3,2,2,6,14,32
319,Kirk Penney,SG,23,MIA,2,0,18,1,6,1,3,0,3,0,0,0,1,1,1,1,0,3,1,3
320,Kendrick Perkins,C,19,BOS,10,0,35,8,15,0,0,8,15,6,9,5,9,14,3,0,2,5,6,22
321,Wesley Person,SG,32,TOT,58,0,1037,126,314,55,138,71,176,31,39,16,101,117,66,19,9,38,38,338
322,Morris Peterson,SF,26,TOR,82,29,2148,238,587,126,340,112,247,76,94,35,226,261,113,88,14,69,206,678
323,Eric Piatkowski,SF,33,HOU,49,0,703,72,191,43,122,29,69,14,16,10,63,73,26,16,5,29,42,201
324,Paul Pierce,SG,26,BOS,80,80,3099,602,1497,115,384,487,1113,517,631,69,453,522,410,131,52,303,234,1836
325,Mickaël Piétrus,PG,21,GSW,53,22,748,96,231,35,105,61,126,52,75,48,71,119,27,32,12,40,100,279
326,Scottie Pippen*,SF,38,CHI,23,6,412,53,140,13,48,40,92,17,27,20,48,68,50,21,9,29,38,136
327,Zoran Planinić,SG,21,NJN,49,1,473,53,129,9,32,44,97,38,60,14,41,55,68,13,3,36,70,153
328,Scot Pollard,C,28,IND,61,3,678,47,114,0,0,47,114,12,21,67,97,164,10,23,26,22,110,106
329,Olden Polynice,C,39,LAC,2,0,12,0,0,0,0,0,0,0,0,1,1,2,1,1,0,4,2,0
330,Mark Pope,PF,31,DEN,4,0,20,1,2,0,0,1,2,0,1,0,3,3,0,1,0,3,8,2
331,James Posey,SG,27,MEM,82,82,2451,368,770,112,290,256,480,278,335,92,311,403,122,137,40,112,248,1126
332,Vitaly Potapenko,C,28,SEA,65,39,1419,200,409,0,0,200,409,59,92,101,188,289,53,22,28,77,161,459
333,Tayshaun Prince,SF,23,DET,82,80,2701,338,723,57,157,281,566,108,141,93,297,390,191,63,69,119,149,841
334,Joel Przybilla,C,24,TOT,17,12,347,18,50,0,0,18,50,13,31,32,79,111,7,5,17,18,53,49
335,Vladimir Radmanović,PF,23,SEA,77,38,2321,345,812,140,377,205,435,95,127,104,302,406,142,80,42,109,187,925
336,Zach Randolph,PF,22,POR,81,80,3067,663,1368,1,5,662,1363,299,393,242,609,851,163,68,41,247,227,1626
337,Theo Ratliff,C,30,TOT,85,83,2664,266,549,0,0,266,549,140,217,195,419,614,71,54,307,120,300,672
338,Željko Rebrača,C,31,TOT,24,2,273,34,77,0,0,34,77,23,30,23,35,58,6,5,11,17,52,91
339,Michael Redd,SG,24,MIL,82,82,3021,633,1439,127,363,506,1076,383,441,118,289,407,185,81,6,116,152,1776
340,Glen Rice,SF,36,LAC,18,0,262,22,76,5,28,17,48,17,17,9,32,41,24,6,0,13,22,66
341,Jason Richardson,SG,23,GSW,78,78,2936,563,1284,77,273,486,1011,258,377,124,400,524,226,86,41,196,182,1461
342,Quentin Richardson,SG,23,LAC,65,64,2338,425,1068,120,341,305,727,151,204,146,268,414,139,67,19,141,130,1121
343,Luke Ridnour,PG,22,SEA,69,6,1114,145,350,27,80,118,270,65,79,35,73,108,163,52,7,80,105,382
344,Clifford Robinson,PF,37,GSW,82,82,2846,366,945,112,314,254,631,123,173,54,268,322,271,68,73,173,237,967
345,Eddie Robinson,SF,27,CHI,51,4,1024,157,326,1,5,156,321,28,43,27,77,104,58,33,10,45,57,343
346,Glenn Robinson,SF,31,PHI,42,42,1336,275,614,34,100,241,514,114,137,46,143,189,57,42,9,106,96,698
347,Rodney Rogers,PF,32,NJN,69,15,1409,207,505,50,152,157,353,75,98,100,207,307,137,59,27,98,183,539
348,Sean Rooks,C,34,TOT,55,0,595,54,151,0,1,54,150,33,37,24,73,97,29,14,10,22,89,141
350,Malik Rose,PF,29,SAS,67,13,1256,173,404,0,3,173,401,183,225,110,210,320,69,36,24,112,164,529
351,Michael Ruffin,PF,27,UTA,41,23,733,38,117,0,0,38,117,16,38,78,129,207,41,22,21,42,103,92
352,Kareem Rush,SG,23,LAL,72,15,1244,190,432,48,138,142,294,31,52,20,77,97,59,33,20,48,109,459
353,Bryon Russell,SF,33,LAL,72,1,945,98,244,43,112,55,132,50,65,32,114,146,71,32,12,37,110,289
354,John Salmons,SG,24,PHI,77,24,1603,161,416,50,147,111,269,71,92,38,158,196,134,62,16,77,122,443
355,Jamal Sampson,C,20,LAL,10,2,130,11,23,0,0,11,23,7,12,23,29,52,7,2,4,6,16,29
356,Daniel Santiago,C,27,MIL,54,28,708,78,163,0,0,78,163,61,90,35,97,132,24,19,21,32,98,217
357,Brian Scalabrine,PF,25,NJN,69,2,928,86,218,10,41,76,177,58,70,42,131,173,65,21,14,42,113,240
358,Ansu Sesay,SF,27,SEA,57,2,583,81,178,6,21,75,157,32,46,43,49,92,19,19,20,23,66,200
359,Paul Shirley,PF,26,CHI,7,0,86,10,23,0,1,10,22,1,3,8,8,16,4,1,1,9,9,21
360,Bobby Simmons,SF,23,LAC,56,8,1376,147,373,2,12,145,361,141,169,115,147,262,96,51,17,73,169,437
361,Brian Skinner,C,27,MIL,56,54,1577,255,513,0,0,255,513,79,138,119,292,411,49,30,61,78,165,589
362,Tamar Slay,SG,23,NJN,22,0,165,21,60,4,12,17,48,7,14,10,15,25,14,7,1,11,20,53
363,Jabari Smith,C,26,SAC,31,0,168,26,70,0,3,26,67,12,20,11,20,31,11,2,6,7,25,64
364,Joe Smith,PF,28,MIL,76,76,2254,311,708,1,5,310,703,207,241,230,413,643,78,47,94,82,209,830
365,Leon Smith,C,23,SEA,1,0,4,1,2,0,0,1,2,0,0,1,1,2,0,0,0,0,1,2
366,Steve Smith,SG,34,NOH,71,4,929,119,293,43,107,76,186,77,83,27,54,81,56,15,6,42,91,358
367,Theron Smith,SF,23,MEM,20,0,178,16,43,6,12,10,31,6,8,13,28,41,7,5,5,14,18,44
368,Eric Snow,PG,30,PHI,82,82,2966,295,715,2,18,293,697,252,316,62,219,281,563,97,6,187,213,844
369,Darius Songaila,PF,25,SAC,73,7,976,133,273,0,0,133,273,71,88,91,134,225,48,42,12,43,126,337
370,Latrell Sprewell,SF,33,MIN,82,82,3100,518,1266,99,299,419,967,240,295,56,254,310,286,88,21,158,101,1375
371,Jerry Stackhouse,SF,29,WAS,26,17,774,128,321,23,65,105,256,83,103,16,78,94,103,24,3,88,49,362
372,Vladimir Stepania,C,27,POR,42,2,453,43,103,0,0,43,103,22,36,50,75,125,23,11,15,19,61,108
375,Peja Stojaković,SF,26,SAC,81,81,3264,665,1386,240,554,425,832,394,425,91,417,508,173,108,14,153,159,1964
376,Damon Stoudamire,PG,30,POR,82,82,3118,408,1018,156,427,252,591,127,145,52,256,308,500,99,9,180,173,1099
377,Amar'e Stoudemire,PF,21,PHO,55,53,2025,411,865,1,5,410,860,310,435,157,339,496,78,64,89,177,188,1133
378,Erick Strickland,PG,30,MIL,43,0,571,79,196,29,66,50,130,44,51,13,58,71,90,26,2,54,63,231
379,Rod Strickland,PG,37,TOT,61,10,1197,150,353,10,36,140,317,72,98,34,121,155,244,35,11,85,76,382
380,Bruno Šundov,C,23,TOT,5,0,33,4,10,0,0,4,10,3,6,2,8,10,1,0,0,3,9,11
381,Bob Sura,SG,30,TOT,80,18,1663,202,485,21,79,181,406,171,226,100,226,326,233,62,14,105,158,596
382,Mike Sweetney,PF,21,NYK,42,1,494,69,140,0,1,69,139,42,58,68,89,157,14,18,12,32,57,180
383,Stromile Swift,PF,24,MEM,77,10,1528,268,571,1,4,267,567,190,262,141,237,378,38,56,118,88,188,727
384,Wally Szczerbiak,SF,26,MIN,28,0,622,106,236,20,46,86,190,53,64,24,64,88,33,12,1,28,42,285
385,Maurice Taylor,PF,27,HOU,75,10,2081,367,765,0,2,367,763,128,174,131,253,384,107,43,47,149,253,862
386,Jason Terry,PG,26,ATL,81,78,3018,499,1196,146,421,353,775,215,260,49,287,336,437,124,16,229,192,1359
387,Etan Thomas,C,25,WAS,79,15,1901,257,526,0,0,257,526,191,295,183,345,528,68,36,123,113,219,705
388,Kenny Thomas,PF,26,PHI,74,72,2699,381,813,1,5,380,808,243,323,261,489,750,111,82,33,172,219,1006
389,Kurt Thomas,PF,31,NYK,80,75,2548,392,829,0,3,392,826,106,127,145,517,662,149,56,80,132,298,890
390,Tim Thomas,SF,26,TOT,66,65,2089,363,813,73,194,290,619,171,218,64,256,320,124,64,20,116,196,970
391,Jamaal Tinsley,PG,25,IND,52,43,1378,153,370,77,207,76,163,49,67,28,108,136,303,84,17,110,132,432
392,Robert Traylor,C,26,NOH,71,0,942,145,287,2,5,143,282,70,128,106,156,262,43,39,37,62,161,362
393,Gary Trent,C,29,MIN,68,2,1025,155,328,0,6,155,322,69,91,83,133,216,49,12,17,54,129,379
394,Jeff Trepagnier,SG,24,DEN,11,0,96,10,38,2,4,8,34,3,6,6,9,15,4,3,0,6,7,25
395,Cezary Trybański,C,24,TOT,7,0,15,0,4,0,0,0,4,1,2,0,1,1,0,1,1,2,3,1
396,Jake Tsakalidis,C,24,MEM,40,28,533,67,133,0,0,67,133,36,61,37,91,128,18,9,22,23,79,170
397,Nikoloz Tskitishvili,PF,20,DEN,39,0,307,40,122,3,11,37,111,23,29,24,39,63,10,6,8,17,50,106
398,Hedo Türkoğlu,SF,24,SAS,80,44,2073,262,645,101,241,161,404,114,161,52,306,358,154,80,32,94,165,739
399,Ime Udoka,SF,26,LAL,4,0,28,3,9,0,1,3,8,2,4,1,4,5,2,2,1,3,3,8
400,Nick Van Exel,PG,32,GSW,39,29,1255,187,479,46,150,141,329,70,99,16,88,104,206,20,2,78,57,490
401,Keith Van Horn,SF,28,TOT,72,62,2340,410,903,93,233,317,670,249,290,149,352,501,120,68,33,169,215,1162
402,Jacque Vaughn,PG,28,ATL,71,6,1271,107,277,3,20,104,257,53,68,12,104,116,195,44,2,84,126,270
403,Jake Voskuhl,C,26,PHO,66,43,1606,152,300,0,0,152,300,134,181,123,220,343,57,42,25,77,258,438
404,Slavko Vraneš,C,21,POR,1,0,3,0,1,0,0,0,1,0,0,0,0,0,0,0,0,0,1,0
405,Dwyane Wade,PG,22,MIA,61,56,2126,371,798,16,53,355,745,233,312,85,162,247,275,86,34,196,140,991
406,Dajuan Wagner,SG,20,CLE,44,4,708,112,306,31,86,81,220,32,47,9,49,58,51,26,7,41,89,287
407,Antoine Walker,PF,27,DAL,82,82,2840,483,1129,82,305,401,824,103,186,198,486,684,369,65,65,202,212,1151
408,Samaki Walker,PF,27,MIA,33,0,418,38,99,0,2,38,97,29,44,42,70,112,6,9,11,15,54,105
409,Ben Wallace,C,29,DET,81,81,3050,315,748,1,8,314,740,142,290,324,682,1006,138,143,246,123,162,773
410,Gerald Wallace,SF,21,SAC,37,1,337,32,89,0,2,32,87,11,24,35,39,74,19,14,14,8,37,75
411,John Wallace,SF,29,MIA,37,0,368,61,145,5,13,56,132,31,40,12,47,59,14,5,8,24,38,158
412,Rasheed Wallace,PF,29,TOT,68,66,2390,425,974,82,248,343,726,156,212,102,357,459,156,61,122,119,190,1088
413,Luke Walton,PF,23,LAL,72,2,730,65,153,13,39,52,114,31,44,39,88,127,113,28,8,44,70,174
414,Charlie Ward,PG,33,TOT,71,10,1252,160,390,84,206,76,184,20,27,12,132,144,215,64,11,96,107,424
415,Earl Watson,PG,24,MEM,81,14,1669,172,464,26,106,146,358,90,138,49,129,178,402,91,19,146,175,460
416,Clarence Weatherspoon,PF,33,TOT,52,1,868,104,211,0,1,104,210,53,72,74,130,204,30,30,15,35,75,261
417,Chris Webber,PF,30,SAC,23,23,831,174,421,1,5,173,416,81,114,48,152,200,105,31,20,60,76,430
418,Bonzi Wells,SG,27,TOT,72,27,1872,363,850,22,69,341,781,138,183,78,182,260,139,91,19,161,197,886
419,Jiří Welsch,SG,24,BOS,81,68,2179,262,612,69,181,193,431,153,206,60,236,296,183,101,7,129,176,746
420,David Wesley,SG,33,NOH,61,60,2001,311,800,92,285,219,515,137,182,28,106,134,175,71,14,100,147,851
421,David West,PF,23,NOH,71,1,930,108,228,0,2,108,226,57,80,117,180,297,60,27,28,48,117,273
422,Jahidi White,C,27,TOT,62,17,865,99,190,0,0,99,190,63,126,97,164,261,7,25,51,66,176,261
423,Rodney White,SF,23,DEN,72,0,985,215,468,33,87,182,381,78,104,44,121,165,60,32,20,78,105,541
424,Chris Whitney,PG,32,WAS,16,5,186,17,45,8,18,9,27,5,5,3,12,15,14,6,2,6,6,47
425,Chris Wilcox,C,21,LAC,65,17,1340,227,436,0,1,227,435,105,150,125,180,305,51,29,20,80,183,559
426,Mike Wilks,PG,24,HOU,26,0,145,17,36,6,10,11,26,10,12,3,13,16,17,3,0,7,15,50
427,Aaron Williams,C,32,NJN,72,7,1337,172,342,1,3,171,339,105,155,101,193,294,81,34,46,89,187,450
428,Alvin Williams,SG,29,TOR,56,54,1730,201,496,26,89,175,407,66,85,18,132,150,224,55,10,78,114,494
429,Eric Williams,SF,31,TOT,71,36,1886,231,598,35,127,196,471,215,283,65,221,286,120,70,9,88,180,712
430,Frank Williams,PG,23,NYK,56,3,714,80,208,18,60,62,148,41,48,8,45,53,121,25,6,63,58,219
431,Jason Williams,PG,28,MEM,72,68,2115,290,713,120,364,170,349,82,98,25,122,147,492,92,5,136,97,782
432,Jerome Williams,PF,30,TOT,68,44,1637,158,336,0,8,158,328,106,155,177,298,475,72,90,8,74,134,422
433,Mo Williams,SG,21,UTA,57,0,772,115,303,10,39,105,264,44,56,23,49,72,76,28,2,51,87,284
434,Scott Williams,C,35,TOT,43,21,527,90,186,2,3,88,183,16,27,38,94,132,17,20,16,16,95,198
436,Corliss Williamson,PF,30,DET,79,0,1574,304,602,0,0,304,602,144,197,88,168,256,57,30,20,113,204,752
437,Kevin Willis,C,41,SAS,48,0,373,70,150,0,1,70,149,24,39,37,61,98,11,21,9,32,61,164
438,Loren Woods,C,25,MIA,38,2,506,44,96,0,0,44,96,33,55,65,69,134,10,11,19,26,52,121
439,Qyntel Woods,SF,22,POR,62,8,673,88,237,10,29,78,208,38,60,46,90,136,46,20,14,52,88,224
440,Metta World Peace,SF,24,IND,73,71,2714,468,1112,75,242,393,870,322,439,100,285,385,272,152,50,202,194,1333
441,Lorenzen Wright,C,28,MEM,65,46,1674,257,586,0,5,257,581,96,131,144,301,445,71,45,58,77,192,610
442,Wang Zhizhi,C,26,TOT,16,0,114,17,46,4,14,13,32,9,10,4,14,18,2,3,5,6,13,47
1,Shareef Abdur-Rahim,PF,28,POR,54,49,1867,337,670,15,39,322,631,220,254,123,269,392,111,49,26,117,150,909
2,Cory Alexander,SG,31,CHA,16,1,201,16,49,8,19,8,30,9,12,8,21,29,37,9,1,19,29,49
3,Malik Allen,PF,26,TOT,36,1,519,84,177,0,0,84,177,26,28,40,59,99,18,9,22,18,53,194
4,Ray Allen*,SG,29,SEA,78,78,3064,640,1494,209,556,431,938,378,428,79,268,347,289,84,5,171,167,1867
5,Tony Allen,SG,23,BOS,77,34,1262,184,387,12,31,172,356,112,152,85,136,221,64,76,24,77,156,492
6,Rafer Alston,PG,28,TOR,80,78,2717,403,974,139,389,264,585,191,258,42,237,279,514,118,7,170,212,1136
7,Chris Andersen,C,26,NOH,67,2,1430,191,358,0,3,191,355,131,190,137,273,410,71,14,100,64,144,513
8,Derek Anderson,SG,30,POR,47,32,1239,152,391,58,151,94,240,70,87,25,103,128,143,36,4,70,89,432
9,Kenny Anderson,PG,34,TOT,43,20,743,85,201,6,13,79,188,27,37,24,64,88,103,33,0,49,87,203
11,Carmelo Anthony,SF,20,DEN,75,75,2608,530,1230,42,158,488,1072,456,573,141,285,426,194,68,30,224,229,1558
12,Rafael Araújo,C,24,TOR,59,41,736,76,175,1,3,75,172,43,55,59,126,185,16,21,8,52,157,196
13,Gilbert Arenas,PG,23,WAS,80,80,3274,656,1523,205,562,451,961,521,640,83,295,378,411,139,23,242,245,2038
14,Trevor Ariza,SF,19,NYK,80,12,1382,172,389,3,13,169,376,121,174,89,153,242,85,70,18,73,150,468
15,Darrell Armstrong,PG,36,TOT,66,16,988,89,277,28,111,61,166,58,68,35,80,115,178,45,8,67,92,264
16,Carlos Arroyo,PG,25,TOT,70,16,1448,167,429,8,30,159,399,119,149,26,78,104,280,44,4,107,143,461
17,Chucky Atkins,PG,30,LAL,82,82,2903,388,910,176,455,212,455,163,203,31,166,197,358,73,2,151,181,1115
18,Stacey Augmon,SF,36,ORL,55,7,663,68,167,0,0,68,167,57,77,45,54,99,36,23,8,31,83,193
19,Maurice Baker,PG,25,TOT,5,0,19,0,1,0,0,0,1,0,0,1,1,2,1,1,0,1,3,0
21,Marcus Banks,PG,23,BOS,81,2,1145,115,286,21,59,94,227,121,163,29,97,126,155,63,13,79,146,372
22,Leandro Barbosa,PG,22,PHO,63,6,1087,168,354,51,139,117,215,55,69,32,98,130,126,30,7,87,127,442
23,Matt Barnes,SF,24,SAC,43,9,715,62,151,5,22,57,129,35,58,49,84,133,57,30,7,45,80,164
24,Andre Barrett,PG,22,TOT,38,1,483,45,124,14,52,31,72,14,19,11,29,40,69,19,1,27,51,118
25,Brent Barry,SG,33,SAS,81,8,1742,194,459,100,280,94,179,113,135,29,161,190,178,39,20,64,123,601
26,Jon Barry,SG,35,TOT,69,2,1505,161,368,71,165,90,203,62,71,26,133,159,167,60,9,67,95,455
27,Tony Battie,C,28,ORL,81,32,1894,163,354,0,6,163,348,68,94,109,343,452,42,30,81,81,244,394
28,Shane Battier,SG,26,MEM,80,72,2516,271,613,70,177,201,436,180,228,158,255,413,126,91,77,75,201,792
29,Lonny Baxter,PF,26,NOH,4,0,36,3,11,0,0,3,11,0,2,4,4,8,0,0,0,4,10,6
30,Raja Bell,SG,28,UTA,63,32,1790,303,667,54,134,249,533,112,150,48,153,201,91,44,8,79,205,772
31,Jonathan Bender,SF,24,IND,7,0,93,16,40,1,5,15,35,3,6,5,9,14,4,1,2,10,9,36
32,Travis Best,PG,32,NJN,76,6,1461,190,452,26,85,164,367,108,122,19,88,107,143,66,9,67,148,514
33,Mike Bibby,PG,26,SAC,80,80,3084,560,1264,131,364,429,900,320,413,77,255,332,541,124,30,203,191,1571
34,Andris Biedriņš,C,18,GSW,30,1,384,45,78,0,1,45,77,19,40,47,71,118,12,12,24,12,87,109
35,Chauncey Billups,PG,28,DET,80,80,2866,404,913,165,387,239,526,343,382,48,223,271,464,81,9,180,194,1316
36,Steve Blake,PG,24,WAS,44,1,648,61,186,36,93,25,93,33,41,18,53,71,69,13,0,39,47,191
37,Mark Blount,C,29,BOS,82,57,2130,327,618,0,1,327,617,117,164,143,254,397,129,33,64,158,229,771
38,Tony Bobbitt,SG,25,LAL,2,0,12,2,5,1,2,1,3,0,0,0,3,3,0,0,0,0,1,5
39,Keith Bogans,SG,24,CHA,74,42,1791,262,688,57,173,205,515,133,183,76,150,226,135,68,8,122,167,714
40,Matt Bonner,C,24,TOR,82,0,1553,247,463,39,92,208,371,56,71,108,177,285,48,39,19,40,220,589
41,Calvin Booth,C,28,TOT,51,1,451,49,108,0,1,49,107,26,32,29,78,107,8,15,28,16,78,124
42,Carlos Boozer,PF,23,UTA,51,51,1772,361,693,0,1,361,692,187,268,141,316,457,144,41,24,137,179,909
43,Curtis Borchardt,C,24,UTA,67,23,859,74,172,0,0,74,172,52,71,86,138,224,49,10,32,52,160,200
44,Chris Bosh,PF,20,TOR,81,81,3017,473,1005,3,10,470,995,412,542,194,524,718,153,76,113,187,226,1361
45,Bruce Bowen,SF,33,SAS,82,82,2627,251,598,102,253,149,345,71,112,50,235,285,126,55,39,57,175,675
46,Ryan Bowen,SF,29,HOU,66,6,604,47,111,3,6,44,105,14,21,21,55,76,18,23,5,7,61,111
47,Earl Boykins,PG,28,DEN,82,5,2162,340,824,56,166,284,658,279,303,37,106,143,372,78,12,121,122,1015
48,Michael Bradley,PF,25,TOT,18,0,119,15,24,0,1,15,23,3,8,8,20,28,5,1,2,5,12,33
49,Shawn Bradley,C,32,DAL,77,14,885,84,186,0,0,84,186,43,63,70,144,214,15,25,63,33,153,211
50,Torraye Braggs,PF,28,HOU,7,0,24,3,7,0,0,3,7,0,0,7,5,12,0,0,0,2,4,6
51,Elton Brand,PF,25,LAC,81,81,3001,629,1251,0,3,629,1248,364,484,296,474,770,208,62,169,183,240,1622
52,Jamison Brewer,PG,24,NYK,18,0,185,11,37,3,15,8,22,6,13,6,16,22,12,8,1,13,11,31
53,Primož Brezec,C,25,CHA,72,72,2276,387,756,0,0,387,756,164,220,226,305,531,86,33,55,106,183,938
54,Damone Brown,SF,25,WAS,14,0,152,23,62,4,11,19,51,4,9,10,18,28,14,1,6,15,17,54
55,Devin Brown,SG,26,SAS,67,0,1238,173,409,45,121,128,288,103,130,37,139,176,92,39,12,53,83,494
56,Kedrick Brown,SF,23,PHI,8,0,55,2,6,0,3,2,3,8,10,1,10,11,4,3,1,5,4,12
57,Kwame Brown,PF,22,WAS,42,14,908,109,237,0,0,109,237,74,129,72,134,206,39,25,15,67,112,292
58,P.J. Brown,PF,35,NOH,82,78,2817,338,758,0,0,338,758,210,243,266,471,737,178,74,50,101,233,886
59,Tierre Brown,PG,25,LAL,76,0,1066,124,348,26,72,98,276,59,75,21,72,93,155,32,1,74,59,333
60,Rick Brunson,PG,32,LAC,80,39,1945,166,442,48,130,118,312,57,74,23,164,187,410,82,7,125,106,437
61,Kobe Bryant,SG,26,LAL,66,66,2689,573,1324,131,387,442,937,542,664,95,297,392,398,86,53,270,174,1819
62,Greg Buckner,SG,28,DEN,70,41,1522,160,303,49,121,111,182,63,81,66,142,208,133,75,6,49,169,432
63,Rodney Buford,SF,27,NJN,64,17,1313,187,489,34,108,153,381,37,45,33,156,189,63,40,4,35,101,445
64,Antonio Burks,PG,24,MEM,24,0,219,28,60,3,11,25,49,14,19,1,11,12,28,13,1,12,25,73
65,Caron Butler,SF,24,LAL,77,77,2746,441,991,38,125,403,866,275,319,146,304,450,146,110,23,125,213,1195
66,Jackie Butler,C,19,NYK,3,0,5,4,4,0,0,4,4,2,2,0,0,0,0,1,0,1,0,10
67,Rasual Butler,SF,25,MIA,65,15,1203,163,409,57,153,106,256,37,48,15,136,151,62,18,29,37,104,420
68,Žarko Čabarkapa,PF,23,TOT,40,0,475,86,177,13,36,73,141,53,65,35,67,102,25,10,5,30,59,238
69,Marcus Camby,C,30,DEN,66,66,2015,279,600,0,4,279,596,125,173,131,530,661,152,61,199,103,177,683
70,Elden Campbell,C,36,TOT,40,1,390,39,123,0,2,39,121,42,55,28,65,93,19,8,7,29,57,120
71,Brian Cardinal,PF,27,MEM,58,16,1433,160,432,44,125,116,307,158,181,63,162,225,114,88,19,83,172,522
72,Geno Carlisle,SG,28,POR,6,0,16,2,3,0,0,2,3,4,6,1,0,1,1,0,0,1,1,8
73,Matt Carroll,SG,24,CHA,25,0,430,70,180,13,39,57,141,71,83,13,47,60,17,17,2,25,37,224
74,Anthony Carter,PG,29,MIN,66,12,742,72,177,2,17,70,160,35,51,12,57,69,161,35,18,62,88,181
76,Sam Cassell,PG,35,MIN,59,38,1522,319,687,27,103,292,584,134,155,25,132,157,301,36,14,109,160,799
77,Kelvin Cato,C,30,ORL,62,50,1525,160,297,0,0,160,297,112,143,102,314,416,40,55,82,64,170,432
78,Lionel Chalmers,PG,24,LAC,36,0,433,42,125,12,49,30,76,15,24,4,27,31,51,13,0,24,30,111
79,Tyson Chandler,C,22,CHI,80,10,2189,207,419,0,2,207,417,226,336,261,514,775,65,69,141,118,268,640
80,Calbert Cheaney,SG,33,GSW,55,5,951,113,265,0,3,113,262,24,37,32,92,124,64,17,15,35,95,250
81,Josh Childress,SG,21,ATL,80,44,2376,302,642,13,56,289,586,190,231,195,287,482,151,74,35,106,184,807
82,Doug Christie,SG,34,TOT,52,44,1525,130,332,15,62,115,270,70,78,38,139,177,199,80,18,104,106,345
83,Speedy Claxton,PG,26,TOT,62,47,1866,257,611,11,61,246,550,187,254,37,147,184,374,109,8,119,184,712
84,Mateen Cleaves,PG,27,SEA,14,0,65,5,14,0,2,5,12,3,4,2,4,6,7,2,0,2,2,13
85,Derrick Coleman,C,37,DET,5,0,50,3,14,0,2,3,12,3,3,3,12,15,0,0,0,2,6,9
86,Jason Collier,C,27,ATL,70,44,942,174,376,6,14,168,362,48,71,84,100,184,18,15,13,63,147,402
87,Jarron Collins,C,26,UTA,50,38,961,65,157,0,1,65,156,83,119,57,107,164,61,11,6,34,146,213
88,Jason Collins,C,26,NJN,80,80,2542,186,451,2,6,184,445,137,209,153,335,488,105,71,71,91,322,511
89,Nick Collison,C,24,SEA,82,4,1396,190,354,0,3,190,351,83,118,156,220,376,32,34,50,62,252,463
90,Brian Cook,C,24,LAL,72,0,1087,176,422,78,199,98,223,28,37,63,153,216,35,23,26,29,139,458
91,Omar Cook,PG,23,TOR,5,0,74,10,24,0,4,10,20,3,6,2,5,7,22,6,1,6,6,23
92,Jamal Crawford,SG,24,NYK,70,67,2688,437,1097,185,512,252,585,182,216,33,170,203,302,92,19,148,135,1241
93,Austin Croshere,PF,29,IND,73,22,1827,188,497,45,174,143,323,226,256,103,272,375,98,48,17,104,154,647
94,Eddy Curry,C,22,CHI,63,60,1808,393,730,0,0,393,730,226,314,116,222,338,37,21,58,163,202,1012
95,Michael Curry,SF,36,IND,18,7,249,13,29,0,0,13,29,4,8,8,19,27,15,5,4,5,39,30
96,Samuel Dalembert,C,23,PHI,72,60,1785,250,477,0,0,250,477,89,148,187,355,542,35,46,121,114,241,589
97,Erick Dampier,C,29,DAL,59,56,1609,202,367,0,3,202,364,138,228,183,318,501,51,15,80,102,205,542
98,Antonio Daniels,PG,29,SEA,75,2,2026,273,623,49,165,224,458,248,304,20,149,169,309,51,3,78,78,843
99,Erik Daniels,SF,22,SAC,21,0,72,6,18,1,2,5,16,0,0,7,11,18,4,2,0,6,7,13
100,Marquis Daniels,SG,24,DAL,60,17,1412,220,504,7,35,213,469,98,133,87,129,216,128,83,14,86,124,545
101,Antonio Davis,PF,36,CHI,72,62,1843,193,419,0,0,193,419,115,152,152,276,428,80,27,41,96,147,501
102,Baron Davis,PG,25,TOT,46,32,1581,291,752,118,354,173,398,185,243,32,143,175,362,81,14,131,126,885
103,Dale Davis,C,35,TOT,61,28,1307,112,234,0,0,112,234,60,99,152,223,375,47,32,65,43,162,284
104,Josh Davis,PF,24,PHI,42,5,328,42,111,19,53,23,58,14,17,29,50,79,12,8,4,15,45,117
105,Ricky Davis,SG,25,BOS,82,11,2696,481,1041,61,180,420,861,286,351,66,183,249,246,89,27,205,174,1309
106,Andrew DeClercq,C,31,ORL,8,0,49,4,9,0,0,4,9,1,3,7,3,10,0,2,0,1,14,9
107,Carlos Delfino,SG,22,DET,30,4,459,42,117,9,35,33,82,23,40,13,42,55,38,22,6,23,44,116
108,Tony Delk,SG,31,ATL,56,1,1340,246,591,72,202,174,389,103,136,28,102,130,104,47,3,54,123,667
109,Luol Deng,SF,19,CHI,61,45,1663,280,645,31,117,249,528,120,162,92,230,322,135,48,27,118,98,711
110,Boris Diaw,SG,22,ATL,66,25,1201,124,294,9,50,115,244,57,77,54,116,170,149,37,18,87,123,314
111,Dan Dickau,PG,26,TOT,71,46,2090,306,756,85,245,221,511,190,228,34,146,180,347,76,4,145,201,887
112,Kaniel Dickens,SF,26,NJN,11,0,61,4,14,3,9,1,5,2,2,3,6,9,1,2,1,2,5,13
113,DeSagana Diop,C,23,CLE,39,0,306,20,69,0,2,20,67,0,5,30,40,70,15,8,27,12,53,40
114,Vlade Divac*,C,36,LAL,15,0,130,13,31,0,0,13,31,8,12,18,14,32,19,4,1,14,25,34
115,Juan Dixon,SG,26,WAS,63,4,1054,186,447,48,147,138,300,87,97,32,87,119,111,43,4,68,98,507
116,Michael Doleac,C,27,MIA,80,8,1175,148,331,0,2,148,329,25,41,74,185,259,47,23,22,36,160,321
117,Keyon Dooling,PG,24,MIA,74,0,1184,139,345,19,75,120,270,85,109,11,79,90,132,39,11,65,120,382
118,Predrag Drobnjak,C,29,ATL,71,1,1435,238,543,25,71,213,472,96,120,73,165,238,49,42,24,78,138,597
119,Chris Duhon,PG,22,CHI,82,73,2177,172,488,94,265,78,223,49,67,23,190,213,398,82,3,119,205,487
120,Tim Duncan,PF,28,SAS,66,66,2203,517,1042,3,9,514,1033,305,455,202,530,732,179,45,174,127,144,1342
121,Mike Dunleavy,SF,24,GSW,79,79,2570,408,905,107,276,301,629,134,172,97,338,435,203,79,26,132,198,1057
122,Ronald Dupree,SF,24,DET,47,0,472,61,127,1,2,60,125,29,47,34,61,95,24,7,10,22,60,152
123,Ndudi Ebi,SG,20,MIN,2,0,54,11,21,0,1,11,20,5,9,6,10,16,1,1,1,3,7,27
124,Corsley Edwards,C,25,NOH,10,0,110,10,31,0,0,10,31,7,12,12,13,25,3,3,4,2,19,27
125,John Edwards,C,23,IND,25,1,139,11,30,0,0,11,30,7,14,8,11,19,3,3,4,8,12,29
126,Howard Eisley,PG,32,UTA,74,1,1428,161,405,27,103,134,302,66,83,15,75,90,250,45,9,111,156,415
127,Obinna Ekezie,C,29,ATL,42,31,732,79,182,0,1,79,181,72,93,69,110,179,11,22,12,45,129,230
128,Francisco Elson,C,28,DEN,67,11,939,101,216,1,3,100,213,45,79,61,140,201,34,34,41,40,129,248
129,Melvin Ely,PF,26,CHA,79,17,1649,227,526,0,0,227,526,122,212,142,184,326,76,32,69,115,199,576
130,Andre Emmett,SG,22,MEM,8,0,28,2,6,0,0,2,6,3,5,0,2,2,0,0,0,1,4,7
131,Maurice Evans,SG,26,SAC,65,11,1233,165,373,27,82,138,291,59,78,88,113,201,45,37,8,34,104,416
132,Reggie Evans,PF,24,SEA,79,79,1881,131,275,0,2,131,273,125,234,254,482,736,58,58,15,104,202,387
133,Michael Finley,SG,31,DAL,64,64,2358,387,907,116,285,271,622,113,136,45,217,262,169,48,18,60,123,1003
134,Derek Fisher,PG,30,GSW,74,32,2222,297,755,108,291,189,464,175,203,38,180,218,301,76,4,129,176,877
135,Marcus Fizer,PF,26,MIL,54,0,903,133,292,0,6,133,286,70,103,29,146,175,64,25,13,63,96,336
136,Luis Flores,PG,23,TOT,16,0,77,14,29,5,10,9,19,2,2,1,2,3,11,2,0,11,9,35
137,Danny Fortson,C,28,SEA,62,0,1047,118,226,0,0,118,226,227,258,157,191,348,8,15,7,91,265,463
138,Jeff Foster,C,28,IND,61,43,1594,168,324,0,5,168,319,90,142,205,345,550,43,46,12,55,186,426
139,Tremaine Fowlkes,SF,28,IND,8,0,56,9,17,1,3,8,14,0,2,3,5,8,0,2,0,5,7,19
140,Adonal Foyle,C,29,GSW,78,50,1700,156,311,0,0,156,311,40,72,165,264,429,56,26,159,58,201,352
141,Richie Frahm,SG,27,POR,43,0,499,56,140,31,80,25,60,21,25,17,44,61,30,15,4,14,35,164
142,Steve Francis,PG,27,ORL,78,78,2978,563,1330,38,127,525,1203,499,606,126,324,450,547,112,28,317,273,1663
143,Matt Freije,PF,23,NOH,23,11,441,37,127,14,54,23,73,5,8,16,45,61,20,13,2,17,40,93
144,Lawrence Funderburke,PF,34,CHI,2,0,21,3,6,0,0,3,6,3,5,1,2,3,0,0,0,0,2,9
145,Dan Gadzuric,C,26,MIL,81,81,1783,243,451,0,0,243,451,107,199,261,413,674,30,47,106,81,224,593
146,Reece Gaines,PG,24,TOT,21,0,187,17,50,4,14,13,36,3,4,1,13,14,7,5,1,7,17,41
147,Alex Garcia,SG,24,NOH,8,3,146,18,52,5,18,13,34,3,4,7,8,15,18,4,1,8,15,44
148,Kevin Garnett,PF,28,MIN,82,82,3121,683,1360,6,25,677,1335,445,549,247,861,1108,466,121,112,222,207,1817
149,Pat Garrity,PF,28,ORL,71,0,955,123,306,49,147,74,159,29,33,21,103,124,30,19,9,30,107,324
150,Pau Gasol,PF,24,MEM,56,53,1790,357,695,1,6,356,689,282,367,130,280,410,135,37,93,137,146,997
151,Devean George,SF,27,LAL,15,3,306,37,104,21,58,16,46,15,20,13,40,53,14,8,2,12,32,110
152,Eddie Gill,PG,26,IND,73,3,1021,81,242,36,117,45,125,71,81,16,96,112,83,59,5,60,105,269
153,Kendall Gill,SG,36,MIL,14,0,284,32,80,3,9,29,71,18,20,11,26,37,27,14,4,9,37,85
154,Manu Ginóbili,SG,27,SAS,74,74,2193,367,780,97,258,270,522,355,442,75,254,329,288,119,27,172,190,1186
155,Gordan Giriček,SG,27,UTA,81,44,1660,283,632,38,105,245,527,111,137,25,157,182,137,46,11,90,155,715
156,Dion Glover,SG,26,SAS,7,0,68,8,22,1,8,7,14,8,10,3,8,11,4,3,3,2,9,25
157,Anthony Goldwire,PG,33,TOT,33,2,537,57,136,32,80,25,56,26,31,10,49,59,78,15,0,15,32,172
158,Drew Gooden,PF,23,CLE,82,80,2523,464,943,5,28,459,915,251,310,207,546,753,130,77,76,133,233,1184
159,Ben Gordon,SG,21,CHI,82,3,2002,434,1056,134,331,300,725,233,270,55,160,215,164,53,10,186,224,1235
160,Brian Grant,C,32,LAL,69,8,1136,103,209,0,0,103,209,57,79,101,156,257,34,23,23,43,175,263
161,Willie Green,SG,23,PHI,57,21,1066,155,423,30,105,125,318,97,125,22,111,133,100,34,6,75,121,437
162,Adrian Griffin,SF,30,CHI,69,1,667,58,161,2,9,56,152,33,44,52,94,146,53,43,4,30,78,151
163,Eddie Griffin,PF,22,MIN,70,0,1492,202,522,67,204,135,318,56,78,128,325,453,53,23,118,55,120,527
164,Tom Gugliotta,PF,35,TOT,47,9,966,99,241,8,26,91,215,33,43,56,135,191,68,41,17,57,104,239
165,Marcus Haislip,PF,24,IND,9,0,106,13,38,0,1,13,37,6,11,5,10,15,3,2,2,6,15,32
166,Darvin Ham,SF,31,DET,47,0,275,17,37,0,0,17,37,12,31,19,16,35,5,6,7,8,39,46
167,Richard Hamilton,SG,26,DET,76,76,2926,510,1160,36,118,474,1042,368,429,74,221,295,372,77,13,217,232,1424
168,Zendon Hamilton,C,29,MIL,16,0,159,11,32,0,0,11,32,29,48,18,24,42,6,5,2,12,26,51
169,Ben Handlogten,C,31,UTA,21,5,297,43,83,0,1,43,82,9,17,23,42,65,13,7,5,18,55,95
170,Anfernee Hardaway,SF,33,NYK,37,0,894,110,260,15,50,95,210,34,46,19,70,89,74,28,3,50,79,269
171,Matt Harpring,SF,28,UTA,78,55,2584,418,855,9,43,409,812,245,315,196,284,480,142,70,16,133,250,1090
172,Al Harrington,SF,24,ATL,66,66,2550,453,986,16,74,437,912,236,351,145,316,461,208,85,16,204,249,1158
173,Junior Harrington,SG,24,NOH,29,7,550,64,178,6,19,58,159,29,35,13,50,63,62,25,5,41,72,163
174,Othella Harrington,PF,31,CHI,70,28,1271,217,424,0,0,217,424,127,177,106,186,292,56,24,18,84,188,561
175,Devin Harris,PG,21,DAL,76,19,1173,157,366,44,131,113,235,78,103,28,74,102,169,77,19,82,139,436
176,Lucious Harris,SG,34,CLE,73,4,1128,118,299,21,65,97,234,56,69,39,82,121,49,27,6,29,68,313
177,David Harrison,C,22,IND,43,14,760,106,184,0,0,106,184,52,91,48,87,135,13,16,55,53,134,264
178,Jason Hart,PG,26,CHA,74,27,1887,257,573,35,95,222,478,157,200,18,185,203,367,99,14,102,167,706
179,Donnell Harvey,PF,24,NJN,3,0,16,2,2,0,0,2,2,4,4,2,5,7,1,1,1,1,2,8
180,Udonis Haslem,PF,24,MIA,80,80,2675,346,641,0,4,346,637,178,225,239,487,726,108,63,41,113,260,870
181,Trenton Hassell,SG,25,MIN,82,51,2068,225,475,1,11,224,464,90,114,80,139,219,128,30,30,64,200,541
182,Jarvis Hayes,SF,23,WAS,54,22,1560,206,530,42,123,164,407,99,118,41,186,227,90,49,9,62,107,553
183,Brendan Haywood,C,25,WAS,68,68,1865,239,427,0,0,239,427,159,261,202,262,464,57,52,114,96,218,637
184,Alan Henderson,PF,32,DAL,78,10,1203,116,220,0,2,116,218,41,76,164,184,348,21,29,37,49,149,273
185,Nenê Hilário,C,22,DEN,55,18,1317,194,386,0,2,194,384,140,212,104,221,325,84,50,48,94,167,528
186,Grant Hill*,SF,32,ORL,67,67,2338,517,1015,3,13,514,1002,280,341,77,241,318,220,97,28,161,144,1317
187,Kirk Hinrich,PG,24,CHI,77,77,2800,445,1122,145,408,300,714,171,216,32,272,304,494,122,21,176,244,1206
188,Fred Hoiberg,SG,32,MIN,76,0,1272,139,284,70,145,69,139,89,102,32,149,181,85,50,15,20,105,437
189,Robert Horry,PF,34,SAS,75,16,1396,157,375,51,138,106,237,86,109,91,177,268,80,67,60,69,138,451
191,Allan Houston,SG,33,NYK,20,11,532,85,205,31,80,54,125,36,43,4,19,23,42,8,2,21,40,237
192,Dwight Howard,PF,19,ORL,82,82,2670,352,677,0,2,352,675,277,413,287,536,823,75,77,136,165,232,981
193,Josh Howard,SF,24,DAL,76,76,2446,377,793,34,115,343,678,170,232,169,315,484,109,116,49,122,211,958
194,Juwan Howard,PF,31,HOU,61,47,1624,244,541,0,1,244,540,97,115,126,220,346,94,32,5,79,143,585
195,Troy Hudson,PG,28,MIN,79,32,1729,266,664,89,258,177,406,70,90,19,86,105,283,27,6,113,121,691
196,Larry Hughes,SG,26,WAS,61,61,2358,467,1086,59,209,408,877,352,453,74,308,382,285,176,18,153,168,1345
197,Ryan Humphrey,SF,25,MEM,35,0,317,42,103,0,2,42,101,18,37,50,37,87,6,10,1,23,35,102
198,Kris Humphries,PF,19,UTA,67,4,873,116,287,2,6,114,281,44,101,73,124,197,43,25,18,52,96,278
199,Brandon Hunter,PF,24,ORL,31,0,224,37,73,0,0,37,73,21,39,25,44,69,3,4,7,22,42,95
200,Lindsey Hunter,SG,34,DET,76,3,1144,108,302,23,84,85,218,46,58,38,85,123,130,68,13,68,125,285
201,Steven Hunter,C,23,PHO,76,3,1046,135,220,0,1,135,219,78,163,98,129,227,13,4,102,44,131,348
202,Andre Iguodala,SG,21,PHI,82,82,2686,269,546,47,142,222,404,156,210,89,375,464,246,138,48,139,204,741
203,Zydrunas Ilgauskas,C,29,CLE,78,78,2615,458,979,2,7,456,972,402,503,299,373,672,100,53,165,191,313,1320
204,Didier Ilunga-Mbenga,C,24,DAL,15,1,58,6,14,0,0,6,14,3,4,3,5,8,0,0,5,5,13,15
205,Allen Iverson*,PG,29,PHI,75,75,3174,771,1818,104,338,667,1480,656,786,51,248,299,596,180,9,344,140,2302
206,Royal Ivey,PG,23,ATL,62,5,809,85,198,3,9,82,189,47,67,19,65,84,103,39,7,58,140,220
207,Bobby Jackson,SG,31,SAC,25,0,536,109,255,33,96,76,159,50,58,23,62,85,59,14,2,28,58,301
208,Jermaine Jackson,SG,28,NYK,21,0,230,17,33,0,2,17,31,8,13,3,20,23,24,7,1,10,26,42
209,Jim Jackson,SF,34,TOT,64,27,1987,248,582,122,295,126,287,54,58,33,236,269,183,35,5,115,153,672
210,Luke Jackson,SF,23,CLE,10,0,43,10,27,4,6,6,21,5,6,2,4,6,3,0,0,2,4,29
211,Marc Jackson,C,30,PHI,81,23,1976,340,731,0,2,340,729,289,349,184,222,406,81,32,18,131,171,969
212,Stephen Jackson,SF,26,IND,51,49,1806,330,819,103,286,227,533,190,229,44,206,250,119,64,14,123,154,953
214,Jerome James,C,29,SEA,80,80,1330,174,342,0,2,174,340,47,65,81,160,241,19,23,111,88,279,395
215,LeBron James,SF,20,CLE,80,80,3388,795,1684,108,308,687,1376,477,636,111,477,588,577,177,52,262,146,2175
216,Mike James,PG,29,TOT,74,5,1859,331,751,100,259,231,492,109,145,35,173,208,263,65,6,106,174,871
217,Antawn Jamison,PF,28,WAS,68,68,2605,519,1189,71,208,448,981,225,296,160,359,519,154,55,16,118,151,1334
218,Marko Jarić,PG,26,LAC,50,41,1656,189,457,56,151,133,306,59,82,20,141,161,303,84,17,98,107,493
219,Al Jefferson,PF,20,BOS,71,1,1051,195,369,0,3,195,366,85,135,119,193,312,24,22,55,66,195,475
220,Richard Jefferson,SF,24,NJN,33,33,1355,238,564,30,89,208,475,227,269,49,191,240,133,33,17,132,109,733
221,Jared Jeffries,SF,23,WAS,77,71,2007,203,434,16,51,187,383,101,173,152,222,374,151,66,35,114,206,523
222,Horace Jenkins,PG,30,DET,15,0,104,15,45,0,9,15,36,12,13,3,6,9,9,5,1,7,6,42
223,Britton Johnsen,SF,25,IND,6,1,87,6,22,0,4,6,18,0,0,5,5,10,4,1,0,3,10,12
224,Anthony Johnson,PG,30,IND,63,36,1747,203,456,41,108,162,348,85,113,32,147,179,302,59,15,96,144,532
225,DerMarr Johnson,SG,24,DEN,71,40,1232,185,371,53,148,132,223,80,101,43,108,151,75,43,18,65,140,503
226,Ervin Johnson,C,37,MIN,46,23,410,28,54,1,1,27,53,16,25,43,70,113,6,7,13,18,86,73
227,Joe Johnson,SF,23,PHO,82,82,3240,544,1179,177,370,367,809,135,180,120,302,422,291,79,24,148,167,1400
228,Linton Johnson,SF,24,SAS,2,0,15,0,2,0,1,0,1,0,0,0,3,3,0,1,0,1,1,0
229,Dahntay Jones,SG,24,MEM,52,7,649,83,190,23,60,60,130,44,64,11,58,69,21,13,11,29,81,233
230,Damon Jones,PG,28,MIA,82,66,2576,331,726,225,521,106,205,68,86,14,217,231,350,44,5,98,121,955
231,Eddie Jones,SF,33,MIA,80,80,2839,351,820,142,382,209,438,174,216,38,367,405,212,86,38,99,251,1018
232,Fred Jones,SG,25,IND,77,14,2268,275,647,87,229,188,418,176,207,34,208,242,196,61,31,114,171,813
233,James Jones,SF,24,IND,75,24,1330,126,318,66,166,60,152,53,62,39,135,174,57,31,28,43,123,371
234,Jumaine Jones,SF,25,LAL,76,23,1830,210,486,102,261,108,225,55,75,107,291,398,65,44,24,49,165,577
235,Mark Jones,SF,29,ORL,10,0,116,9,31,0,4,9,27,5,10,6,7,13,6,5,2,3,16,23
236,Chris Kaman,C,22,LAC,63,50,1632,246,495,0,1,246,494,80,121,135,288,423,73,26,68,115,182,572
237,Jason Kapono,SF,23,CHA,81,14,1491,269,671,80,194,189,477,70,85,32,132,164,61,40,6,46,132,688
238,Mario Kasun,C,24,ORL,45,0,356,47,98,0,1,47,97,24,43,52,76,128,8,8,13,26,86,118
239,Viktor Khryapa,SF,22,POR,32,5,523,54,124,4,11,50,113,23,42,28,80,108,25,20,18,33,80,135
240,Jason Kidd*,PG,31,NJN,66,65,2435,340,855,129,358,211,497,142,192,94,394,488,545,123,9,167,110,951
241,Andrei Kirilenko,PF,23,UTA,41,37,1349,207,420,23,77,184,343,203,259,89,166,255,132,67,136,90,101,640
242,Kerry Kittles,SG,30,LAC,11,0,243,28,73,7,21,21,52,6,10,1,31,32,20,8,3,7,12,69
243,Brandin Knight,PG,23,HOU,1,0,3,0,1,0,0,0,1,0,0,0,0,0,1,0,0,0,0,0
244,Brevin Knight,PG,29,CHA,66,61,1944,248,587,3,20,245,567,167,196,21,149,170,591,131,5,147,192,666
245,Kyle Korver,SF,23,PHI,82,57,2667,317,759,226,558,91,201,82,96,40,339,379,182,103,33,106,265,942
246,Nenad Krstić,PF,21,NJN,75,57,1965,281,570,0,2,281,568,185,255,161,240,401,77,32,63,112,280,747
247,Toni Kukoč,SF,36,MIL,53,6,1099,105,256,42,116,63,140,44,61,31,129,160,160,39,13,64,70,296
248,Ibo Kutluay,SG,30,SEA,5,0,12,0,1,0,0,0,1,0,0,0,1,1,0,0,0,2,1,0
249,Christian Laettner,PF,35,MIA,49,0,739,107,184,1,7,106,177,45,59,36,95,131,41,32,15,29,78,260
250,Raef LaFrentz,PF,28,BOS,80,80,2196,341,688,82,225,259,463,120,148,154,399,553,98,42,99,70,262,884
251,Maciej Lampe,C,19,TOT,37,0,380,49,132,2,4,47,128,15,22,24,65,89,11,5,7,17,51,115
252,Voshon Lenard,SG,31,DEN,3,1,54,10,26,4,12,6,14,5,8,0,6,6,6,1,0,2,2,29
253,Rashard Lewis,SF,25,SEA,71,71,2697,532,1151,173,432,359,719,220,283,110,278,388,94,75,62,123,158,1457
254,Randy Livingston,PG,29,UTA,17,4,227,22,52,5,8,17,44,15,17,3,9,12,45,12,2,14,28,64
255,Shaun Livingston,PG,19,LAC,30,15,814,89,215,0,2,89,213,44,59,22,67,89,151,32,11,75,82,222
256,Raül López,PG,24,UTA,31,15,518,57,135,20,45,37,90,27,33,7,32,39,123,22,3,47,78,161
257,Tyronn Lue,PG,27,TOT,70,49,2007,295,654,55,155,240,499,142,165,14,135,149,322,33,0,105,168,787
258,George Lynch,SF,34,NOH,44,27,933,68,189,11,37,57,152,17,23,55,119,174,88,32,12,57,83,164
259,Mark Madsen,C,29,MIN,41,14,601,34,66,0,0,34,66,20,40,63,65,128,18,7,14,24,103,88
260,Corey Maggette,SG,25,LAC,66,60,2436,425,986,51,168,374,818,563,657,70,324,394,225,70,8,195,191,1464
261,Jamaal Magloire,C,26,NOH,23,22,703,98,227,0,0,98,227,74,123,79,126,205,29,8,23,59,74,270
262,Stephon Marbury,PG,27,NYK,82,82,3281,604,1308,115,325,489,983,458,549,50,198,248,668,122,6,233,186,1781
263,Shawn Marion,PF,26,PHO,81,81,3146,613,1289,114,341,499,948,229,275,235,680,915,154,163,119,125,199,1569
264,Sean Marks,PF,29,SAS,23,0,244,27,80,0,3,27,77,22,28,18,38,56,8,3,11,14,29,76
265,Donyell Marshall,PF,31,TOR,65,2,1645,262,592,151,363,111,229,72,91,95,333,428,81,57,46,42,136,747
266,Darrick Martin,PG,33,LAC,11,0,190,16,50,5,18,11,32,5,8,3,7,10,28,6,0,6,19,42
267,Kenyon Martin,PF,27,DEN,70,67,2272,444,907,0,12,444,895,199,308,146,365,511,170,100,78,149,228,1087
268,Kevin Martin,PG,21,SAC,45,0,455,45,117,5,25,40,92,36,55,29,29,58,22,16,3,24,35,131
269,Desmond Mason,SF,27,MIL,80,71,2893,478,1079,1,8,477,1071,420,524,85,227,312,217,58,27,164,198,1377
270,Tony Massenburg,PF,37,SAS,61,6,699,74,182,0,0,74,182,48,63,54,109,163,14,18,20,40,122,196
271,Walter McCarty,PF,30,TOT,72,0,906,95,235,55,155,40,80,15,29,29,109,138,37,25,15,36,144,260
272,Jelani McCoy,C,27,ATL,10,0,88,7,13,0,0,7,13,1,5,7,14,21,0,3,8,6,24,15
273,Antonio McDyess,PF,30,DET,77,8,1797,307,598,0,1,307,597,126,192,177,305,482,71,46,52,93,204,740
274,Tracy McGrady*,SF,25,HOU,78,78,3182,715,1660,142,435,573,1225,431,557,71,413,484,448,135,52,201,167,2003
275,Jeff McInnis,PG,30,CLE,76,69,2651,377,915,91,264,286,651,130,160,32,125,157,391,56,1,117,177,975
276,Aaron McKie,SG,32,PHI,68,3,1118,61,142,20,62,41,80,10,16,20,152,172,103,48,17,31,116,152
277,Keith McLeod,PG,25,UTA,53,47,1382,143,408,18,72,125,336,112,146,20,93,113,236,63,12,99,138,416
278,Stanislav Medvedenko,PF,25,LAL,43,4,423,71,156,0,1,71,155,23,28,31,48,79,13,9,2,13,64,165
279,Ron Mercer,SF,28,NJN,18,3,390,65,158,0,3,65,155,7,10,9,31,40,20,16,2,14,20,137
280,Chris Mihm,C,25,LAL,75,75,1870,280,552,0,2,280,550,175,258,197,305,502,50,14,108,110,237,735
281,Darius Miles,SF,23,POR,63,22,1699,336,697,8,23,328,674,129,215,71,228,299,129,75,78,157,189,809
282,Darko Miličić,C,19,DET,37,2,254,25,76,0,0,25,76,17,24,3,40,43,7,2,17,16,31,67
283,Andre Miller,PG,28,DEN,82,82,2852,427,895,6,39,421,856,253,302,100,238,338,569,121,8,220,204,1113
284,Anthony Miller,PF,33,ATL,2,0,9,2,3,0,0,2,3,0,0,0,1,1,1,1,0,1,2,4
285,Brad Miller,C,28,SAC,56,56,2089,319,609,5,19,314,590,233,287,139,382,521,220,69,68,82,181,876
286,Mike Miller,SF,24,MEM,76,51,2278,387,766,140,323,247,443,108,150,36,264,300,220,54,23,127,197,1022
287,Reggie Miller*,SG,39,IND,66,66,2105,314,719,96,298,218,421,250,268,18,138,156,146,50,5,77,109,974
288,Yao Ming*,C,24,HOU,80,80,2447,538,975,0,0,538,975,389,497,208,461,669,61,34,160,196,298,1465
289,Cuttino Mobley,SG,29,TOT,66,64,2388,408,932,150,342,258,590,168,205,45,184,229,188,74,30,133,152,1134
290,Nazr Mohammed,C,27,TOT,77,59,1933,289,602,0,1,289,601,153,227,247,339,586,34,58,86,108,236,731
292,Mikki Moore,PF,29,LAC,74,4,1178,144,287,1,5,143,282,107,136,97,149,246,47,19,32,63,173,396
294,Troy Murphy,PF,24,GSW,70,69,2375,392,947,59,148,333,799,233,319,251,505,756,97,53,33,108,190,1076
295,Lamond Murray,SF,31,TOR,62,1,918,132,310,46,105,86,205,61,80,44,120,164,47,32,16,54,85,371
296,Ronald Murray,SG,25,SEA,49,6,883,131,363,24,95,107,268,59,80,15,83,98,65,30,11,57,59,345
297,Dikembe Mutombo*,C,38,HOU,80,2,1212,108,217,0,0,108,217,106,143,150,276,426,10,16,101,51,135,322
298,Mamadou N'Diaye,C,29,LAC,11,0,72,8,20,0,1,8,19,4,7,9,9,18,1,1,5,0,20,20
300,Lee Nailon,SF,29,NOH,68,51,2017,415,869,0,2,415,867,133,165,128,170,298,109,36,16,110,190,963
301,Eduardo Nájera,PF,28,TOT,68,4,1185,145,322,6,21,139,301,58,91,102,141,243,65,41,24,61,148,354
302,Steve Nash*,PG,30,PHO,75,75,2573,430,857,94,218,336,639,211,238,57,192,249,861,74,6,245,136,1165
303,Jameer Nelson,PG,22,ORL,79,21,1612,286,628,44,141,242,487,73,107,52,141,193,237,78,3,117,199,689
304,Rasho Nesterović,C,28,SAS,70,70,1785,198,430,0,0,198,430,14,30,184,275,459,71,31,117,73,207,410
305,Ira Newble,SG,30,CLE,74,69,1832,182,424,19,53,163,371,55,69,78,142,220,91,50,18,61,144,438
306,Andrés Nocioni,SF,25,CHI,81,38,1892,241,601,25,97,216,504,170,222,69,317,386,122,37,34,135,208,677
307,Moochie Norris,PG,31,TOT,38,0,360,35,109,0,12,35,97,20,24,10,36,46,39,18,2,27,44,90
308,Dirk Nowitzki,PF,26,DAL,78,78,3020,663,1445,91,228,572,1217,615,708,96,661,757,240,97,119,176,219,2032
309,Jermaine O'Neal,PF,26,IND,44,41,1530,386,854,1,6,385,848,295,391,85,303,388,82,25,88,131,173,1068
310,Shaquille O'Neal*,C,32,MIA,73,73,2492,658,1095,0,0,658,1095,353,765,253,507,760,200,36,171,203,262,1669
311,Lamar Odom,PF,25,LAL,64,64,2320,366,774,36,117,330,657,207,298,134,519,653,238,42,65,161,211,975
312,Emeka Okafor,PF,22,CHA,73,73,2600,448,1003,0,1,448,1002,209,343,275,520,795,64,62,125,125,214,1105
313,Mehmet Okur,C,25,UTA,82,25,2304,354,756,17,63,337,693,329,387,194,422,616,166,32,68,141,227,1054
314,Kevin Ollie,PG,32,PHI,26,0,158,11,31,0,0,11,31,6,9,3,16,19,19,5,0,6,16,28
315,Michael Olowokandi,C,29,MIN,62,34,1215,161,353,0,0,161,353,46,69,106,218,324,29,15,56,68,193,368
316,Greg Ostertag,C,31,SAC,56,3,556,37,84,0,2,37,82,13,38,55,112,167,37,7,40,24,88,87
317,Bo Outlaw,PF,33,PHO,39,0,214,12,34,0,0,12,34,5,9,16,37,53,13,6,12,8,29,29
318,Travis Outlaw,SF,20,POR,59,2,793,133,267,4,10,129,257,49,75,40,81,121,35,30,40,39,77,319
319,Zaza Pachulia,C,20,MIL,74,4,1397,160,354,0,1,160,353,138,185,131,247,378,60,44,34,70,166,458
320,Scott Padgett,PF,28,HOU,66,0,942,98,233,50,126,48,107,29,40,47,138,185,55,33,10,30,119,275
321,Milt Palacio,PG,26,TOR,80,4,1533,175,392,2,12,173,380,115,155,26,108,134,279,48,13,104,126,467
322,Jannero Pargo,PG,25,CHI,32,0,453,82,213,23,66,59,147,17,23,12,35,47,76,16,1,45,53,204
323,Smush Parker,PG,23,TOT,16,1,144,18,43,3,13,15,30,9,13,4,8,12,15,5,0,19,16,48
324,Tony Parker,PG,22,SAS,80,80,2735,539,1118,43,156,496,962,210,323,47,251,298,491,98,4,215,167,1331
325,Ruben Patterson,SF,29,POR,70,36,1957,319,601,2,25,317,576,169,282,126,147,273,138,106,21,143,164,809
326,Sasha Pavlović,SG,21,CLE,65,9,862,120,276,30,78,90,198,44,64,15,56,71,49,29,4,47,121,314
327,Gary Payton*,PG,36,BOS,77,77,2541,339,725,42,129,297,596,153,201,48,188,236,469,88,12,148,121,873
328,Anthony Peeler,SG,35,WAS,40,0,529,56,150,25,65,31,85,16,18,14,51,65,57,18,2,28,39,153
329,Kirk Penney,SG,24,LAC,4,0,12,1,3,0,1,1,2,0,0,0,1,1,1,0,0,2,0,2
330,Kendrick Perkins,C,20,BOS,60,3,548,56,119,0,0,56,119,37,58,53,123,176,21,9,37,43,98,149
331,Wesley Person,SF,33,TOT,41,3,667,107,226,41,89,66,137,9,13,3,80,83,39,19,4,17,30,264
332,Morris Peterson,SG,27,TOR,82,61,2510,356,848,129,335,227,513,188,226,71,269,340,169,91,18,93,219,1029
333,Eric Piatkowski,SG,34,CHI,68,11,841,111,258,57,134,54,124,45,56,15,64,79,51,29,1,37,67,324
334,Paul Pierce,SF,27,BOS,82,82,2960,556,1223,108,292,448,931,549,668,78,461,539,348,133,39,230,255,1769
335,Mickaël Piétrus,SF,22,GSW,67,3,1340,214,501,67,195,147,306,141,202,65,124,189,82,46,18,92,139,636
336,Zoran Planinić,PG,22,NJN,43,8,515,78,174,15,40,63,134,46,66,19,50,69,44,25,0,41,76,217
337,Pavel Podkolzin,C,20,DAL,5,0,10,0,0,0,0,0,0,1,2,0,2,2,0,0,0,2,4,1
338,Scot Pollard,C,29,IND,49,17,865,79,167,0,0,79,167,33,49,85,120,205,18,30,24,31,123,191
339,Mark Pope,PF,32,DEN,9,0,27,2,6,0,0,2,6,0,0,5,3,8,1,1,2,1,5,4
340,James Posey,SF,28,MEM,50,18,1382,127,356,55,178,72,178,96,111,45,174,219,88,48,23,69,134,405
341,Vitaly Potapenko,C,29,SEA,33,1,335,45,87,0,1,45,86,27,31,30,48,78,9,7,3,12,53,117
342,Tayshaun Prince,SF,24,DET,82,82,3039,469,963,47,138,422,825,221,274,133,302,435,247,56,71,135,161,1206
343,Laron Profit,SF,27,WAS,42,4,428,56,128,8,28,48,100,16,25,24,52,76,37,16,5,27,44,136
344,Joel Przybilla,C,25,POR,76,50,1858,199,333,0,0,199,333,90,174,178,410,588,74,24,163,98,239,488
345,Vladimir Radmanović,PF,24,SEA,63,0,1856,266,650,128,329,138,321,81,103,52,237,289,86,57,31,80,172,741
346,Aleksandar Radojević,C,28,UTA,12,6,128,6,19,0,0,6,19,7,10,9,19,28,6,0,2,15,32,19
347,Peter John Ramos,C,19,WAS,6,0,20,5,10,0,0,5,10,1,2,1,3,4,0,0,1,3,4,11
348,Zach Randolph,PF,23,POR,46,37,1603,332,741,0,6,332,735,207,254,142,300,442,86,34,17,112,112,871
349,Theo Ratliff,C,31,POR,63,45,1731,115,257,0,0,115,257,74,107,111,220,331,34,23,158,56,183,304
350,Željko Rebrača,C,32,LAC,58,2,928,133,234,0,0,133,234,73,85,49,135,184,26,13,40,49,130,339
351,Michael Redd,SG,25,MIL,75,75,2848,625,1418,104,293,521,1125,369,432,72,240,312,172,63,8,133,152,1723
352,Justin Reed,SF,23,BOS,23,0,121,15,29,0,3,15,26,11,15,8,8,16,10,3,1,5,12,41
353,Jared Reiner,C,22,CHI,19,2,132,10,30,0,0,10,30,1,4,13,25,38,1,3,7,9,35,21
354,Jason Richardson,SG,24,GSW,72,72,2724,610,1368,125,370,485,998,214,309,125,299,424,281,105,32,169,156,1559
355,Quentin Richardson,SG,24,PHO,79,78,2839,407,1045,226,631,181,414,136,184,91,388,479,158,96,27,102,197,1176
356,Luke Ridnour,PG,23,SEA,82,82,2571,299,739,67,178,232,561,159,180,55,149,204,483,94,23,149,185,824
357,Bernard Robinson,SG,24,CHA,31,1,328,36,81,3,8,33,73,18,26,14,34,48,30,11,4,20,42,93
359,Glenn Robinson,SF,32,SAS,9,0,157,34,77,2,6,32,71,20,23,4,20,24,8,4,3,7,19,90
361,Jalen Rose,SF,32,TOR,81,65,2710,527,1159,108,274,419,885,333,390,44,232,276,209,63,10,180,190,1495
362,Malik Rose,PF,30,TOT,76,5,1475,198,441,1,10,197,431,137,186,129,212,341,59,46,16,102,208,534
363,Quinton Ross,SG,23,LAC,78,19,1659,161,373,1,4,160,369,74,110,59,151,210,109,51,22,54,165,397
364,Michael Ruffin,C,28,WAS,79,7,1262,41,99,0,1,41,98,29,67,157,175,332,64,43,41,44,193,111
365,Kareem Rush,SG,24,TOT,48,22,968,157,406,51,137,106,269,37,48,20,69,89,68,20,7,47,74,402
366,Bryon Russell,SF,34,DEN,70,2,1026,95,252,56,149,39,103,61,77,50,122,172,72,44,11,35,130,307
367,John Salmons,SG,25,PHI,58,8,993,85,210,31,91,54,119,35,48,12,109,121,114,40,13,51,92,236
368,Jamal Sampson,PF,21,CHA,23,0,329,28,62,0,0,28,62,23,39,36,86,122,8,4,17,17,53,79
369,Daniel Santiago,C,28,MIL,11,0,105,7,21,0,0,7,21,8,11,6,13,19,1,3,4,4,28,22
370,Brian Scalabrine,PF,26,NJN,54,14,1167,132,332,22,68,110,264,53,69,83,161,244,88,34,18,66,111,339
371,Ansu Sesay,SF,28,GSW,16,0,128,17,42,2,8,15,34,13,24,18,20,38,12,2,3,8,16,49
372,Ha Seung-Jin,C,19,POR,19,0,104,10,23,0,0,10,23,6,11,6,12,18,2,1,5,12,21,26
373,Paul Shirley,PF,27,PHO,9,0,30,5,11,0,0,5,11,2,4,1,1,2,3,0,0,1,3,12
374,Bobby Simmons,SF,24,LAC,75,74,2799,474,1017,50,115,424,902,231,273,128,318,446,205,106,16,135,227,1229
376,Tamar Slay,SG,24,CHA,8,0,78,13,39,2,12,11,27,0,2,6,8,14,3,5,0,8,20,28
377,Donta Smith,SG,21,ATL,38,0,433,44,113,6,22,38,91,33,48,19,33,52,39,23,5,25,50,127
378,J.R. Smith,SG,19,NOH,76,56,1859,295,748,81,281,214,467,111,161,39,113,152,142,55,11,109,135,782
379,Jabari Smith,PF,27,NJN,45,2,648,62,148,1,2,61,146,41,55,29,82,111,38,25,14,39,103,166
380,Joe Smith,PF,29,MIL,74,73,2265,319,621,0,1,319,620,175,228,179,362,541,67,43,38,79,222,813
381,Josh Smith,SF,19,ATL,74,59,2050,274,602,4,23,270,579,163,237,147,310,457,127,59,144,135,157,715
382,Steve Smith,SG,35,TOT,50,1,750,102,248,41,105,61,143,69,80,15,50,65,71,14,7,27,82,314
383,Theron Smith,SF,24,CHA,33,5,510,44,136,3,12,41,124,14,16,39,77,116,28,6,4,27,58,105
384,Eric Snow,SG,31,CLE,81,15,1844,125,327,13,45,112,282,59,80,37,118,155,317,67,16,89,189,322
385,Kirk Snyder,SG,21,UTA,68,7,906,122,328,30,85,92,243,64,96,50,71,121,36,26,19,58,116,338
386,Darius Songaila,PF,26,SAC,81,21,1668,257,488,0,3,257,485,94,111,125,219,344,114,51,18,70,206,608
387,Pape Sow,C,23,TOR,27,4,255,23,58,0,0,23,58,16,27,18,39,57,2,12,4,10,46,62
388,Latrell Sprewell,SF,34,MIN,80,79,2450,398,961,69,211,329,750,156,188,65,189,254,179,53,21,127,124,1021
389,Jerry Stackhouse,SG,30,DAL,56,7,1617,274,662,32,120,242,542,253,298,38,145,183,127,53,10,106,104,833
390,DeShawn Stevenson,SG,23,ORL,55,27,1089,174,426,25,67,149,359,56,101,38,64,102,69,16,9,57,73,429
391,Michael Stewart,PF,29,ATL,12,1,145,11,21,0,0,11,21,3,7,21,19,40,5,6,5,6,32,25
392,Peja Stojaković,SF,27,SAC,66,66,2534,451,1016,174,433,277,583,253,275,62,223,285,138,79,12,102,157,1329
393,Awvee Storey,SG,27,NJN,9,0,32,3,10,1,2,2,8,1,2,4,1,5,1,0,0,0,3,8
394,Damon Stoudamire,PG,31,POR,81,70,2762,457,1165,181,490,276,675,182,199,56,254,310,458,86,2,164,158,1277
395,Amar'e Stoudemire,C,22,PHO,80,80,2889,747,1336,3,16,744,1320,583,795,219,494,713,131,77,130,189,278,2080
396,Erick Strickland,SG,31,MIL,62,5,1014,114,304,21,83,93,221,52,64,11,92,103,115,30,1,64,103,301
397,Rod Strickland,PG,38,HOU,16,2,196,9,43,1,2,8,41,9,10,3,24,27,39,3,2,16,15,28
398,Bruno Šundov,C,24,NYK,21,0,73,11,37,1,3,10,34,2,2,6,7,13,2,2,2,6,16,25
399,Bob Sura,PG,31,HOU,61,59,1922,215,504,55,155,160,349,141,188,79,258,337,317,65,7,147,168,626
400,Mike Sweetney,C,22,NYK,77,28,1509,237,446,0,1,237,445,176,235,169,249,418,44,27,28,108,224,650
401,Robert Swift,C,19,SEA,16,0,72,5,11,0,0,5,11,5,9,1,4,5,2,1,7,4,16,15
402,Stromile Swift,PF,25,MEM,60,14,1279,219,488,0,4,219,484,166,219,92,181,273,43,41,92,90,182,604
403,Wally Szczerbiak,SF,27,MIN,81,37,2558,465,919,63,169,402,750,260,304,82,221,303,191,40,16,132,178,1253
404,Yuta Tabuse,PG,24,PHO,4,0,17,1,6,1,1,0,5,4,4,2,2,4,3,0,0,1,1,7
406,Sebastian Telfair,PG,19,POR,68,26,1330,169,430,17,69,152,361,105,133,10,94,104,224,35,4,125,120,460
407,Jason Terry,PG,27,DAL,80,57,2401,372,743,103,245,269,498,146,173,38,150,188,429,109,15,147,177,993
408,Billy Thomas,SF,29,NJN,25,0,356,34,94,17,56,17,38,7,9,7,29,36,17,14,1,9,29,92
409,Etan Thomas,C,26,WAS,47,10,976,128,255,0,0,128,255,76,144,85,159,244,20,17,51,50,133,332
410,James Thomas,PF,24,TOT,11,2,117,12,20,0,0,12,20,2,6,17,20,37,4,4,4,7,13,26
411,John Thomas,C,29,MIN,44,8,521,42,86,0,0,42,86,27,46,39,58,97,17,15,13,18,82,111
412,Kenny Thomas,PF,27,TOT,73,58,2167,367,781,1,5,366,776,173,227,184,351,535,152,67,17,131,227,908
413,Kurt Thomas,PF,32,NYK,80,80,2855,424,901,2,4,422,897,66,84,170,661,831,160,70,79,99,310,916
414,Tim Thomas,SF,27,NYK,71,68,1940,315,718,85,208,230,510,136,173,45,192,237,110,41,17,113,222,851
415,Jamaal Tinsley,PG,26,IND,40,40,1301,218,522,58,156,160,366,122,164,26,134,160,257,81,12,134,112,616
416,Robert Traylor,C,27,CLE,74,6,1327,177,399,0,8,177,391,55,102,136,196,332,61,54,50,73,215,409
417,Jake Tsakalidis,C,25,MEM,31,1,278,32,64,0,0,32,64,14,18,21,35,56,10,3,16,12,42,78
418,Nikoloz Tskitishvili,PF,21,TOT,35,0,220,22,74,2,17,20,57,4,7,12,29,41,10,8,11,19,33,50
419,Hedo Türkoğlu,SF,25,ORL,67,11,1757,328,782,93,245,235,537,188,225,62,171,233,153,41,18,119,140,937
420,Beno Udrih,PG,22,SAS,80,2,1149,173,390,58,142,115,248,67,89,16,67,83,150,41,10,77,96,471
421,Nick Van Exel,SG,33,POR,53,34,1619,214,561,100,257,114,304,58,74,20,141,161,227,44,0,92,70,586
423,Anderson Varejão,PF,22,CLE,54,0,863,99,193,0,2,99,191,68,127,109,148,257,27,41,38,26,122,266
424,Jacque Vaughn,SG,29,NJN,71,34,1410,146,325,5,15,141,310,76,91,17,90,107,135,41,1,62,138,373
425,Jake Voskuhl,C,27,PHO,38,1,360,27,59,0,0,27,59,26,38,30,62,92,17,4,11,20,60,80
427,Sasha Vujačić,SG,20,LAL,35,3,403,33,117,17,63,16,54,18,19,13,49,62,51,12,2,15,41,101
428,Dwyane Wade,SG,23,MIA,77,77,2974,630,1318,13,45,617,1273,581,762,110,287,397,520,121,82,321,230,1854
429,Dajuan Wagner,SG,21,CLE,11,0,102,18,55,5,26,13,29,3,4,0,2,2,13,5,0,9,15,44
430,Antoine Walker,PF,28,TOT,77,77,2955,581,1377,110,341,471,1036,201,373,182,513,695,265,89,58,253,217,1473
431,Samaki Walker,PF,28,WAS,14,0,134,11,31,0,0,11,31,2,3,8,10,18,4,3,7,8,25,24
432,Ben Wallace,C,30,DET,74,74,2671,295,651,1,9,294,642,130,304,292,610,902,123,106,176,82,159,721
433,Gerald Wallace,SF,22,CHA,70,68,2147,286,637,17,62,269,575,191,289,118,268,386,137,117,91,159,182,780
434,Rasheed Wallace,PF,30,DET,79,79,2687,467,1062,75,236,392,826,136,195,174,470,644,142,65,115,127,236,1145
435,Luke Walton,SF,24,LAL,61,5,768,74,180,16,61,58,119,34,48,55,87,142,93,26,11,58,70,198
436,Charlie Ward,PG,34,HOU,14,13,360,24,77,16,51,8,26,11,13,6,33,39,43,15,0,18,22,75
437,Earl Watson,PG,25,MEM,80,14,1808,236,554,52,163,184,391,91,138,35,129,164,359,83,19,167,184,615
438,Clarence Weatherspoon,PF,34,HOU,40,18,525,47,114,0,0,47,114,29,35,35,87,122,17,9,6,15,74,123
439,Chris Webber,PF,31,TOT,67,67,2370,555,1283,15,44,540,1239,181,228,130,482,612,318,94,53,182,214,1306
440,Bonzi Wells,SG,28,MEM,69,19,1489,272,617,36,104,236,513,141,188,49,180,229,80,85,27,90,165,721
442,David Wesley,SG,34,TOT,80,79,2774,334,840,118,315,216,525,162,189,38,190,228,265,96,9,113,215,948
443,David West,SF,24,NOH,30,8,552,75,172,2,5,73,167,34,50,40,89,129,23,12,16,37,62,186
444,Delonte West,SG,21,BOS,39,7,507,66,155,24,67,42,88,19,27,14,51,65,53,21,8,24,69,175
445,Jahidi White,C,28,CHA,17,0,135,14,31,0,0,14,31,14,40,11,23,34,1,2,12,11,31,42
446,Rodney White,SF,24,TOT,58,2,677,121,289,24,60,97,229,27,44,24,65,89,44,32,11,37,64,293
447,Chris Wilcox,C,22,LAC,54,25,1005,169,329,0,0,169,329,88,144,63,165,228,38,26,24,77,129,426
448,Damien Wilkins,SF,25,SEA,29,7,520,73,168,16,59,57,109,21,34,29,37,66,26,22,10,16,55,183
449,Mike Wilks,PG,25,SAS,48,0,278,32,77,5,16,27,61,12,16,4,21,25,33,14,1,14,26,81
450,Aaron Williams,C,33,TOT,42,4,315,29,63,0,0,29,63,15,17,17,43,60,8,5,8,17,70,73
451,Eric Williams,SG,32,TOT,55,39,1322,142,330,28,73,114,257,112,161,44,128,172,92,38,4,60,147,424
452,Frank Williams,SG,24,CHI,9,0,71,3,20,0,4,3,16,0,0,2,4,6,11,2,3,3,9,6
453,Jason Williams,PG,29,MEM,71,68,1952,266,644,107,330,159,314,80,101,19,103,122,399,75,5,130,91,719
454,Jerome Williams,SF,31,NYK,79,4,1211,122,243,0,5,122,238,115,172,115,168,283,41,55,10,65,155,359
455,Mo Williams,PG,22,MIL,80,80,2254,323,737,32,99,291,638,136,160,50,194,244,484,74,11,196,221,814
456,Scott Williams,C,36,CLE,19,0,152,12,41,0,1,12,40,9,11,15,15,30,8,4,6,5,30,33
457,Corliss Williamson,PF,31,TOT,72,9,1527,273,584,0,2,273,582,195,244,104,155,259,78,38,15,86,218,741
458,Kevin Willis,C,42,ATL,29,5,344,35,90,0,2,35,88,17,23,29,47,76,9,8,7,15,53,87
459,Loren Woods,C,26,TOR,45,30,712,71,164,0,1,71,163,34,59,81,139,220,17,8,39,37,78,176
460,Qyntel Woods,SF,23,MIA,3,0,40,5,12,0,0,5,12,0,0,2,4,6,0,4,0,2,6,10
461,Metta World Peace,SF,25,IND,7,7,291,59,119,7,17,52,102,47,51,8,37,45,22,12,6,17,27,172
462,Dorell Wright,SF,19,MIA,3,0,27,3,11,0,4,3,7,1,1,0,1,1,3,4,0,3,2,7
463,Lorenzen Wright,C,29,MEM,80,77,2287,320,683,0,3,320,680,131,198,177,436,613,87,58,69,100,251,771
464,Wang Zhizhi,C,27,MIA,20,0,92,17,36,2,3,15,33,7,12,6,12,18,5,3,2,5,9,43
1,Shareef Abdur-Rahim,PF,29,SAC,72,30,1961,332,632,5,22,327,610,218,278,106,251,357,149,48,42,108,227,887
2,Alex Acker,SG,23,DET,5,0,35,4,16,1,5,3,11,0,0,1,4,5,4,1,0,4,4,9
3,Malik Allen,PF,27,CHI,54,20,701,121,247,1,1,120,246,23,38,44,96,140,20,14,16,34,92,266
4,Ray Allen*,SG,30,SEA,78,78,3022,681,1500,269,653,412,847,324,359,71,261,332,286,105,16,188,151,1955
5,Tony Allen,PG,24,BOS,51,9,978,129,274,11,34,118,240,100,134,32,79,111,67,51,18,67,126,369
6,Rafer Alston,PG,29,HOU,63,63,2431,280,738,102,312,178,426,99,143,36,219,255,425,101,15,157,194,761
7,Chris Andersen,C,27,NOK,32,2,570,56,98,0,0,56,98,49,103,61,94,155,6,8,41,26,84,161
8,Alan Anderson,SF,23,CHA,36,7,564,75,181,24,58,51,123,33,41,23,47,70,32,11,4,32,48,207
9,Derek Anderson,SG,31,TOT,43,11,1047,108,303,40,134,68,169,93,111,21,122,143,101,23,6,54,98,349
10,Shandon Anderson,SF,32,MIA,48,1,638,54,126,5,19,49,107,13,18,18,63,81,30,17,6,24,75,126
11,Martynas Andriuškevičius,C,19,CLE,6,0,9,0,1,0,0,0,1,0,0,1,3,4,0,2,0,0,1,0
12,Carmelo Anthony,SF,21,DEN,80,80,2941,756,1572,37,152,719,1420,573,709,122,272,394,216,88,42,218,229,2122
13,Rafael Araújo,C,25,TOR,52,34,601,53,145,0,1,53,144,15,28,43,101,144,15,24,6,42,104,121
14,Gilbert Arenas,PG,24,WAS,80,80,3384,746,1668,199,540,547,1128,655,799,59,221,280,484,161,25,297,286,2346
15,Trevor Ariza,SF,20,TOT,57,10,999,93,226,1,5,92,221,77,127,78,140,218,61,57,11,62,100,264
16,Darrell Armstrong,PG,37,DAL,62,2,622,43,128,11,48,32,80,33,42,18,63,81,86,27,3,58,71,130
19,Stacey Augmon,SF,37,ORL,36,3,385,25,73,0,0,25,73,21,30,18,35,53,23,12,6,11,40,71
20,Vin Baker,C,34,LAC,8,1,85,7,15,0,0,7,15,13,18,2,17,19,4,4,4,9,13,27
21,Marcus Banks,PG,24,TOT,58,29,1497,219,468,22,63,197,405,118,147,23,112,135,220,54,11,119,162,578
22,Leandro Barbosa,SG,23,PHO,57,11,1592,273,567,87,196,186,371,111,147,31,119,150,158,48,6,89,145,744
24,Andre Barrett,PG,23,TOT,19,0,282,38,104,2,14,36,90,9,12,9,16,25,52,10,0,15,13,87
25,Earl Barron,C,24,MIA,8,0,45,5,16,0,0,5,16,3,4,2,8,10,0,0,0,5,10,13
26,Brent Barry,SG,34,SAS,74,5,1259,156,345,80,202,76,143,39,59,29,130,159,123,39,27,52,99,431
27,Jon Barry,SG,36,HOU,20,0,342,25,65,12,32,13,33,24,29,1,30,31,26,13,1,22,25,86
28,Eddie Basden,SF,22,CHI,19,0,141,15,37,1,7,14,30,8,10,7,21,28,8,9,2,9,17,39
29,Brandon Bass,PF,20,NOK,29,1,268,28,70,0,0,28,70,12,19,18,50,68,3,3,7,11,18,68
30,Esteban Batista,PF,22,ATL,57,3,495,34,80,0,1,34,79,33,53,61,83,144,7,15,11,38,111,101
31,Tony Battie,C,29,ORL,82,82,2215,280,552,0,6,280,546,89,134,145,312,457,49,46,69,88,250,649
32,Shane Battier,SF,27,MEM,81,81,2839,303,621,65,165,238,456,147,208,164,265,429,136,92,114,90,223,818
34,Charlie Bell,SG,26,MIL,59,6,1283,180,410,71,168,109,242,63,89,21,99,120,130,59,5,41,126,494
35,Raja Bell,SG,29,PHO,79,79,2959,425,930,197,446,228,484,115,146,44,209,253,207,76,22,89,248,1162
36,Jonathan Bender,SF,25,IND,2,0,21,4,5,0,0,4,5,2,2,0,4,4,2,0,1,0,2,10
37,Mike Bibby,PG,27,SAC,82,82,3167,597,1382,192,497,405,885,342,403,29,211,240,444,82,10,199,169,1728
38,Andris Biedriņš,C,19,GSW,68,2,1000,118,185,0,0,118,185,22,72,124,159,283,24,23,47,34,190,258
39,Chauncey Billups,PG,29,DET,81,81,2925,423,1012,184,425,239,587,465,520,41,211,252,699,71,8,170,160,1495
40,Steve Blake,PG,25,POR,68,57,1781,206,470,76,184,130,286,72,91,26,120,146,306,42,5,83,107,560
41,Andray Blatche,PF,19,WAS,29,0,175,26,67,3,13,23,54,10,12,12,26,38,10,5,7,12,36,65
42,Mark Blount,C,30,TOT,81,55,2240,373,734,0,0,373,734,168,222,96,269,365,99,40,76,194,254,914
44,Andrew Bogut,PF,21,MIL,82,77,2348,323,606,0,3,323,603,122,194,189,384,573,192,49,68,125,259,768
45,Matt Bonner,PF,25,TOR,78,6,1710,209,467,102,243,107,224,63,76,86,198,284,56,49,31,32,216,583
46,Calvin Booth,C,29,WAS,33,2,250,20,47,1,2,19,45,5,9,19,33,52,12,9,9,8,44,46
47,Carlos Boozer,PF,24,UTA,33,19,1025,219,399,0,0,219,399,99,137,73,212,285,88,30,8,69,105,537
48,Chris Bosh,C,21,TOR,70,70,2751,549,1087,0,13,549,1074,474,581,204,443,647,181,50,79,157,209,1572
49,Bruce Bowen,SF,34,SAS,82,82,2755,232,536,104,245,128,291,51,84,35,285,320,126,79,30,67,191,619
50,Ryan Bowen,SF,30,HOU,68,19,652,37,124,3,22,34,102,11,14,31,57,88,24,21,6,13,85,88
51,Earl Boykins,PG,29,DEN,60,0,1542,271,661,62,179,209,482,152,174,21,60,81,230,48,4,83,73,756
52,Michael Bradley,PF,26,PHI,46,1,367,32,79,1,5,31,74,2,3,40,67,107,17,5,7,19,39,67
53,Elton Brand,PF,26,LAC,79,79,3099,756,1435,1,3,755,1432,440,568,236,554,790,208,81,201,173,227,1953
54,Primož Brezec,C,26,CHA,79,79,2165,409,791,0,2,409,789,164,224,181,259,440,45,19,32,85,227,982
55,Devin Brown,SG,27,UTA,81,14,1711,207,527,39,118,168,409,158,212,73,134,207,104,44,14,99,153,611
56,Kwame Brown,C,23,LAL,72,49,1978,204,388,0,1,204,387,128,235,182,291,473,72,27,46,100,196,536
57,P.J. Brown,C,36,NOK,75,73,2380,269,583,0,0,269,583,139,168,182,365,547,90,46,50,90,216,677
58,Rick Brunson,PG,33,TOT,27,0,246,21,54,5,13,16,41,7,12,1,21,22,35,8,1,22,22,54
59,Kobe Bryant,SG,27,LAL,80,80,3277,978,2173,180,518,798,1655,696,819,71,354,425,360,147,30,250,233,2832
60,Greg Buckner,SG,29,DEN,73,27,1758,181,417,86,243,95,174,43,55,31,178,209,127,87,20,52,180,491
61,Pat Burke,C,32,PHO,42,0,346,63,127,2,7,61,120,13,21,21,52,73,16,6,13,33,62,141
62,Antonio Burks,PG,25,MEM,57,1,570,51,144,1,6,50,138,10,23,4,33,37,76,20,0,36,45,113
63,Kevin Burleson,PG,26,CHA,39,1,340,22,88,10,54,12,34,16,17,4,22,26,48,26,2,25,63,70
64,Caron Butler,SF,25,WAS,75,54,2708,494,1086,41,120,453,966,289,332,114,352,466,186,127,18,175,238,1318
65,Jackie Butler,C,20,NYK,55,0,740,117,215,0,0,117,215,58,77,67,116,183,25,17,31,62,127,292
66,Rasual Butler,SF,26,NOK,79,20,1875,257,633,92,242,165,391,79,114,51,181,232,40,33,45,65,142,685
67,Andrew Bynum,C,18,LAL,46,0,338,33,82,0,0,33,82,8,27,34,46,80,9,4,22,17,56,74
68,Will Bynum,PG,23,GSW,15,0,162,21,52,2,9,19,43,10,16,3,9,12,19,7,0,14,10,54
69,Žarko Čabarkapa,PF,24,GSW,61,0,505,67,174,5,20,62,154,60,84,37,74,111,20,13,7,35,87,199
70,José Calderón,SG,24,TOR,64,11,1487,132,312,7,43,125,269,78,92,30,111,141,288,42,4,101,93,349
71,Marcus Camby,C,31,DEN,56,54,1857,302,649,1,11,301,638,111,156,132,536,668,115,79,184,92,158,716
72,Brian Cardinal,PF,28,MEM,36,0,402,46,111,13,29,33,82,19,27,11,44,55,33,23,0,27,65,124
73,Matt Carroll,SG,25,CHA,78,6,1275,192,476,72,185,120,291,138,168,34,123,157,35,47,11,48,120,594
74,Anthony Carter,PG,30,MIN,45,8,589,53,137,4,15,49,122,40,55,9,53,62,101,24,9,40,71,150
75,Vince Carter,SG,29,NJN,79,79,2906,653,1518,125,367,528,1151,480,601,135,327,462,338,94,53,213,235,1911
76,Sam Cassell,PG,36,LAC,78,75,2653,493,1112,70,190,423,922,289,335,40,247,287,491,74,11,175,225,1345
77,Kelvin Cato,C,31,TOT,27,0,333,36,84,0,0,36,84,26,35,20,50,70,4,6,12,18,52,98
78,Tyson Chandler,C,23,CHI,79,50,2121,160,283,0,1,160,282,97,193,265,449,714,81,41,104,123,298,417
79,Calbert Cheaney,SF,34,GSW,42,0,448,42,108,0,8,42,100,8,8,20,41,61,19,13,2,17,38,92
80,Josh Childress,SF,22,ATL,74,10,2249,278,504,32,65,246,439,154,201,134,253,387,131,86,39,101,184,742
81,Doug Christie,SG,35,DAL,7,7,185,9,26,0,1,9,25,8,12,2,11,13,14,9,1,6,10,26
82,Speedy Claxton,PG,27,NOK,71,3,2019,304,736,17,63,287,673,246,320,39,154,193,339,108,6,154,177,871
83,Mateen Cleaves,PG,28,SEA,27,0,230,25,71,4,16,21,55,19,24,2,12,14,42,3,2,14,30,73
84,Jarron Collins,C,27,UTA,79,41,1730,129,280,0,0,129,280,157,219,134,199,333,97,36,27,61,252,415
85,Jason Collins,C,27,NJN,71,70,1895,104,262,3,12,101,250,44,86,93,249,342,70,46,40,61,251,255
86,Nick Collison,PF,25,SEA,66,27,1448,207,394,0,3,207,391,79,113,143,225,368,74,21,35,77,213,493
87,Brian Cook,PF,25,LAL,81,46,1535,261,511,36,84,225,427,84,101,88,186,274,74,37,32,61,205,642
88,Jamal Crawford,SG,25,NYK,79,27,2555,366,879,101,293,265,586,295,357,36,212,248,301,87,15,175,150,1128
89,Austin Croshere,PF,30,IND,50,26,1148,132,285,54,140,78,145,90,102,62,203,265,62,22,7,48,105,408
90,Eddy Curry,C,23,NYK,72,69,1865,336,597,0,0,336,597,307,486,145,287,432,19,28,56,179,239,979
91,Samuel Dalembert,C,24,PHI,66,52,1761,196,369,0,1,196,368,93,132,159,382,541,25,34,160,107,244,485
92,Erick Dampier,C,30,DAL,82,36,1934,171,347,0,0,171,347,127,215,273,367,640,51,27,106,115,263,469
93,Antonio Daniels,SG,30,WAS,80,17,2283,230,550,23,101,207,449,284,336,19,153,172,284,52,8,89,96,767
94,Marquis Daniels,SG,25,DAL,62,29,1766,246,512,4,19,242,493,138,183,81,143,224,172,67,13,100,143,634
96,Baron Davis,PG,26,GSW,54,48,1971,335,861,102,324,233,537,195,289,45,191,236,480,89,14,159,165,967
97,Dale Davis,C,36,DET,28,2,178,9,24,0,1,9,23,8,15,21,32,53,6,0,9,4,23,26
98,Josh Davis,PF,25,TOT,6,0,17,2,7,0,2,2,5,2,3,3,1,4,1,2,0,1,3,6
100,Carlos Delfino,SG,23,DET,68,1,726,91,226,20,60,71,166,45,67,28,85,113,44,21,15,36,86,247
102,Luol Deng,SF,20,CHI,78,56,2604,442,954,21,78,421,876,207,276,127,389,516,147,72,50,105,128,1112
103,Boris Diaw,PF,23,PHO,81,70,2874,449,853,8,30,441,823,174,238,159,399,558,503,58,85,189,260,1080
104,Dan Dickau,PG,27,BOS,19,0,234,17,46,10,20,7,26,18,18,5,11,16,40,11,1,18,40,62
105,Travis Diener,PG,23,ORL,23,0,246,29,69,25,57,4,12,5,6,4,17,21,16,7,0,10,22,88
106,Ike Diogu,PF,22,GSW,69,14,1031,175,334,0,0,175,334,136,168,95,134,229,29,15,30,78,164,486
107,DeSagana Diop,C,24,DAL,81,45,1510,75,154,1,2,74,152,39,72,145,229,374,23,44,146,36,253,190
108,Juan Dixon,SG,27,POR,76,42,1920,357,821,65,170,292,651,156,194,30,147,177,149,58,6,113,157,935
109,Michael Doleac,C,28,MIA,31,3,371,37,88,0,0,37,88,24,30,23,62,85,8,10,7,14,45,98
110,Keyon Dooling,PG,25,ORL,50,7,1137,178,405,13,43,165,362,101,121,11,67,78,109,49,4,82,116,470
111,Chris Duhon,PG,23,CHI,74,38,2155,215,538,100,278,115,260,117,143,28,192,220,373,70,3,117,152,647
112,Tim Duncan,PF,29,SAS,80,80,2784,574,1185,2,5,572,1180,335,533,231,650,881,253,70,162,198,219,1485
113,Mike Dunleavy,SF,25,GSW,81,68,2578,331,816,74,260,257,556,196,252,78,321,399,237,60,32,120,199,932
114,Ronald Dupree,SF,25,MIN,36,0,265,33,63,0,1,33,62,14,41,21,28,49,14,12,0,14,44,80
115,John Edwards,C,24,ATL,40,4,296,31,64,0,0,31,64,8,11,18,30,48,5,3,15,12,76,70
116,Howard Eisley,PG,33,TOT,32,0,394,34,103,13,42,21,61,20,24,3,30,33,69,11,2,21,34,101
117,Monta Ellis,SG,20,GSW,49,3,886,132,318,28,82,104,236,42,59,22,83,105,78,32,11,58,69,334
118,Francisco Elson,C,29,DEN,72,54,1579,151,284,1,5,150,279,49,74,99,240,339,47,54,45,65,211,352
119,Melvin Ely,PF,27,CHA,57,22,1348,216,425,0,2,216,423,128,192,94,183,277,76,29,44,100,160,560
120,Maurice Evans,SG,27,DET,80,1,1139,154,341,43,116,111,225,52,65,76,87,163,60,41,15,39,122,403
121,Reggie Evans,PF,25,TOT,67,25,1393,131,268,0,1,131,267,115,217,171,331,502,38,40,10,85,166,377
122,Daniel Ewing,SG,22,LAC,66,5,971,97,255,22,78,75,177,36,46,23,62,85,84,37,6,57,86,252
123,Noel Felix,SF,24,SEA,12,0,82,6,25,1,3,5,22,5,8,3,10,13,2,2,3,8,13,18
124,Raymond Felton,PG,21,CHA,80,54,2406,345,883,97,271,248,612,161,222,77,188,265,446,102,8,182,181,948
125,Michael Finley,SG,32,SAS,77,18,2038,286,695,110,279,176,416,98,115,31,216,247,116,37,7,62,97,780
126,Derek Fisher,PG,31,GSW,82,36,2589,364,887,117,295,247,592,244,293,36,175,211,352,125,8,156,237,1089
127,Gerald Fitch,PG,23,MIA,18,1,239,30,89,7,26,23,63,17,23,7,23,30,33,7,5,15,28,84
128,Marcus Fizer,PF,27,NOK,3,0,39,9,17,1,1,8,16,1,2,1,6,7,1,0,0,2,5,20
129,Sharrod Ford,PF,24,PHO,3,0,13,2,3,0,0,2,3,0,0,1,2,3,0,0,1,2,7,4
130,T.J. Ford,PG,22,MIL,72,70,2557,328,789,35,104,293,685,187,248,63,248,311,473,104,7,219,196,878
131,Danny Fortson,C,29,SEA,23,1,276,27,51,0,0,27,51,33,43,31,47,78,2,4,2,26,76,87
132,Jeff Foster,C,29,IND,63,37,1581,138,250,0,4,138,246,96,159,224,350,574,50,41,27,64,191,372
133,Adonal Foyle,C,30,GSW,77,72,1824,152,300,0,0,152,300,41,67,143,281,424,33,44,125,80,215,345
134,Richie Frahm,SG,28,TOT,33,0,342,39,100,23,70,16,30,7,10,3,30,33,21,4,2,8,30,108
136,Channing Frye,C,22,NYK,65,14,1572,305,640,3,9,302,631,189,229,138,236,374,53,30,47,97,200,802
137,Dan Gadzuric,C,27,MIL,74,0,885,171,309,0,1,171,308,41,89,91,141,232,24,25,43,35,171,383
138,Deng Gai,C,23,PHI,2,0,5,0,0,0,0,0,0,0,0,0,0,0,0,0,0,0,0,0
139,Reece Gaines,PG,25,MIL,12,0,54,6,12,0,2,6,10,1,4,0,0,0,3,1,0,1,1,13
140,Francisco García,SF,24,SAC,67,11,1301,130,325,39,137,91,188,78,101,39,146,185,94,41,47,75,135,377
141,Kevin Garnett,PF,29,MIN,76,76,2957,626,1191,8,30,618,1161,396,489,214,752,966,308,104,107,180,206,1656
142,Pat Garrity,PF,29,ORL,57,0,938,101,242,50,129,51,113,30,37,31,77,108,38,12,9,38,108,282
143,Pau Gasol,PF,25,MEM,80,80,3135,600,1194,3,12,597,1182,425,617,191,522,713,371,46,153,235,184,1628
144,Devean George,SF,28,LAL,71,5,1542,170,425,50,160,120,265,58,86,82,192,274,68,66,34,54,159,448
145,Eddie Gill,PG,27,IND,41,0,122,10,45,7,23,3,22,18,23,0,15,15,12,11,1,9,13,45
146,Manu Ginóbili,SG,28,SAS,65,56,1813,309,669,83,217,226,452,280,360,42,188,230,235,101,26,121,156,981
147,Gordan Giriček,SG,28,UTA,37,36,956,166,383,18,59,148,324,43,57,15,55,70,63,16,4,63,87,393
148,Anthony Goldwire,PG,34,LAC,3,0,22,1,7,0,2,1,5,0,0,0,1,1,2,0,0,1,0,2
149,Ryan Gomes,PF,23,BOS,61,33,1376,173,355,3,9,170,346,112,149,102,196,298,58,35,5,55,83,461
150,Drew Gooden,PF,24,CLE,79,79,2174,334,652,1,3,333,649,176,258,237,428,665,56,52,49,106,190,845
151,Ben Gordon,SG,22,CHI,80,47,2482,486,1152,166,382,320,770,211,268,43,176,219,240,75,5,180,238,1349
152,Joey Graham,SF,23,TOR,80,24,1581,198,414,29,87,169,327,108,133,57,187,244,60,37,13,92,228,533
153,Stephen Graham,SG,23,TOT,22,0,175,21,54,2,10,19,44,14,15,5,22,27,7,5,2,13,31,58
154,Danny Granger,SF,22,IND,78,17,1765,221,478,30,93,191,385,115,148,131,253,384,90,58,62,80,211,587
155,Brian Grant,C,33,PHO,21,2,248,27,65,0,0,27,65,7,8,11,46,57,7,5,3,7,45,61
156,Devin Green,SG,23,LAL,27,0,135,6,28,0,2,6,26,13,21,10,14,24,7,3,0,5,13,25
157,Gerald Green,SG,20,BOS,32,3,374,66,138,6,20,60,118,29,37,10,31,41,18,13,4,22,41,167
158,Willie Green,SG,24,PHI,10,2,153,28,66,10,19,18,47,4,5,1,14,15,5,2,0,12,13,70
159,Orien Greene,PG,23,BOS,80,5,1235,100,253,9,40,91,213,45,68,37,108,145,129,77,10,109,181,254
160,Adrian Griffin,SG,31,DAL,52,45,1245,98,204,0,2,98,202,41,53,75,152,227,89,51,9,39,113,237
161,Eddie Griffin,C,23,MIN,70,27,1359,130,370,16,82,114,288,44,74,107,282,389,40,13,148,43,125,320
162,Anthony Grundy,SG,26,ATL,12,0,108,19,38,5,15,14,23,9,14,1,16,17,9,7,0,9,14,52
163,Richard Hamilton,SG,27,DET,80,80,2825,649,1322,55,120,594,1202,256,303,84,172,256,275,52,16,173,207,1609
164,Zendon Hamilton,C,30,TOT,12,0,49,7,14,0,0,7,14,12,18,3,8,11,0,4,0,6,5,26
165,Anfernee Hardaway,SF,34,NYK,4,0,72,4,14,0,1,4,13,2,2,0,10,10,8,2,0,6,7,10
166,Matt Harpring,SF,29,UTA,71,32,1944,322,678,14,39,308,639,227,313,158,210,368,98,59,14,109,202,885
167,Al Harrington,PF,25,ATL,76,76,2782,551,1220,66,191,485,1029,243,350,132,391,523,238,85,14,195,301,1411
168,Othella Harrington,C,32,CHI,72,23,824,135,273,0,0,135,273,77,123,54,100,154,39,7,13,61,131,347
169,Devin Harris,PG,22,DAL,56,4,1275,190,405,5,21,185,384,169,236,26,99,125,177,53,16,84,121,554
170,David Harrison,C,23,IND,67,17,1034,148,294,0,0,148,294,89,174,84,170,254,14,23,59,79,193,385
171,Jason Hart,PG,27,SAC,66,0,818,86,221,9,31,77,190,37,56,12,59,71,70,31,5,43,85,218
172,Udonis Haslem,PF,25,MIA,81,80,2491,300,591,0,2,300,589,157,199,167,467,634,95,50,17,80,216,757
173,Trenton Hassell,SG,26,MIN,77,67,2514,286,616,7,23,279,593,131,176,82,134,216,203,43,29,124,201,710
174,Chuck Hayes,PF,22,HOU,40,0,535,59,105,0,1,59,104,29,45,67,112,179,14,26,14,12,76,147
175,Jarvis Hayes,SG,24,WAS,21,13,516,77,183,17,47,60,136,25,30,19,57,76,27,16,1,22,38,196
176,Brendan Haywood,C,26,WAS,79,70,1879,222,432,0,0,222,432,131,224,200,267,467,46,30,104,97,232,575
177,Luther Head,SG,23,HOU,80,27,2310,254,630,113,313,141,317,86,123,33,233,266,215,89,9,119,169,707
178,Alan Henderson,C,33,CLE,51,3,531,47,91,0,0,47,91,33,49,60,77,137,10,9,12,22,58,127
179,Nenê Hilário,PF,23,DEN,1,0,3,0,1,0,0,0,1,0,0,0,0,0,0,0,0,2,1,0
180,Grant Hill*,SF,33,ORL,21,17,613,119,243,2,8,117,235,78,102,15,65,80,48,24,6,35,50,318
181,Kirk Hinrich,PG,25,CHI,81,81,2955,451,1078,126,341,325,737,256,314,29,259,288,514,94,21,188,251,1284
182,Julius Hodge,SG,22,DEN,14,0,33,5,13,0,0,5,13,3,8,5,2,7,6,2,0,8,7,13
183,Randy Holcomb,SF,26,CHI,4,0,11,1,1,0,0,1,1,0,0,1,0,1,0,0,0,0,2,2
184,Robert Horry,PF,35,SAS,63,3,1182,112,292,53,144,59,148,44,68,71,171,242,79,43,51,41,115,321
185,Eddie House,PG,27,PHO,81,0,1421,320,759,123,316,197,443,33,41,15,117,132,148,42,12,76,96,796
186,Dwight Howard,PF,20,ORL,82,81,3021,468,881,0,2,468,879,356,598,288,734,1022,125,65,115,217,277,1292
187,Josh Howard,SF,25,DAL,59,58,1915,350,743,27,63,323,680,196,267,123,248,371,111,68,26,79,167,923
188,Juwan Howard,PF,32,HOU,80,80,2537,394,859,0,4,394,855,154,191,168,367,535,112,49,8,133,235,942
189,Troy Hudson,PG,29,MIN,36,0,800,127,333,40,101,87,232,48,52,8,36,44,106,12,4,40,55,342
190,Larry Hughes,SG,27,CLE,36,31,1281,192,469,28,76,164,393,146,193,26,135,161,131,53,21,99,117,558
191,Kris Humphries,PF,20,UTA,62,2,619,77,203,0,5,77,198,34,65,56,101,157,30,23,16,31,82,188
192,Lindsey Hunter,PG,35,DET,30,1,353,37,100,11,43,26,57,2,4,10,30,40,62,19,1,20,44,87
193,Steven Hunter,C,24,PHI,69,35,1312,175,291,0,0,175,291,71,138,110,161,271,17,12,76,64,120,421
194,Andre Iguodala,SF,22,PHI,82,82,3086,344,688,56,158,288,530,263,349,117,364,481,255,135,21,153,198,1007
195,Zydrunas Ilgauskas,C,30,CLE,78,78,2283,450,889,0,5,450,884,317,380,245,346,591,91,38,136,155,280,1217
196,Didier Ilunga-Mbenga,C,25,DAL,43,1,237,32,60,0,1,32,59,10,20,19,37,56,2,6,25,16,47,74
197,Allen Iverson*,PG,30,PHI,72,72,3103,815,1822,72,223,743,1599,675,829,44,188,232,532,140,10,248,121,2377
198,Royal Ivey,PG,24,ATL,73,66,978,116,264,4,10,112,254,24,33,31,65,96,74,24,7,23,147,260
199,Jarrett Jack,SG,22,POR,79,4,1599,189,428,20,76,169,352,128,160,18,142,160,219,41,2,102,138,526
200,Bobby Jackson,PG,32,MEM,71,15,1775,286,748,129,332,157,416,107,146,44,179,223,195,61,1,101,155,808
201,Jermaine Jackson,PG,29,MIL,30,2,202,11,26,1,4,10,22,12,14,8,19,27,25,4,1,13,19,35
202,Jim Jackson,SF,35,TOT,40,1,512,47,160,18,74,29,86,9,13,11,65,76,35,12,6,35,51,121
203,Luke Jackson,SF,24,CLE,36,0,315,29,85,12,36,17,49,26,33,16,24,40,25,11,2,31,30,96
204,Marc Jackson,C,31,TOT,64,10,1027,174,369,1,2,173,367,66,82,86,131,217,44,13,8,65,126,415
205,Stephen Jackson,SG,27,IND,81,81,2910,472,1148,117,339,355,809,268,341,48,264,312,225,104,43,203,195,1329
206,Jerome James,C,30,NYK,45,9,406,56,121,0,0,56,121,25,40,39,52,91,12,3,23,51,104,137
207,LeBron James,SF,21,CLE,79,79,3361,875,1823,127,379,748,1444,601,814,75,481,556,521,123,66,260,181,2478
208,Mike James,PG,30,TOR,79,79,2925,576,1228,169,382,407,846,283,338,45,217,262,460,72,3,206,214,1604
209,Antawn Jamison,SF,29,WAS,82,80,3288,660,1494,147,373,513,1121,217,297,167,598,765,158,90,12,137,189,1684
210,Marko Jarić,PG,27,MIN,75,49,2102,226,566,40,133,186,433,95,138,60,173,233,293,108,21,127,189,587
211,Šarūnas Jasikevičius,PG,29,IND,75,15,1557,170,429,86,236,84,193,121,133,19,134,153,227,40,4,116,108,547
212,Al Jefferson,PF,21,BOS,59,7,1062,189,379,0,4,189,375,86,134,97,202,299,30,30,46,62,166,464
213,Richard Jefferson,SF,25,NJN,78,78,3059,495,1005,60,188,435,817,471,580,95,439,534,297,59,17,174,193,1521
214,Jared Jeffries,PF,24,WAS,77,77,1951,187,415,16,50,171,365,99,168,164,215,379,148,58,50,99,223,489
215,Amir Johnson,SF,18,DET,3,0,39,7,10,2,3,5,7,4,4,3,1,4,3,0,2,4,7,20
216,Anthony Johnson,PG,31,IND,75,53,1981,267,603,51,155,216,448,106,141,31,137,168,324,63,22,115,132,691
217,DerMarr Johnson,SG,25,DEN,58,21,924,132,306,56,160,76,146,34,42,19,77,96,55,25,26,46,86,354
218,Ervin Johnson,C,38,MIL,18,0,81,7,17,0,0,7,17,1,2,5,19,24,2,1,2,5,23,15
219,Joe Johnson,SG,24,ATL,82,82,3340,632,1395,128,360,504,1035,261,330,98,237,335,536,103,31,267,187,1653
220,Linton Johnson,SF,25,TOT,36,7,524,61,149,13,36,48,113,18,27,40,82,122,14,12,12,28,61,153
221,Dahntay Jones,SF,25,MEM,71,4,967,109,263,3,21,106,242,60,93,20,84,104,39,38,15,50,108,281
222,Damon Jones,PG,29,CLE,82,7,2089,190,491,140,371,50,120,32,50,14,119,133,169,37,1,55,112,552
223,Dwayne Jones,PF,22,BOS,14,0,87,4,10,0,0,4,10,6,13,10,21,31,2,1,3,3,14,14
224,Eddie Jones,SG,34,MEM,75,75,2437,292,722,133,374,159,348,168,215,35,244,279,177,131,27,93,201,885
225,Fred Jones,SG,26,IND,68,2,1837,233,559,63,187,170,372,122,160,18,152,170,154,55,20,107,142,651
226,James Jones,SF,25,PHO,75,24,1772,243,581,110,285,133,296,103,121,44,209,253,57,38,49,35,142,699
227,Jumaine Jones,PF,26,CHA,76,42,2089,298,736,115,335,183,401,88,121,105,271,376,63,68,22,74,200,799
228,Chris Kaman,C,23,LAC,78,78,2560,369,706,0,2,369,704,194,252,187,563,750,79,45,108,176,269,932
229,Jason Kapono,SF,24,MIA,51,2,665,79,177,21,53,58,124,28,33,12,59,71,37,7,3,20,89,207
230,Mario Kasun,C,25,ORL,28,0,213,31,69,0,0,31,69,18,23,24,36,60,3,2,3,15,69,80
231,Viktor Khryapa,SF,23,POR,69,53,1492,158,342,10,30,148,312,77,111,114,193,307,88,50,29,84,209,403
232,Jason Kidd*,PG,32,NJN,80,80,2975,366,905,139,395,227,510,194,244,86,494,580,672,150,29,192,157,1065
233,Andrei Kirilenko,SF,24,UTA,69,63,2604,336,730,36,117,300,613,346,495,161,391,552,299,102,220,203,162,1054
234,Linas Kleiza,PF,21,DEN,61,2,519,77,173,2,13,75,160,57,81,38,78,116,15,10,13,16,87,213
235,Brevin Knight,PG,30,CHA,69,67,2351,308,772,3,13,305,759,252,314,35,188,223,610,157,4,164,202,871
236,Yaroslav Korolev,SF,18,LAC,24,0,127,9,30,2,7,7,23,7,10,5,8,13,9,3,0,6,11,27
237,Kyle Korver,SF,24,PHI,82,43,2563,327,761,184,438,143,323,101,119,27,243,270,163,65,26,98,224,939
238,Nenad Krstić,PF,22,NJN,80,80,2469,447,881,1,4,446,877,185,265,182,331,513,88,32,63,133,297,1080
239,Toni Kukoč,PF,37,MIL,65,0,1018,116,298,45,147,71,151,40,56,26,124,150,139,33,17,66,87,317
240,Raef LaFrentz,PF,29,BOS,82,63,2033,238,552,112,286,126,266,51,75,80,326,406,115,29,72,65,273,639
241,Maciej Lampe,C,20,TOT,6,0,28,2,11,0,0,2,11,0,2,4,5,9,2,0,0,3,2,4
242,David Lee,SF,22,NYK,67,14,1129,137,230,0,0,137,230,71,123,109,194,303,43,30,20,51,124,345
243,Voshon Lenard,SG,32,TOT,26,6,458,75,191,25,78,50,113,16,31,5,42,47,41,21,4,31,39,191
244,Rashard Lewis,SF,26,SEA,78,77,2876,538,1151,142,370,396,781,350,428,111,279,390,182,102,50,141,191,1568
245,Randy Livingston,PG,30,CHI,5,0,22,0,2,0,0,0,2,0,0,1,3,4,1,1,0,1,6,0
246,Shaun Livingston,PG,20,LAC,61,14,1525,149,349,1,8,148,341,53,77,41,142,183,273,46,32,111,160,352
247,John Lucas III,PG,23,HOU,13,0,107,14,36,2,9,12,27,0,0,2,3,5,12,5,0,7,6,30
248,Tyronn Lue,PG,28,ATL,51,10,1234,192,418,58,127,134,291,118,138,13,69,82,157,26,3,75,113,560
249,Arvydas Macijauskas,SG,26,NOK,19,0,135,14,41,3,12,11,29,13,15,3,7,10,5,7,0,8,10,44
250,Mark Madsen,C,30,MIN,62,7,676,27,66,0,7,27,59,20,47,50,91,141,11,23,17,26,114,74
251,Corey Maggette,SF,26,LAC,32,13,943,167,375,24,71,143,304,212,256,28,141,169,66,19,4,78,95,570
252,Jamaal Magloire,C,27,MIL,82,82,2465,287,615,0,0,287,615,178,333,220,558,778,56,29,80,166,276,752
253,Stephon Marbury,PG,28,NYK,60,60,2193,349,774,33,104,316,670,246,326,25,150,175,382,63,4,157,143,977
254,Shawn Marion,PF,27,PHO,81,81,3263,716,1365,96,290,620,1075,241,298,249,710,959,143,160,137,125,223,1769
255,Sean Marks,PF,30,SAS,25,0,181,37,71,0,3,37,68,7,12,12,31,43,7,5,7,7,21,81
256,Donyell Marshall,PF,32,CLE,81,0,2077,265,671,128,395,137,276,92,123,105,387,492,60,59,41,90,160,750
257,Rawle Marshall,SF,23,DAL,23,9,241,24,60,1,3,23,57,22,29,8,23,31,10,8,7,15,17,71
258,Darrick Martin,PG,34,TOR,40,0,339,34,97,16,40,18,57,18,24,2,18,20,57,17,0,15,42,102
259,Kenyon Martin,PF,28,DEN,56,49,1546,297,600,5,22,292,578,121,170,93,260,353,79,43,52,72,171,720
260,Kevin Martin,SG,22,SAC,72,41,1913,262,546,66,179,196,367,188,222,58,203,261,97,55,9,81,138,778
261,Desmond Mason,SF,28,NOK,70,55,2102,275,690,1,6,274,684,206,302,64,234,298,66,42,17,113,136,757
262,Jason Maxiell,PF,22,DET,26,0,159,23,54,0,0,23,54,14,42,12,16,28,3,4,5,11,14,60
263,Sean May,PF,21,CHA,23,1,398,70,171,0,5,70,166,49,64,42,67,109,22,17,12,33,58,189
264,Rashad McCants,SG,21,MIN,79,12,1362,241,535,67,180,174,355,78,106,29,114,143,63,44,22,86,176,627
265,Walter McCarty,SF,31,LAC,36,1,353,33,99,10,45,23,54,12,21,15,53,68,23,8,5,19,52,88
266,Antonio McDyess,PF,31,DET,82,0,1733,285,560,0,2,285,558,68,122,156,280,436,90,46,48,76,220,638
267,Tracy McGrady*,SF,26,HOU,47,47,1745,410,1011,73,234,337,777,254,340,46,261,307,225,59,41,120,88,1147
268,Jeff McInnis,SG,31,NJN,28,1,486,63,143,3,16,60,127,20,29,11,39,50,52,11,2,29,37,149
269,Aaron McKie,PG,33,LAL,14,0,121,3,12,0,2,3,10,1,2,3,17,20,11,5,0,2,7,7
270,Keith McLeod,PG,26,UTA,66,32,1232,120,340,24,82,96,258,106,133,11,67,78,151,42,9,76,131,370
271,Stanislav Medvedenko,PF,26,LAL,2,0,6,1,2,0,0,1,2,0,0,0,0,0,1,0,0,0,1,2
272,Chris Mihm,C,26,LAL,59,56,1541,230,459,0,0,230,459,144,201,137,236,373,61,16,73,83,214,604
273,Aaron Miles,PG,22,GSW,19,0,118,6,18,0,0,6,18,4,4,0,14,14,24,4,1,11,13,16
274,C.J. Miles,PG,18,UTA,23,0,203,28,76,5,20,23,56,18,24,18,20,38,16,7,2,9,20,79
275,Darius Miles,SF,24,POR,40,23,1286,235,510,2,10,233,500,87,163,24,158,182,73,42,39,99,100,559
276,Darko Miličić,C,20,TOT,55,1,767,119,234,0,2,119,232,28,50,44,107,151,41,14,77,51,92,266
277,Andre Miller,PG,29,DEN,82,82,2937,404,872,5,27,399,845,313,424,92,259,351,674,106,18,256,213,1126
278,Brad Miller,C,29,SAC,79,79,2923,434,877,34,88,400,789,280,338,122,493,615,374,61,62,180,234,1182
279,Mike Miller,SG,25,MEM,74,9,2268,354,760,138,339,216,421,168,210,42,355,397,200,52,27,140,173,1014
280,Yao Ming*,C,25,HOU,57,57,1949,467,900,0,1,467,899,337,395,148,433,581,85,30,94,147,195,1271
281,Cuttino Mobley,SG,30,LAC,79,74,2979,429,1008,83,245,346,763,229,273,50,291,341,238,93,36,145,208,1170
282,Nazr Mohammed,C,28,SAS,80,30,1389,190,377,0,0,190,377,113,144,163,255,418,40,21,49,91,220,493
283,Sergei Monia,SF,22,TOT,26,15,343,29,87,9,34,20,53,10,14,11,41,52,19,7,5,12,41,77
284,Mikki Moore,C,30,SEA,47,1,583,54,124,0,2,54,122,46,62,44,86,130,27,7,15,40,92,154
285,Terence Morris,SF,27,ORL,22,0,192,16,49,0,2,16,47,3,3,6,32,38,4,6,5,7,19,35
286,Alonzo Mourning*,C,35,MIA,65,20,1302,188,315,0,1,188,314,133,224,125,234,359,11,13,173,79,177,509
287,Troy Murphy,PF,25,GSW,74,74,2516,363,838,58,181,305,657,251,319,195,548,743,101,47,26,108,191,1035
288,Lamond Murray,SF,32,NJN,57,1,576,72,181,27,78,45,103,25,40,29,103,132,13,17,7,22,66,196
289,Ronald Murray,SG,26,TOT,76,27,2112,321,768,37,141,284,627,172,242,33,120,153,197,68,11,135,133,851
290,Dikembe Mutombo*,C,39,HOU,64,23,955,50,95,0,0,50,95,69,91,100,206,306,4,17,57,35,128,169
291,Boniface N'Dong,C,28,LAC,23,1,152,22,53,0,1,22,52,6,9,15,22,37,7,2,5,6,23,50
293,Lee Nailon,PF,30,PHI,22,0,237,40,80,0,0,40,80,13,15,23,19,42,7,8,4,10,32,93
294,Eduardo Nájera,PF,29,DEN,64,3,1449,127,301,4,12,123,289,89,114,128,197,325,52,53,34,54,165,347
295,Steve Nash*,PG,31,PHO,79,79,2796,541,1056,150,342,391,714,257,279,47,286,333,826,61,12,276,120,1489
296,Jameer Nelson,PG,23,ORL,62,33,1784,347,719,70,165,277,554,141,181,39,141,180,302,70,9,148,174,905
297,Rasho Nesterović,C,29,SAS,80,51,1515,172,334,0,2,172,332,18,30,114,195,309,33,21,88,53,209,362
298,Ira Newble,SG,31,CLE,36,3,353,17,57,3,13,14,44,11,16,21,35,56,9,5,10,12,47,48
299,Andrés Nocioni,PF,26,CHI,82,43,2239,383,831,93,238,290,593,204,242,89,411,500,117,40,52,120,252,1063
300,Moochie Norris,PG,32,TOT,45,0,424,46,112,4,14,42,98,29,42,12,42,54,50,20,1,33,49,125
301,Dirk Nowitzki,PF,27,DAL,81,81,3089,751,1564,110,271,641,1293,539,598,115,613,728,226,58,83,156,164,2151
302,Jermaine O'Neal,PF,27,IND,51,47,1802,380,805,3,10,377,795,261,368,102,374,476,133,27,117,151,177,1024
303,Shaquille O'Neal*,C,33,MIA,59,58,1806,480,800,0,0,480,800,221,471,172,369,541,113,23,104,168,230,1181
304,Fabricio Oberto,C,30,SAS,59,0,490,44,93,0,2,44,91,15,27,57,66,123,27,9,11,28,91,103
305,Lamar Odom,PF,26,LAL,80,80,3221,445,925,80,215,365,710,216,313,181,557,738,443,75,64,213,256,1186
306,Emeka Okafor,PF,23,CHA,26,25,874,131,316,0,0,131,316,82,125,94,167,261,31,22,50,53,88,344
307,Mehmet Okur,PF,26,UTA,82,82,2945,519,1128,80,234,439,894,354,454,211,535,746,194,40,73,163,285,1472
308,Kevin Ollie,SG,33,PHI,70,23,1069,75,174,1,3,74,171,41,49,13,85,98,101,33,3,29,103,192
309,Michael Olowokandi,C,30,TOT,48,24,919,107,240,0,0,107,240,24,47,50,170,220,23,22,33,55,122,238
310,Greg Ostertag,C,32,UTA,60,22,807,61,124,0,0,61,124,24,48,82,143,225,58,6,66,46,129,146
311,Bo Outlaw,PF,34,ORL,32,0,355,35,58,0,0,35,58,5,8,31,46,77,14,10,12,17,50,75
312,Travis Outlaw,PF,21,POR,69,11,1153,162,368,14,53,148,315,62,89,48,141,189,34,31,46,37,112,400
313,Andre Owens,PG,25,UTA,23,2,210,27,74,3,16,24,58,12,18,11,10,21,8,5,0,13,25,69
314,Zaza Pachulia,C,21,ATL,78,78,2452,307,681,0,2,307,679,297,404,264,349,613,129,89,39,180,286,911
315,Scott Padgett,PF,29,NJN,62,1,718,71,201,42,121,29,80,27,34,56,109,165,41,28,12,21,90,211
316,Milt Palacio,PG,27,UTA,71,18,1376,171,403,1,16,170,387,98,150,17,117,134,190,47,14,110,125,441
317,Jannero Pargo,PG,26,CHI,57,0,646,109,292,39,103,70,189,17,21,8,53,61,94,24,2,61,57,274
318,Smush Parker,PG,24,LAL,82,82,2773,348,779,120,328,228,451,125,180,37,234,271,302,140,16,147,213,941
319,Tony Parker,PG,23,SAS,80,80,2715,623,1136,11,36,612,1100,253,358,38,223,261,460,83,4,249,161,1510
321,Chris Paul,PG,20,NOK,78,78,2808,407,947,50,177,357,770,394,465,61,339,400,611,175,6,183,218,1258
322,Sasha Pavlović,SG,22,CLE,53,19,813,87,212,35,96,52,116,32,49,16,64,80,25,19,6,42,103,241
323,Gary Payton*,PG,37,MIA,81,25,2305,230,547,66,230,164,317,100,126,34,199,233,257,71,10,102,169,626
324,Kendrick Perkins,C,21,BOS,68,40,1332,137,266,0,2,137,264,80,130,140,264,404,69,21,105,107,199,354
325,Morris Peterson,SG,28,TOR,82,77,3140,478,1096,177,448,301,648,241,294,65,316,381,190,104,15,126,223,1374
326,Johan Petro,C,20,SEA,68,41,1282,153,300,0,0,153,300,47,75,109,187,296,15,25,51,60,213,353
327,Eric Piatkowski,SG,35,CHI,29,1,228,24,61,9,33,15,28,2,5,4,19,23,13,6,1,11,20,59
328,Paul Pierce,SF,28,BOS,79,79,3084,689,1462,111,314,578,1148,627,812,77,453,530,375,107,34,273,223,2116
329,Mickaël Piétrus,SF,23,GSW,52,18,1179,169,418,56,176,113,242,87,143,58,105,163,44,33,10,78,132,481
330,Zoran Planinić,PG,23,NJN,56,1,596,66,183,13,56,53,127,46,66,14,60,74,53,20,4,43,91,191
331,Pavel Podkolzin,C,21,DAL,1,0,18,0,2,0,0,0,2,3,6,0,7,7,0,0,1,2,0,3
332,Scot Pollard,C,30,IND,45,32,771,70,154,0,0,70,154,29,38,73,145,218,24,37,20,26,115,169
333,James Posey,SF,29,MIA,67,63,1914,159,395,117,290,42,105,48,61,33,286,319,89,54,20,58,196,483
334,Vitaly Potapenko,C,30,TOT,33,12,353,37,71,0,0,37,71,10,17,27,37,64,9,2,2,16,50,84
335,Josh Powell,PF,23,DAL,37,2,429,37,81,0,0,37,81,36,45,28,53,81,9,7,4,22,52,110
336,Ronnie Price,PG,22,SAC,29,0,150,21,58,6,27,15,31,12,12,5,10,15,11,6,0,10,10,60
337,Tayshaun Prince,SF,25,DET,82,82,2898,455,999,64,183,391,816,182,238,104,242,346,186,62,39,91,96,1156
338,Laron Profit,SG,28,LAL,25,1,279,40,84,3,18,37,66,21,24,8,35,43,15,11,5,24,25,104
339,Joel Przybilla,C,26,POR,56,52,1395,131,239,0,0,131,239,82,154,146,245,391,43,20,130,76,149,344
340,Vladimir Radmanović,PF,25,TOT,77,27,1974,262,643,138,354,124,289,93,114,64,294,358,136,61,29,93,210,755
341,Shavlik Randolph,PF,22,PHI,57,1,487,44,97,0,0,44,97,43,71,55,78,133,19,19,12,21,83,131
342,Zach Randolph,PF,24,POR,74,71,2545,536,1229,16,55,520,1174,245,343,193,399,592,144,57,14,165,185,1333
343,Theo Ratliff,C,32,POR,55,19,1301,108,189,0,0,108,189,54,83,89,190,279,28,18,88,47,143,270
344,Željko Rebrača,C,33,LAC,29,2,412,52,96,0,0,52,96,31,41,13,51,64,9,5,19,24,59,135
345,Michael Redd,SG,26,MIL,80,80,3130,682,1516,163,413,519,1103,501,571,78,264,342,229,95,5,170,157,2028
346,Justin Reed,SF,24,TOT,72,6,997,119,295,0,1,119,294,87,120,53,71,124,41,23,15,52,163,325
347,Jason Richardson,SG,25,GSW,75,75,2877,641,1438,183,477,458,961,276,410,105,333,438,232,97,37,167,206,1741
348,Quentin Richardson,SF,25,NYK,55,43,1442,163,459,64,188,99,271,61,91,65,165,230,88,39,6,56,134,451
349,Luke Ridnour,PG,24,SEA,79,77,2625,334,799,43,149,291,650,199,227,47,188,235,550,123,22,162,178,910
350,Anthony Roberson,PG,22,MEM,16,0,88,14,31,5,10,9,21,2,2,0,6,6,5,1,0,3,6,35
351,Lawrence Roberts,C,23,MEM,33,0,181,20,44,0,2,20,42,11,23,26,23,49,5,8,2,5,30,51
352,Bernard Robinson,SF,25,CHA,66,18,1303,157,365,2,21,155,344,106,134,62,157,219,77,81,10,74,141,422
353,Clifford Robinson,PF,39,NJN,80,13,1863,219,513,60,175,159,338,52,79,55,212,267,89,44,40,62,206,550
354,Nate Robinson,PG,21,NYK,72,26,1544,230,565,58,146,172,419,152,202,56,111,167,147,59,1,114,201,670
356,Malik Rose,PF,31,NYK,72,35,1119,105,281,1,1,104,280,107,137,84,175,259,67,43,14,80,145,318
357,Quinton Ross,SF,24,LAC,67,45,1515,130,308,0,7,130,301,57,75,38,132,170,79,51,16,47,155,317
358,Michael Ruffin,C,29,WAS,76,4,1010,34,77,0,2,34,75,37,74,122,149,271,27,33,31,38,179,105
359,Kareem Rush,SG,25,CHA,47,25,1111,181,469,57,164,124,305,55,77,18,85,103,50,38,13,65,79,474
360,Bryon Russell,SF,35,DEN,1,0,3,0,0,0,0,0,0,0,0,0,1,1,1,0,0,0,0,0
361,John Salmons,SG,26,PHI,82,24,2059,219,521,26,87,193,434,155,200,48,172,220,223,73,13,125,178,619
362,Jamal Sampson,PF,22,SAC,12,0,39,5,7,0,0,5,7,0,2,5,13,18,5,0,4,0,5,10
363,Melvin Sanders,SG,25,SAS,16,0,113,16,33,2,3,14,30,7,10,4,19,23,3,5,0,8,20,41
364,Brian Scalabrine,PF,27,BOS,71,1,938,74,193,31,87,43,106,26,36,27,87,114,51,21,19,50,127,205
365,Alex Scales,SG,27,SAS,1,0,0,0,0,0,0,0,0,0,0,0,0,0,0,0,0,0,0,0
366,Luke Schenscher,C,23,CHI,20,0,149,16,26,0,0,16,26,4,13,8,21,29,7,1,3,5,21,36
367,Ha Seung-Jin,C,20,POR,27,4,212,18,31,0,0,18,31,8,17,14,35,49,1,3,8,14,41,44
368,Wayne Simien,PF,22,MIA,43,2,414,58,120,0,0,58,120,30,34,38,50,88,7,13,1,24,70,146
369,Bobby Simmons,SF,25,MIL,75,74,2538,366,808,105,250,261,558,165,200,91,242,333,172,86,21,123,254,1002
370,James Singleton,SF,24,LAC,59,10,753,77,151,10,20,67,131,39,50,63,134,197,29,19,21,28,95,203
372,Charles Smith,SG,30,TOT,22,4,210,30,72,15,38,15,34,5,8,3,13,16,9,5,6,4,28,80
373,Donta Smith,SG,22,ATL,23,0,127,15,27,2,4,13,23,6,12,3,11,14,9,8,0,4,20,38
374,J.R. Smith,SG,20,NOK,55,25,989,144,366,52,140,92,226,83,101,19,91,110,58,37,4,54,90,423
375,Joe Smith,PF,30,MIL,44,5,887,145,305,0,2,145,303,89,115,83,147,230,31,24,13,40,120,379
376,Josh Smith,SF,20,ATL,80,73,2559,329,774,34,110,295,664,210,292,176,355,531,191,64,208,162,260,902
377,Eric Snow,PG,32,CLE,82,82,2351,163,399,1,10,162,389,64,93,38,160,198,346,76,19,116,218,391
378,Kirk Snyder,SG,22,NOK,68,45,1310,205,453,46,129,159,324,86,117,55,106,161,102,29,23,70,106,542
379,Darius Songaila,PF,27,CHI,62,7,1329,236,491,2,5,234,486,94,115,76,170,246,88,35,16,85,157,568
380,Pape Sow,C,24,TOR,42,25,590,53,123,0,0,53,123,41,57,54,92,146,8,21,19,30,118,147
381,Jerry Stackhouse,SG,31,DAL,55,11,1525,242,603,36,130,206,473,195,221,32,121,153,160,37,10,121,96,715
382,DeShawn Stevenson,SG,24,ORL,82,82,2648,359,781,2,15,357,766,180,242,59,182,241,160,58,17,123,178,900
383,Peja Stojaković,SF,28,TOT,71,71,2601,445,1018,162,404,283,614,238,260,79,336,415,136,45,10,103,171,1290
384,Awvee Storey,SF,28,WAS,25,1,116,16,41,3,7,13,34,8,14,8,14,22,4,3,1,5,22,43
385,Damon Stoudamire,PG,32,MEM,27,27,862,114,287,36,104,78,183,53,62,23,72,95,128,19,1,55,49,317
386,Salim Stoudamire,SG,23,ATL,61,1,1236,204,492,82,216,122,276,99,110,12,104,116,75,27,3,82,118,589
387,Amar'e Stoudemire,C,23,PHO,3,3,50,9,27,0,1,9,26,8,9,6,10,16,2,1,3,1,4,26
388,Mike Sweetney,C,23,CHI,66,44,1222,200,444,0,0,200,444,133,204,118,232,350,59,19,56,95,209,533
389,Robert Swift,C,20,SEA,47,20,987,124,241,0,0,124,241,53,91,94,170,264,8,15,56,49,142,301
390,Stromile Swift,C,26,HOU,66,5,1344,225,458,0,2,225,456,136,209,103,188,291,25,38,50,91,198,586
391,Wally Szczerbiak,SF,28,TOT,72,71,2729,493,1012,102,255,391,757,278,310,77,236,313,213,40,19,136,150,1366
392,Chris Taft,C,20,GSW,17,0,144,23,38,0,0,23,38,1,6,19,17,36,2,2,7,2,25,47
393,Donell Taylor,SG,23,WAS,51,1,465,53,136,4,17,49,119,30,43,16,37,53,45,30,4,34,47,140
394,Maurice Taylor,PF,29,NYK,67,13,1210,182,389,0,1,182,388,58,83,65,164,229,53,21,14,103,177,422
395,Sebastian Telfair,PG,20,POR,68,30,1641,228,578,57,162,171,416,130,175,19,101,120,247,66,6,115,167,643
396,Jason Terry,PG,28,DAL,80,80,2798,516,1099,171,416,345,683,168,210,31,127,158,306,100,27,135,196,1371
397,Billy Thomas,SG,30,WAS,17,0,131,13,40,10,30,3,10,2,2,5,9,14,9,10,1,6,19,38
398,Etan Thomas,C,27,WAS,71,9,1121,131,246,0,0,131,246,75,125,99,180,279,14,20,68,51,148,337
399,James Thomas,PF,25,TOT,22,0,150,10,19,0,0,10,19,8,14,12,27,39,1,0,3,7,35,28
400,John Thomas,C,30,TOT,16,0,127,6,15,0,0,6,15,3,4,10,10,20,2,3,2,8,17,15
401,Kenny Thomas,PF,28,SAC,82,55,2293,305,604,0,1,305,603,138,204,199,419,618,168,72,39,135,196,748
402,Kurt Thomas,C,33,PHO,53,50,1411,190,391,0,0,190,391,75,92,102,313,415,57,23,54,57,193,455
404,Dijon Thompson,SG,22,PHO,10,0,43,11,25,4,11,7,14,2,2,4,7,11,1,3,1,2,6,28
405,Jamaal Tinsley,PG,27,IND,42,27,1122,158,386,16,70,142,316,58,91,35,98,133,211,49,6,109,96,390
406,Jake Tsakalidis,C,26,MEM,51,19,732,100,165,0,0,100,165,57,87,78,134,212,13,14,32,39,107,257
408,Ronny Turiaf,C,23,LAL,23,1,161,15,30,0,0,15,30,15,27,11,26,37,8,3,10,7,30,45
409,Hedo Türkoğlu,SF,26,ORL,78,59,2615,398,877,114,283,284,594,255,296,70,263,333,216,70,21,130,234,1165
410,Ime Udoka,SF,28,NYK,8,0,114,9,24,1,3,8,21,3,6,3,14,17,6,1,0,2,8,22
411,Beno Udrih,PG,23,SAS,54,3,586,106,233,24,70,82,163,39,50,18,34,52,92,14,2,53,55,275
412,Nick Van Exel,PG,34,SAS,65,2,986,136,343,55,154,81,189,28,41,6,85,91,123,16,3,57,60,355
413,Keith Van Horn,SF,30,DAL,53,0,1090,164,387,50,136,114,251,94,113,54,138,192,37,31,11,71,121,472
414,Anderson Varejão,C,23,CLE,48,4,760,79,150,0,1,79,149,61,119,77,158,235,19,31,19,27,118,219
415,Jacque Vaughn,SG,30,NJN,80,6,1234,107,245,1,6,106,239,59,81,16,75,91,123,42,1,52,140,274
416,Charlie Villanueva,PF,21,TOR,81,36,2361,435,940,70,214,365,726,113,160,181,340,521,88,60,63,99,247,1053
417,Jake Voskuhl,C,28,CHA,51,2,818,114,261,1,3,113,258,41,60,62,121,183,39,26,23,33,157,270
418,Jackson Vroman,PF,24,NOK,41,2,406,26,66,0,0,26,66,21,44,33,53,86,11,12,11,21,78,73
419,Sasha Vujačić,PG,21,LAL,82,4,1449,108,312,59,172,49,140,46,52,33,126,159,139,48,3,50,150,321
420,Dwyane Wade,SG,24,MIA,75,75,2892,699,1413,13,76,686,1337,629,803,107,323,430,503,146,58,268,217,2040
421,Von Wafer,SG,20,LAL,16,0,73,6,38,2,17,4,21,6,8,5,3,8,4,3,0,1,12,20
422,Antoine Walker,PF,29,MIA,82,19,2199,391,898,137,383,254,515,81,129,103,318,421,166,47,30,150,187,1000
423,Samaki Walker,PF,29,IND,7,0,22,0,2,0,0,0,2,2,2,0,3,3,0,0,1,2,7,2
424,Ben Wallace,C,31,DET,82,82,2890,237,465,0,4,237,461,123,296,301,622,923,158,146,181,88,164,597
425,Gerald Wallace,SF,23,CHA,55,52,1895,317,589,14,50,303,539,188,306,123,289,412,96,138,115,99,150,836
426,Rasheed Wallace,PF,31,DET,80,80,2780,459,1067,155,434,304,633,136,183,90,457,547,182,82,130,85,232,1209
427,Matt Walsh,SG,23,MIA,2,0,3,1,1,0,0,1,1,0,2,0,0,0,0,0,0,1,0,2
428,Luke Walton,SF,25,LAL,69,6,1333,135,328,18,55,117,273,57,76,88,159,247,156,41,15,78,119,345
429,Hakim Warrick,PF,23,MEM,68,2,724,101,228,0,0,101,228,76,115,43,101,144,30,14,21,56,113,278
430,Earl Watson,PG,26,TOT,70,10,1578,219,509,110,272,109,237,75,111,24,134,158,289,68,10,136,159,623
431,Chris Webber,PF,32,PHI,75,75,2893,617,1422,21,77,596,1345,263,348,184,557,741,256,103,62,182,219,1518
432,Martell Webster,SF,19,POR,61,18,1070,139,348,65,182,74,166,61,71,29,101,130,34,21,14,43,90,404
433,Bonzi Wells,SG,29,SAC,52,41,1684,284,613,10,45,274,568,129,190,142,259,401,144,94,25,126,156,707
434,Jiří Welsch,SF,26,MIL,58,2,866,86,222,14,49,72,173,65,87,22,89,111,62,34,1,41,65,251
435,David Wesley,SG,35,HOU,71,59,2372,226,561,99,271,127,290,151,187,24,154,178,204,59,6,120,212,702
436,David West,PF,25,NOK,74,74,2526,530,1036,3,11,527,1025,199,236,168,380,548,92,61,64,105,214,1262
437,Delonte West,PG,22,BOS,71,71,2418,333,684,84,218,249,466,86,101,57,232,289,329,84,46,133,197,836
438,Robert Whaley,C,23,UTA,23,0,212,23,57,0,0,23,57,3,6,16,27,43,17,7,8,14,41,49
440,Damien Wilkins,SF,26,SEA,82,12,1525,193,435,14,56,179,379,136,162,79,113,192,107,72,12,85,144,536
441,Mike Wilks,PG,26,TOT,47,0,348,29,90,3,19,26,71,25,41,9,30,39,32,14,1,24,34,86
442,Aaron Williams,C,34,TOT,48,5,791,91,176,0,0,91,176,40,58,64,117,181,17,17,21,30,138,222
443,Alvin Williams,PG,31,TOR,1,0,10,0,3,0,2,0,1,1,2,0,3,3,0,0,0,0,0,1
444,Deron Williams,PG,21,UTA,80,47,2307,339,805,91,219,248,586,95,135,35,159,194,359,60,17,145,233,864
445,Eric Williams,SF,33,TOR,28,11,352,29,75,5,18,24,57,28,38,10,40,50,15,7,2,15,55,91
446,Jason Williams,PG,30,MIA,59,56,1874,268,606,107,288,161,318,85,98,6,133,139,287,53,5,100,101,728
447,Lou Williams,PG,19,PHI,30,0,145,23,52,2,9,21,43,8,13,3,16,19,10,5,0,13,13,56
448,Marvin Williams,PF,19,ATL,79,7,1952,235,531,13,53,222,478,189,253,122,261,383,63,48,24,83,227,672
449,Mo Williams,PG,23,MIL,58,12,1531,267,629,73,191,194,438,96,113,30,113,143,230,52,7,105,146,703
450,Corliss Williamson,SF,32,SAC,37,0,362,43,103,2,2,41,101,38,49,21,46,67,14,7,4,30,56,126
451,Loren Woods,C,27,TOR,27,4,324,28,59,0,1,28,58,6,14,44,66,110,4,9,23,16,49,62
452,Qyntel Woods,SF,24,NYK,49,16,1013,129,254,22,60,107,194,49,76,44,146,190,47,32,13,61,96,329
453,Metta World Peace,SF,26,TOT,56,56,2207,350,867,78,253,272,614,206,305,75,211,286,203,122,41,131,164,984
454,Antoine Wright,SG,21,NJN,39,0,370,29,81,1,15,28,66,11,22,8,22,30,12,4,3,21,42,70
455,Bracey Wright,SG,21,MIN,7,0,135,21,51,6,17,15,34,14,16,3,15,18,5,1,0,8,8,62
456,Dorell Wright,SF,20,MIA,20,2,132,20,43,3,6,17,37,15,17,2,30,32,8,3,1,14,12,58
457,Lorenzen Wright,C,30,MEM,78,58,1689,194,406,0,2,194,404,66,117,142,253,395,48,52,46,67,201,454
458,Derrick Zimmerman,PG,24,NJN,2,0,32,2,3,0,0,2,3,0,0,1,3,4,7,0,0,4,4,4
1,Shareef Abdur-Rahim,C,30,SAC,80,45,2015,310,654,3,20,307,634,170,234,122,276,398,109,53,40,116,243,793
2,Hassan Adams,SG,22,NJN,61,8,495,75,135,0,1,75,134,24,36,35,42,77,13,17,4,22,47,174
3,Maurice Ager,SG,22,DAL,32,1,214,22,70,5,15,17,55,20,33,1,20,21,7,4,3,15,27,69
4,LaMarcus Aldridge,C,21,POR,63,22,1392,241,479,0,2,241,477,83,115,144,168,312,24,22,73,43,186,565
5,Malik Allen,PF,28,CHI,60,1,638,107,258,0,1,107,257,28,34,42,77,119,16,17,16,21,85,242
6,Ray Allen*,SG,31,SEA,55,55,2219,505,1153,165,443,340,710,279,309,57,190,247,228,82,11,154,113,1454
7,Tony Allen,SG,25,BOS,33,18,805,133,259,8,33,125,226,105,134,35,89,124,56,49,12,75,87,379
8,Rafer Alston,PG,30,HOU,82,82,3040,383,1020,192,529,191,491,130,177,29,253,282,444,129,10,170,195,1088
9,Lou Amundson,PF,24,TOT,11,0,89,6,15,0,0,6,15,4,10,13,15,28,1,1,8,5,15,16
10,Alan Anderson,SG,24,CHA,17,0,256,37,81,5,20,32,61,19,23,11,21,32,21,7,0,22,33,98
11,Derek Anderson,SF,32,CHA,50,32,1190,126,294,54,152,72,142,93,106,29,84,113,133,52,7,56,115,399
12,Carmelo Anthony,SF,22,DEN,65,65,2486,691,1453,40,149,651,1304,459,568,143,248,391,249,77,23,234,203,1881
13,Rafael Araújo,C,26,UTA,28,0,248,27,65,0,0,27,65,18,29,22,44,66,10,6,2,17,39,72
14,Gilbert Arenas,PG,25,WAS,74,73,2942,647,1548,205,584,442,964,606,718,61,277,338,443,139,13,236,249,2105
15,Trevor Ariza,SG,21,ORL,57,7,1278,200,371,0,7,200,364,106,171,98,151,249,65,59,19,84,134,506
16,Darrell Armstrong,PG,38,IND,81,4,1275,156,377,72,214,84,163,73,93,34,101,135,191,70,6,76,102,457
17,Hilton Armstrong,C,22,NOK,56,5,634,68,125,0,0,68,125,40,67,58,91,149,10,12,26,35,79,176
18,Carlos Arroyo,PG,27,ORL,72,5,1304,203,478,14,51,189,427,132,166,31,103,134,202,39,2,90,131,552
19,Chucky Atkins,PG,32,MEM,75,23,2064,310,715,116,306,194,409,252,311,18,121,139,346,50,4,127,136,988
20,James Augustine,PF,22,ORL,2,0,7,1,3,0,0,1,3,0,0,1,2,3,2,0,0,0,2,2
21,Kelenna Azubuike,SG,23,GSW,41,9,669,98,220,34,79,64,141,61,78,26,68,94,28,22,10,39,49,291
22,Renaldo Balkman,SF,22,NYK,68,1,1064,139,275,5,27,134,248,51,90,97,197,294,44,57,44,49,146,334
23,Marcus Banks,PG,25,PHO,45,1,503,84,196,5,29,79,167,48,60,10,28,38,60,23,3,40,70,221
24,Leandro Barbosa,SG,24,PHO,80,18,2613,529,1111,190,438,339,673,196,232,22,192,214,317,96,15,146,210,1444
25,J.J. Barea,PG,22,DAL,33,1,191,28,78,6,21,22,57,16,24,7,18,25,24,1,1,14,19,78
26,Andrea Bargnani,PF,21,TOR,65,2,1629,267,625,100,268,167,357,117,142,52,203,255,50,32,53,107,180,751
27,Matt Barnes,PF,26,GSW,76,23,1813,275,628,106,290,169,338,90,123,91,259,350,156,73,41,105,188,746
28,Andre Barrett,PG,24,CHI,6,0,29,4,8,0,0,4,8,0,0,1,4,5,7,0,0,4,4,8
29,Earl Barron,C,25,MIA,28,0,203,24,83,0,1,24,82,17,18,19,22,41,5,6,4,11,21,65
30,Brent Barry,SG,35,SAS,75,28,1631,202,425,128,287,74,138,103,117,17,143,160,138,56,12,61,88,635
31,Brandon Bass,PF,21,NOK,21,3,162,15,44,0,1,15,43,12,16,13,30,43,3,2,3,10,16,42
32,Maceo Baston,PF,31,IND,47,2,405,49,76,3,7,46,69,37,47,21,53,74,16,12,18,32,65,138
33,Esteban Batista,PF,23,ATL,13,0,81,8,16,0,0,8,16,4,7,7,23,30,4,3,0,4,13,20
34,Tony Battie,PF,30,ORL,66,66,1575,176,360,0,1,176,359,52,77,92,252,344,35,29,30,61,185,404
35,Shane Battier,SF,28,HOU,82,82,2988,292,654,157,373,135,281,88,113,67,271,338,175,79,60,72,190,829
36,Charlie Bell,SG,27,MIL,82,64,2848,426,974,127,361,299,613,131,168,57,181,238,247,97,4,104,213,1110
37,Raja Bell,SG,30,PHO,78,78,2917,410,950,205,496,205,454,118,152,48,203,251,196,50,22,83,233,1143
38,Mike Bibby,PG,28,SAC,82,82,2784,471,1166,173,481,298,685,288,347,39,224,263,388,88,6,197,139,1403
39,Andris Biedriņš,C,20,GSW,82,63,2382,348,581,0,0,348,581,87,167,251,511,762,88,67,136,119,304,783
40,Chauncey Billups,PG,30,DET,70,70,2533,348,815,109,316,239,499,386,437,23,214,237,502,84,17,140,161,1191
41,Steve Blake,PG,26,TOT,82,42,2225,209,509,67,208,142,301,43,64,21,148,169,408,61,8,129,121,528
42,Will Blalock,PG,23,DET,14,0,166,9,30,1,5,8,25,6,6,6,9,15,17,5,0,12,9,25
43,Andray Blatche,PF,20,WAS,56,13,682,86,197,4,27,82,170,30,49,77,114,191,39,17,32,49,94,206
44,Mark Blount,C,31,MIN,82,81,2544,427,839,9,31,418,808,147,195,136,369,505,67,43,58,159,239,1010
45,Keith Bogans,SG,26,ORL,59,18,990,99,245,53,137,46,108,47,63,16,77,93,59,28,2,46,98,298
46,Andrew Bogut,C,22,MIL,66,66,2258,348,629,1,5,347,624,112,194,168,416,584,198,49,35,150,216,809
47,Matt Bonner,PF,26,SAS,56,0,653,106,237,36,94,70,143,27,38,64,92,156,22,17,11,25,67,275
48,Josh Boone,PF,22,NJN,61,0,669,99,171,0,0,99,171,56,103,64,112,176,10,11,21,33,94,254
49,Calvin Booth,C,30,WAS,44,1,380,31,66,1,2,30,64,6,10,27,54,81,18,4,29,9,71,69
50,Carlos Boozer,PF,25,UTA,74,74,2557,647,1154,0,0,647,1154,255,372,235,632,867,221,70,21,194,217,1549
51,Chris Bosh,C,22,TOR,69,69,2658,543,1094,12,35,531,1059,463,590,186,555,741,175,39,90,179,163,1561
52,Bruce Bowen,SF,35,SAS,82,82,2464,189,467,89,232,100,235,43,73,23,200,223,117,62,25,65,175,510
53,Earl Boykins,PG,30,TOT,66,23,2031,323,769,95,239,228,530,220,245,49,90,139,291,56,2,120,92,961
54,Cedric Bozeman,SG,23,ATL,23,5,199,11,39,2,13,9,26,2,6,3,20,23,9,5,2,9,32,26
55,Elton Brand,PF,27,LAC,80,80,3077,645,1211,1,1,644,1210,351,461,268,476,744,235,77,179,202,238,1642
56,Ronnie Brewer,SG,21,UTA,56,14,675,102,193,0,9,102,184,56,83,37,38,75,24,37,6,24,44,260
57,Primož Brezec,C,27,CHA,58,40,838,122,274,1,3,121,271,43,68,80,104,184,23,11,23,38,161,288
58,Andre Brown,PF,25,SEA,38,0,271,42,74,0,1,42,73,9,15,26,48,74,2,6,4,29,26,93
59,Dee Brown,PG,22,UTA,49,0,450,32,98,6,28,26,70,24,37,8,32,40,83,22,7,31,51,94
60,Devin Brown,SG,28,NOK,58,49,1662,233,555,81,227,152,328,123,155,55,196,251,149,44,9,91,139,670
61,Kwame Brown,C,24,LAL,41,28,1132,143,242,0,1,143,241,59,134,81,163,244,75,39,49,76,124,345
62,P.J. Brown,PF,37,CHI,72,49,1456,170,418,0,2,170,416,96,122,129,218,347,48,24,52,85,187,436
63,Shannon Brown,SG,21,CLE,23,5,202,28,74,7,25,21,49,10,14,6,15,21,10,7,3,14,24,73
64,Kobe Bryant,SG,28,LAL,77,77,3140,813,1757,137,398,676,1359,667,768,75,364,439,413,111,36,255,205,2430
65,Greg Buckner,SG,30,DAL,76,11,1372,123,299,32,103,91,196,27,34,35,123,158,70,47,7,40,152,305
66,Pat Burke,C,33,PHO,23,0,164,23,65,6,22,17,43,8,13,12,35,47,5,3,2,7,19,60
67,Caron Butler,SF,26,WAS,63,63,2474,451,975,18,72,433,903,283,328,147,320,467,233,134,17,181,188,1203
68,Jackie Butler,C,21,SAS,11,2,103,16,35,0,0,16,35,9,10,6,16,22,5,2,0,10,16,41
69,Rasual Butler,SF,27,NOK,81,38,2223,314,788,134,363,180,425,56,87,42,214,256,63,40,54,67,148,818
70,Andrew Bynum,C,19,LAL,82,53,1793,247,443,0,3,247,440,143,214,139,345,484,94,12,128,115,249,637
71,José Calderón,PG,25,TOR,77,11,1614,263,505,25,75,238,430,117,143,21,113,134,387,63,5,110,136,668
72,Marcus Camby,C,32,DEN,70,70,2369,312,659,0,2,312,657,161,221,164,652,816,223,87,231,122,183,785
73,Brian Cardinal,PF,29,MEM,28,1,313,42,85,18,44,24,41,25,27,13,46,59,31,22,1,23,42,127
74,Rodney Carney,SF,22,PHI,67,35,1169,182,392,25,72,157,320,53,87,39,89,128,26,38,23,43,118,442
75,Matt Carroll,SG,26,CHA,72,47,1878,285,658,111,267,174,391,188,208,35,172,207,91,53,9,73,176,869
76,Anthony Carter,PG,31,DEN,2,0,37,3,8,0,2,3,6,0,0,0,3,3,11,0,1,6,4,6
77,Vince Carter,SG,30,NJN,82,82,3126,726,1598,156,437,570,1161,462,576,114,378,492,393,82,30,217,266,2070
78,Sam Cassell,PG,37,LAC,58,30,1407,261,625,32,109,229,516,160,182,27,140,167,270,28,8,101,126,714
79,Kelvin Cato,C,32,NYK,18,0,95,7,22,0,0,7,22,8,12,12,19,31,0,3,10,6,10,22
80,Tyson Chandler,C,24,NOK,73,73,2525,292,468,0,1,292,467,106,201,320,584,904,66,37,129,126,244,690
81,Josh Childress,SG,23,ATL,55,13,2024,261,518,26,77,235,441,167,210,123,217,340,127,58,36,80,118,715
82,Doug Christie,SG,36,LAC,7,0,82,5,17,1,6,4,11,2,3,3,8,11,8,3,1,5,11,13
83,Speedy Claxton,PG,28,ATL,42,31,1054,91,278,6,28,85,250,33,60,12,69,81,185,72,4,75,131,221
84,Jarron Collins,C,28,UTA,82,9,913,75,170,0,0,75,170,54,83,71,100,171,60,13,8,37,147,204
85,Jason Collins,PF,28,NJN,80,78,1844,55,151,0,2,55,149,59,127,90,226,316,46,40,38,73,273,169
86,Mardy Collins,SF,22,NYK,52,9,777,87,228,13,47,74,181,48,82,28,76,104,83,32,3,57,75,235
87,Nick Collison,C,26,SEA,82,56,2378,318,636,0,2,318,634,154,199,229,437,666,82,48,66,123,289,790
89,Brian Cook,PF,26,LAL,65,24,1018,185,408,46,115,139,293,34,47,61,154,215,65,25,27,51,134,450
90,Jamal Crawford,SG,26,NYK,59,36,2198,354,886,103,322,251,564,228,272,44,145,189,259,57,8,162,114,1039
91,Austin Croshere,PF,31,DAL,61,2,727,78,222,26,91,52,131,45,52,33,153,186,44,14,6,33,68,227
92,Eddy Curry,C,24,NYK,81,81,2849,585,1016,1,1,584,1015,405,659,195,376,571,68,34,40,295,265,1576
93,Samuel Dalembert,C,25,PHI,82,82,2535,356,658,0,2,356,656,167,224,239,494,733,64,47,159,161,287,879
94,Erick Dampier,C,31,DAL,76,73,1915,209,334,0,0,209,334,119,191,217,349,566,44,24,82,107,239,537
95,Antonio Daniels,SG,31,WAS,80,8,1761,172,389,19,63,153,326,208,250,18,133,151,290,39,9,69,79,571
96,Marquis Daniels,SG,26,IND,45,4,800,129,281,6,26,123,255,56,80,26,56,82,57,27,7,55,56,320
97,Baron Davis,PG,27,GSW,63,62,2221,452,1030,85,280,367,750,275,369,51,225,276,509,135,29,193,181,1264
98,Dale Davis,C,37,DET,46,6,464,33,74,0,0,33,74,17,26,59,78,137,12,10,34,15,59,83
99,Paul Davis,C,22,LAC,31,0,180,22,52,0,0,22,52,7,10,21,23,44,7,6,5,8,28,51
100,Ricky Davis,SF,27,MIN,81,81,3021,506,1089,123,310,383,779,239,285,54,261,315,385,80,23,210,189,1374
101,Carlos Delfino,SG,24,DET,82,1,1372,156,376,46,138,110,238,70,89,67,199,266,88,46,8,61,97,428
102,Luol Deng,SF,21,CHI,82,82,3071,630,1218,1,7,629,1211,279,359,148,431,579,204,97,48,153,167,1540
103,Boris Diaw,PF,24,PHO,73,59,2268,306,569,15,45,291,524,82,120,91,226,317,352,28,38,154,177,709
104,Yakhouba Diawara,SG,24,DEN,64,19,1177,100,292,49,170,51,122,35,53,27,83,110,55,30,7,37,132,284
105,Dan Dickau,PG,28,POR,50,3,444,54,151,16,61,38,90,42,53,7,36,43,70,14,1,27,55,166
106,Travis Diener,PG,24,ORL,26,0,288,34,80,18,50,16,30,12,15,3,15,18,35,4,0,13,27,98
107,Ike Diogu,PF,23,TOT,59,2,760,127,266,0,0,127,266,112,140,75,128,203,25,8,26,67,122,366
108,DeSagana Diop,C,25,DAL,81,9,1480,71,151,0,1,71,150,48,86,166,272,438,30,40,113,63,244,190
109,Juan Dixon,SG,28,TOT,81,6,1926,299,703,79,226,220,477,101,116,27,131,158,123,76,9,101,177,778
110,Michael Doleac,C,29,MIA,56,0,698,82,175,0,1,82,174,36,41,44,111,155,22,18,15,30,96,200
111,Keyon Dooling,SG,26,ORL,66,2,1435,188,458,31,96,157,362,114,141,22,64,86,112,52,15,72,125,521
112,Quincy Douby,PG,22,SAC,42,0,359,48,126,12,50,36,76,11,15,11,26,37,15,15,4,15,21,119
113,Chris Duhon,PG,24,CHI,78,30,1906,197,483,88,245,109,238,76,101,23,146,169,310,69,6,105,150,558
114,Tim Duncan,C,30,SAS,80,80,2726,618,1131,1,9,617,1122,362,568,213,633,846,273,66,190,224,203,1599
116,Ronald Dupree,SF,26,DET,19,0,94,11,31,0,0,11,31,3,9,5,12,17,5,5,1,3,12,25
117,Monta Ellis,SG,21,GSW,77,53,2638,480,1010,39,143,441,867,273,358,62,181,243,319,132,21,221,210,1272
118,Francisco Elson,C,30,SAS,70,41,1332,144,282,0,2,144,280,62,80,81,255,336,55,31,59,86,184,350
120,Maurice Evans,SG,28,LAL,76,10,1732,234,542,48,133,186,409,122,155,93,128,221,74,38,14,57,126,638
121,Reggie Evans,PF,26,DEN,66,11,1127,117,215,0,0,117,215,91,183,156,304,460,45,42,16,95,144,325
122,Daniel Ewing,PG,23,LAC,61,3,712,65,161,14,44,51,117,35,45,9,64,73,90,32,4,50,62,179
123,Jordan Farmar,PG,20,LAL,72,2,1090,124,294,45,137,79,157,27,38,22,97,119,137,44,7,73,77,320
124,Desmon Farmer,SG,25,SEA,8,0,32,5,15,2,8,3,7,1,1,0,1,1,9,1,0,1,2,13
125,Raymond Felton,PG,22,CHA,78,75,2832,393,1024,103,312,290,712,204,256,51,216,267,545,118,10,230,180,1093
126,Michael Finley,SF,33,SAS,82,16,1823,273,663,104,286,169,377,90,98,34,189,223,108,32,16,46,76,740
127,Derek Fisher,SG,32,UTA,82,61,2287,258,675,48,156,210,519,262,307,30,119,149,274,83,6,120,234,826
128,T.J. Ford,PG,23,TOR,75,71,2243,393,902,21,69,372,833,240,293,53,183,236,595,101,8,231,186,1047
129,Danny Fortson,C,30,SEA,14,6,158,15,30,0,1,15,29,10,13,13,30,43,1,1,0,15,38,40
130,Jeff Foster,C,30,IND,75,43,1740,122,260,0,1,122,259,78,122,253,356,609,57,62,37,70,202,322
131,Randy Foye,PG,23,MIN,82,12,1879,300,691,68,185,232,506,164,192,49,169,218,232,53,21,152,184,832
132,Adonal Foyle,C,31,GSW,48,6,475,48,85,0,0,48,85,11,25,51,75,126,19,11,50,23,61,107
133,Steve Francis,SG,29,NYK,44,30,1237,140,343,42,111,98,232,175,211,33,124,157,170,41,12,100,126,497
134,Matt Freije,PF,25,ATL,19,0,147,16,54,3,22,13,32,5,6,8,16,24,7,3,1,3,13,40
135,Channing Frye,PF,23,NYK,72,59,1896,298,689,3,18,295,671,85,108,91,304,395,67,36,42,100,216,684
136,Dan Gadzuric,C,28,MIL,54,8,840,108,228,0,1,108,227,42,90,94,152,246,29,22,32,49,141,258
137,Jorge Garbajosa,PF,29,TOR,67,60,1909,222,529,66,193,156,336,57,78,48,282,330,125,78,15,64,90,567
138,Francisco García,SF,25,SAC,79,5,1410,163,380,53,149,110,231,95,114,53,152,205,87,45,43,70,190,474
139,Kevin Garnett,PF,30,MIN,76,76,2995,638,1341,12,56,626,1285,416,498,183,792,975,313,89,126,205,184,1704
140,Pat Garrity,PF,30,ORL,33,0,277,22,70,11,32,11,38,16,18,12,30,42,14,7,0,14,37,71
141,Pau Gasol,C,26,MEM,59,59,2133,462,858,3,11,459,847,299,400,149,432,581,201,29,126,162,137,1226
142,Rudy Gay,SF,20,MEM,78,43,2103,321,760,52,143,269,617,152,209,93,255,348,100,71,74,140,192,846
143,Mickaël Gelabale,SF,23,SEA,70,14,1239,122,264,11,47,111,217,66,82,59,114,173,56,24,22,49,108,321
144,Devean George,SF,29,DAL,60,17,1283,146,370,53,150,93,220,36,48,57,156,213,33,46,23,51,143,381
145,Daniel Gibson,PG,20,CLE,60,16,988,98,231,52,124,46,107,28,39,28,64,92,69,23,8,44,94,276
146,Manu Ginóbili,SG,29,SAS,75,36,2060,396,854,128,323,268,531,320,372,59,268,327,263,109,27,157,155,1240
147,Gordan Giriček,SG,29,UTA,61,6,1188,176,381,52,122,124,259,71,87,24,105,129,63,28,5,64,122,475
148,Andreas Glyniadakis,C,25,SEA,13,4,81,8,17,0,0,8,17,1,2,2,6,8,1,0,0,9,19,17
149,Ryan Gomes,PF,24,BOS,73,60,2275,338,723,16,42,322,681,189,233,125,282,407,119,48,13,105,169,881
150,Drew Gooden,PF,25,CLE,80,80,2238,371,784,1,6,370,778,142,199,263,418,681,88,70,28,115,210,885
151,Ben Gordon,SG,23,CHI,82,51,2704,609,1338,155,375,454,963,380,440,35,223,258,296,64,17,249,252,1753
152,Joey Graham,SF,24,TOR,79,21,1319,192,388,9,31,183,357,110,131,55,193,248,44,30,4,49,161,503
153,Stephen Graham,SG,24,POR,14,1,165,17,40,3,11,14,29,8,9,6,15,21,5,4,1,13,25,45
154,Danny Granger,SF,23,IND,82,57,2785,398,868,110,288,288,580,236,294,114,267,381,114,67,61,135,245,1142
155,Gerald Green,SF,21,BOS,81,26,1780,310,739,95,258,215,481,128,159,68,140,208,83,41,24,120,198,843
156,Willie Green,SG,25,PHI,74,36,1842,357,868,51,157,306,711,74,111,42,116,158,112,56,4,106,144,839
157,Orien Greene,SG,24,IND,41,0,254,23,62,2,11,21,51,15,25,12,32,44,22,17,4,28,38,63
158,Lynn Greer,SG,27,MIL,41,0,432,61,141,18,52,43,89,27,32,2,25,27,53,17,1,18,32,167
159,Adrian Griffin,SF,32,CHI,54,1,585,61,129,0,6,61,123,15,19,40,69,109,59,32,4,38,78,137
160,Eddie Griffin,PF,24,MIN,13,0,92,7,27,0,1,7,26,4,5,7,18,25,4,0,7,6,8,18
161,Mike Hall,SF,22,WAS,2,0,13,1,4,0,0,1,4,0,0,1,1,2,1,0,0,0,1,2
162,Richard Hamilton,SG,28,DET,75,75,2763,547,1170,44,129,503,1041,347,403,75,207,282,285,59,15,159,232,1485
163,Matt Harpring,SF,30,UTA,77,2,1965,322,656,13,39,309,617,237,309,117,236,353,99,52,11,118,232,894
164,Al Harrington,PF,26,TOT,78,78,2563,495,1083,127,293,368,790,168,242,151,345,496,149,65,24,169,269,1285
165,Junior Harrington,PG,26,MEM,29,8,543,57,137,7,26,50,111,31,46,12,56,68,89,21,5,52,79,152
166,Othella Harrington,PF,33,CHA,26,0,220,25,56,0,0,25,56,17,22,13,25,38,6,1,1,15,49,67
167,Devin Harris,PG,23,DAL,80,61,2081,292,593,14,50,278,543,215,261,45,151,196,296,96,21,146,242,813
168,David Harrison,C,24,IND,24,2,190,30,58,0,0,30,58,11,22,9,33,42,6,5,12,26,47,71
169,Jason Hart,PG,28,TOT,36,22,846,100,224,7,29,93,195,42,47,14,84,98,103,44,1,38,83,249
170,Udonis Haslem,PF,26,MIA,79,79,2483,353,717,0,4,353,713,138,203,188,466,654,97,49,26,110,236,844
171,Trenton Hassell,SG,27,MIN,76,68,2223,217,443,6,25,211,418,72,92,83,160,243,203,22,26,80,144,512
172,Chuck Hayes,PF,23,HOU,78,43,1714,192,335,0,0,192,335,55,89,204,317,521,47,70,18,64,281,439
173,Jarvis Hayes,SF,25,WAS,81,17,1626,224,546,66,183,158,363,71,84,42,168,210,80,48,13,56,160,585
174,Brendan Haywood,C,27,WAS,77,49,1740,198,355,0,0,198,355,115,210,195,282,477,47,34,88,90,208,511
175,Luther Head,SG,24,HOU,80,10,2211,306,700,177,401,129,299,83,105,31,221,252,194,76,5,137,133,872
176,Alan Henderson,PF,34,PHI,38,5,418,43,67,0,0,43,67,33,47,48,59,107,10,9,12,12,62,119
177,Walter Herrmann,PF,27,CHA,48,12,936,174,330,53,115,121,215,41,53,28,111,139,26,17,7,32,76,442
178,Nenê Hilário,C,24,DEN,64,42,1715,294,516,0,1,294,515,195,283,150,299,449,77,62,59,127,209,783
179,Grant Hill*,SG,34,ORL,65,64,2009,342,660,2,12,340,648,248,324,53,184,237,138,61,25,144,146,934
180,Kirk Hinrich,PG,26,CHI,80,80,2839,475,1061,140,337,335,724,237,284,32,242,274,500,100,23,191,274,1327
181,Robert Hite,SG,23,MIA,12,0,136,19,60,5,23,14,37,8,12,4,12,16,8,3,2,6,8,51
182,Julius Hodge,SG,23,TOT,9,1,65,6,12,0,0,6,12,3,4,2,6,8,12,4,0,3,6,15
183,Ryan Hollins,C,22,CHA,27,0,185,20,36,0,0,20,36,24,40,11,20,31,1,4,7,16,40,64
184,Robert Horry,PF,36,SAS,68,8,1124,90,251,50,149,40,102,38,64,73,156,229,77,45,41,44,105,268
185,Eddie House,SG,28,NJN,56,1,946,180,421,75,175,105,246,33,36,14,78,92,67,27,3,27,69,468
186,Dwight Howard,C,21,ORL,82,82,3023,526,873,1,2,525,871,390,666,283,725,1008,158,70,156,317,245,1443
187,Josh Howard,SF,26,DAL,70,69,2455,493,1075,92,239,401,836,243,294,130,345,475,127,82,56,123,180,1321
188,Juwan Howard,PF,33,HOU,80,38,2123,309,665,0,0,309,665,155,188,138,332,470,131,29,8,112,205,773
189,Troy Hudson,PG,30,MIN,34,6,554,74,195,28,80,46,115,26,32,8,40,48,73,14,2,40,23,202
190,Larry Hughes,SG,28,CLE,70,68,2596,381,953,74,222,307,731,209,309,41,226,267,256,89,26,154,164,1045
191,Kris Humphries,PF,21,TOR,60,2,670,87,185,0,0,87,185,53,79,78,109,187,18,14,21,32,98,227
192,Lindsey Hunter,PG,36,DET,52,0,745,94,244,38,119,56,125,30,33,9,38,47,93,34,7,35,56,256
193,Steven Hunter,PF,25,PHI,70,41,1605,188,326,0,0,188,326,74,151,114,221,335,26,13,76,65,137,450
194,Andre Iguodala,SG,23,PHI,76,76,3062,443,991,48,155,395,836,452,551,77,357,434,432,152,33,261,200,1386
195,Zydrunas Ilgauskas,C,31,CLE,78,78,2130,385,793,0,1,385,792,155,192,242,357,599,123,48,98,141,257,925
196,Mile Ilić,C,22,NJN,5,0,6,0,3,0,0,0,3,0,0,0,1,1,0,0,0,3,1,0
197,Didier Ilunga-Mbenga,C,26,DAL,21,0,79,5,16,0,0,5,16,7,8,3,8,11,6,3,5,5,17,17
198,Ersan İlyasova,PF,19,MIL,66,14,973,139,363,54,148,85,215,70,89,58,131,189,49,27,17,51,147,402
200,Royal Ivey,PG,25,ATL,53,18,539,64,143,5,16,59,127,24,35,15,36,51,45,24,4,31,62,157
201,Jarrett Jack,PG,23,POR,79,79,2651,320,705,63,180,257,525,243,279,18,190,208,417,86,9,187,202,946
202,Bobby Jackson,SG,33,NOK,56,2,1330,204,518,54,165,150,353,130,168,42,136,178,141,50,6,78,98,592
203,Luke Jackson,SF,25,TOT,13,2,138,19,43,5,17,14,26,5,9,2,8,10,13,5,1,7,15,48
204,Marc Jackson,PF,32,NOK,56,25,1025,159,388,0,1,159,387,90,103,62,130,192,58,21,7,65,89,408
206,Jerome James,C,31,NYK,41,11,273,33,79,0,0,33,79,10,18,21,45,66,3,6,15,23,73,76
207,LeBron James,SF,22,CLE,78,78,3190,772,1621,99,310,673,1311,489,701,83,443,526,470,125,55,250,171,2132
208,Mike James,PG,31,MIN,82,65,2069,297,703,80,215,217,488,154,184,25,138,163,297,55,7,129,171,828
209,Antawn Jamison,PF,30,WAS,70,70,2662,512,1139,138,379,374,760,226,307,134,428,562,136,80,36,104,194,1388
210,Marko Jarić,SG,28,MIN,70,13,1555,136,325,32,85,104,240,67,88,54,130,184,145,75,16,88,172,371
212,Al Jefferson,C,22,BOS,69,60,2319,453,882,0,1,453,881,201,295,237,519,756,88,48,106,136,232,1107
213,Richard Jefferson,SF,26,NJN,55,53,1956,303,665,52,145,251,520,239,326,48,192,240,148,34,8,120,123,897
214,Jared Jeffries,SF,25,NYK,55,43,1307,95,206,2,20,93,186,31,68,111,127,238,67,44,30,61,150,223
215,Alexander Johnson,PF,23,MEM,59,19,753,91,169,0,0,91,169,78,118,50,131,181,17,25,35,47,137,260
216,Amir Johnson,PF,19,DET,8,0,124,18,33,0,3,18,30,11,14,15,22,37,3,5,13,9,19,47
217,Anthony Johnson,PG,32,TOT,67,17,1301,142,343,25,73,117,270,46,61,22,79,101,201,33,3,76,119,355
218,DerMarr Johnson,SF,26,DEN,39,7,419,50,154,19,88,31,66,16,21,10,47,57,17,16,12,27,39,135
219,Joe Johnson,SG,25,ATL,57,57,2359,536,1139,119,312,417,827,235,314,53,186,239,249,60,11,176,115,1426
220,Linton Johnson,PF,26,NOK,54,0,720,93,190,10,30,83,160,30,37,52,111,163,18,33,18,27,101,226
221,Bobby Jones,SF,23,PHI,44,5,336,43,93,1,9,42,84,23,41,22,35,57,16,11,1,18,59,110
222,Dahntay Jones,SG,26,MEM,78,25,1671,220,461,5,12,215,449,138,174,47,106,153,68,39,22,92,192,583
223,Damon Jones,PG,30,CLE,60,0,1173,137,355,89,231,48,124,30,44,9,57,66,94,16,2,36,53,393
224,Dwayne Jones,PF,23,CLE,4,0,18,0,1,0,0,0,1,3,6,1,5,6,0,0,0,2,3,3
225,Eddie Jones,SG,35,TOT,64,41,1594,178,422,78,222,100,200,59,75,31,159,190,109,68,10,47,124,493
226,Fred Jones,SG,27,TOT,63,12,1319,139,361,39,128,100,233,95,114,23,92,115,108,48,16,67,121,412
227,James Jones,SF,26,PHO,76,7,1376,162,440,90,238,72,202,71,81,33,143,176,45,28,42,28,115,485
228,Jumaine Jones,SF,27,PHO,18,0,138,14,51,10,32,4,19,2,2,6,17,23,1,5,1,7,19,40
229,Solomon Jones,PF,22,ATL,58,8,666,65,128,0,1,65,127,59,75,49,87,136,11,11,42,25,124,189
230,Chris Kaman,C,24,LAC,75,66,2176,294,652,0,1,294,651,166,224,160,428,588,79,41,116,147,251,754
231,Jason Kapono,SF,25,MIA,67,35,1767,278,563,108,210,170,353,66,74,26,154,180,81,38,2,70,135,730
232,Viktor Khryapa,PF,24,CHI,33,0,231,27,70,0,6,27,64,19,26,20,37,57,21,10,1,16,53,73
233,Jason Kidd*,PG,33,NJN,80,80,2933,369,908,124,361,245,547,179,230,135,520,655,736,127,23,213,146,1041
234,Tarence Kinsey,SG,22,MEM,48,12,967,139,304,13,46,126,258,78,98,29,68,97,41,53,1,46,57,369
235,Andrei Kirilenko,SF,25,UTA,70,70,2049,197,418,16,75,181,343,174,239,88,241,329,202,74,144,135,172,584
236,Linas Kleiza,PF,22,DEN,79,14,1488,200,474,83,221,117,253,115,135,77,189,266,45,28,14,79,200,598
237,Brevin Knight,PG,31,CHA,45,25,1273,152,363,1,18,151,345,103,128,14,101,115,296,67,3,95,113,408
238,Yaroslav Korolev,SF,19,LAC,10,0,41,4,16,1,5,3,11,3,6,1,2,3,4,3,0,1,0,12
239,Kyle Korver,SF,25,PHI,74,1,2288,372,845,132,307,240,538,191,209,30,229,259,105,57,20,117,188,1067
240,Nenad Krstić,C,23,NJN,26,26,848,170,323,0,1,170,322,86,121,51,125,176,46,10,24,52,88,426
241,Raef LaFrentz,PF,30,POR,27,9,352,39,102,2,23,37,79,20,26,25,45,70,8,7,11,13,57,100
242,James Lang,C,23,WAS,11,0,55,4,9,0,0,4,9,3,5,5,6,11,2,0,3,2,14,11
243,David Lee,PF,23,NYK,58,12,1731,240,400,0,0,240,400,141,173,196,406,602,104,48,23,92,155,621
244,Rashard Lewis,SF,27,SEA,60,60,2348,463,1005,151,387,312,618,265,315,91,305,396,145,68,39,118,143,1342
245,Randy Livingston,PG,31,SEA,4,0,26,0,3,0,0,0,3,0,0,1,0,1,4,0,0,1,2,0
246,Shaun Livingston,PG,21,LAC,54,31,1611,208,449,5,16,203,433,82,116,56,128,184,274,59,29,108,135,503
247,Kyle Lowry,PG,20,MEM,10,0,175,14,38,3,8,11,30,25,28,12,19,31,32,14,1,12,20,56
248,John Lucas III,PG,24,HOU,47,0,383,62,156,15,59,47,97,15,19,9,27,36,33,17,0,15,38,154
249,Tyronn Lue,PG,29,ATL,56,17,1488,218,524,56,161,162,363,144,163,19,85,104,201,24,0,85,101,636
250,Mark Madsen,C,31,MIN,56,0,473,23,43,0,0,23,43,15,29,35,52,87,10,10,10,21,100,61
251,Corey Maggette,SF,27,LAC,75,31,2291,367,808,13,65,354,743,519,633,90,352,442,208,65,14,201,244,1266
252,Jamaal Magloire,C,28,POR,81,23,1703,199,395,0,0,199,395,131,242,151,341,492,30,21,66,129,226,529
253,Renaldo Major,PF,24,GSW,1,0,27,2,10,0,0,2,10,1,2,0,2,2,0,2,0,1,4,5
254,Stephon Marbury,PG,29,NYK,74,74,2748,395,952,123,345,272,607,297,386,36,177,213,403,71,10,179,185,1210
255,Shawn Marion,SF,28,PHO,80,80,3010,561,1071,80,252,481,819,201,248,172,613,785,134,156,122,114,216,1403
256,Damir Markota,PF,21,MIL,30,0,170,19,52,6,16,13,36,7,11,11,20,31,6,3,1,15,22,51
257,Sean Marks,PF,31,PHO,3,0,17,2,6,0,1,2,5,2,2,0,3,3,0,0,1,0,4,6
258,Donyell Marshall,PF,33,CLE,81,0,1360,209,493,95,271,114,222,53,80,86,237,323,46,39,43,67,130,566
259,Rawle Marshall,SG,24,IND,40,2,361,32,89,4,18,28,71,31,45,8,21,29,13,12,5,19,22,99
260,Darrick Martin,PG,35,TOR,31,0,220,33,94,13,37,20,57,15,21,2,10,12,43,3,0,12,22,94
261,Kenyon Martin,PF,29,DEN,2,2,63,8,16,0,1,8,15,3,12,6,14,20,1,0,0,5,10,19
262,Kevin Martin,SG,23,SAC,80,80,2818,505,1067,127,333,378,734,481,570,69,273,342,173,98,11,135,181,1618
263,Desmond Mason,SF,29,NOK,75,75,2575,407,900,0,0,407,900,214,323,124,221,345,115,52,22,192,174,1028
264,Roger Mason,SG,26,WAS,62,0,492,59,179,33,102,26,77,14,16,7,38,45,35,13,6,19,66,165
265,Jason Maxiell,C,23,DET,67,8,943,131,262,0,0,131,262,72,137,88,98,186,14,30,60,53,110,334
266,Sean May,PF,22,CHA,35,8,838,164,328,2,3,162,325,86,112,73,160,233,66,19,24,56,100,416
267,Rashad McCants,SG,22,MIN,37,0,554,62,177,20,75,42,102,40,58,14,33,47,38,26,7,40,71,184
268,Chris McCray,SG,22,MIL,5,0,12,0,3,0,0,0,3,0,0,0,0,0,0,0,0,2,1,0
269,Antonio McDyess,PF,32,DET,82,3,1729,284,540,0,0,284,540,96,139,165,331,496,72,61,65,75,240,664
270,Ivan McFarlin,PF,24,PHI,11,0,41,5,13,0,1,5,12,5,7,7,4,11,1,0,0,1,8,15
271,Tracy McGrady*,SG,27,HOU,71,71,2539,638,1480,126,381,512,1099,345,488,56,322,378,458,92,36,213,136,1747
272,Jeff McInnis,PG,32,CHA,38,3,702,71,181,1,8,70,173,22,32,14,48,62,124,14,0,42,72,165
273,Aaron McKie,SF,34,LAL,10,0,131,11,17,0,0,11,17,0,0,1,17,18,13,4,0,8,14,22
274,Keith McLeod,PG,27,TOT,48,9,718,73,188,16,45,57,143,69,78,4,39,43,90,24,5,46,51,231
275,Stanislav Medvedenko,C,27,ATL,14,0,81,12,29,1,2,11,27,17,20,4,10,14,2,0,2,5,16,42
276,Pops Mensah-Bonsu,PF,23,DAL,12,0,71,11,17,0,0,11,17,7,18,9,12,21,0,1,0,9,8,29
277,C.J. Miles,SG,19,UTA,37,13,373,40,116,7,32,33,84,14,23,11,24,35,25,11,4,28,60,101
278,Darko Miličić,PF,21,ORL,80,16,1913,249,548,0,1,249,547,141,230,145,292,437,90,44,140,124,219,639
279,Andre Miller,PG,30,TOT,80,79,2966,424,909,5,35,419,874,222,283,97,255,352,625,110,10,222,184,1075
280,Brad Miller,C,30,SAC,63,56,1783,224,494,5,33,219,461,115,149,79,322,401,224,38,39,108,155,568
281,Mike Miller,SG,26,MEM,70,69,2740,465,1010,202,498,263,512,161,203,52,326,378,298,54,18,179,138,1293
282,Paul Millsap,PF,21,UTA,82,1,1472,209,398,1,3,208,395,140,208,183,240,423,62,67,74,94,236,559
283,Yao Ming*,C,26,HOU,48,48,1624,423,819,0,2,423,817,356,413,101,351,452,94,17,94,167,159,1202
284,Cuttino Mobley,SG,31,LAC,78,73,2841,388,882,101,246,287,636,200,239,52,215,267,198,92,24,145,186,1077
285,Nazr Mohammed,C,29,DET,51,33,773,118,222,0,0,118,222,50,82,89,140,229,9,27,40,43,133,286
286,Mikki Moore,C,31,NJN,79,55,2082,308,506,0,1,308,505,160,235,145,258,403,74,46,60,113,261,776
287,Randolph Morris,C,21,NYK,5,0,44,1,6,0,0,1,6,2,6,1,8,9,1,2,1,2,4,4
288,Adam Morrison,PF,22,CHA,78,23,2326,355,944,87,258,268,686,120,169,54,176,230,163,28,6,130,179,917
289,Alonzo Mourning*,C,36,MIA,77,43,1572,238,425,0,0,238,425,185,308,126,224,350,18,13,178,129,219,661
290,Troy Murphy,PF,26,TOT,68,48,1852,266,581,58,147,208,434,108,145,100,314,414,126,46,42,78,196,698
291,Ronald Murray,SG,27,DET,69,18,1477,177,438,24,83,153,355,87,120,26,87,113,187,49,13,90,96,465
292,Dikembe Mutombo*,C,40,HOU,75,33,1289,85,153,0,0,85,153,60,87,164,324,488,13,22,76,38,156,230
293,Boštjan Nachbar,SF,26,NJN,76,1,1532,226,495,112,265,114,230,132,164,27,226,253,61,30,26,69,183,696
294,Eduardo Nájera,PF,30,DEN,75,36,1658,204,354,1,12,203,342,88,123,131,179,310,64,73,26,56,207,497
295,Steve Nash*,PG,32,PHO,76,76,2682,517,971,156,343,361,628,222,247,30,239,269,884,57,6,287,117,1412
296,Jameer Nelson,PG,24,ORL,77,77,2331,376,875,65,194,311,681,183,221,50,186,236,330,73,5,184,225,1000
297,Rasho Nesterović,C,30,TOR,80,73,1676,230,421,0,1,230,420,34,50,115,245,360,74,37,84,56,193,494
298,Ira Newble,SF,32,CLE,15,1,129,16,37,8,15,8,22,6,10,13,17,30,2,6,0,3,17,46
299,Andrés Nocioni,PF,27,CHI,53,31,1406,273,584,80,209,193,375,123,145,42,259,301,57,27,24,104,164,749
300,David Noel,PF,22,MIL,68,0,792,65,177,17,53,48,124,37,43,42,81,123,65,25,9,40,77,184
301,Steve Novak,SF,23,HOU,35,1,191,18,50,13,39,5,11,2,2,4,22,26,6,5,0,4,21,51
302,Dirk Nowitzki,PF,28,DAL,78,78,2820,673,1341,72,173,601,1168,498,551,122,571,693,263,52,62,167,171,1916
303,Patrick O'Bryant,C,20,GSW,16,0,119,10,32,0,0,10,32,11,17,7,14,21,9,6,8,8,26,31
304,Jermaine O'Neal,C,28,IND,69,69,2459,498,1141,0,7,498,1134,343,447,153,508,661,167,50,182,203,232,1339
305,Shaquille O'Neal*,C,34,MIA,40,39,1135,283,479,0,0,283,479,124,294,97,200,297,79,8,55,95,139,690
306,Fabricio Oberto,PF,31,SAS,79,33,1365,158,281,0,0,158,281,33,51,131,237,368,68,25,24,69,213,349
307,Lamar Odom,PF,27,LAL,56,56,2202,319,681,54,182,265,499,198,283,102,445,547,270,53,32,163,182,890
308,Emeka Okafor,C,24,CHA,67,65,2329,394,740,0,0,394,740,175,295,258,499,757,80,57,172,111,210,963
309,Mehmet Okur,C,27,UTA,80,80,2664,490,1061,129,336,361,725,296,387,160,419,579,156,36,38,125,257,1405
310,Kevin Ollie,PG,34,PHI,53,23,919,81,187,0,2,81,185,37,45,8,66,74,130,21,1,47,76,199
311,Michael Olowokandi,C,31,BOS,24,0,234,19,46,0,0,19,46,2,3,14,34,48,5,8,13,17,48,40
312,Bo Outlaw,PF,35,ORL,41,0,460,34,51,0,0,34,51,13,22,47,59,106,16,17,6,21,57,81
313,Travis Outlaw,PF,22,POR,67,1,1532,246,567,10,37,236,530,143,181,65,152,217,52,61,74,66,150,645
314,Zaza Pachulia,C,22,ATL,72,47,2026,291,614,0,1,291,613,293,373,199,301,500,106,77,36,162,267,875
315,Scott Padgett,PF,30,TOT,31,0,231,16,56,8,33,8,23,6,13,16,38,54,8,5,3,9,35,46
316,Jannero Pargo,PG,27,NOK,82,7,1710,283,692,81,209,202,483,104,122,20,160,180,203,53,4,122,121,751
317,Anthony Parker,SG,31,TOR,73,73,2437,328,687,115,261,213,426,132,158,60,223,283,153,73,11,71,135,903
318,Smush Parker,PG,25,LAL,82,80,2457,342,785,110,301,232,484,113,175,45,161,206,228,119,10,153,211,907
319,Tony Parker,PG,24,SAS,77,77,2499,570,1096,15,38,555,1058,274,350,34,216,250,420,82,6,191,137,1429
320,Ruben Patterson,SF,31,MIL,81,53,2508,475,867,3,19,472,848,241,376,190,250,440,232,110,25,199,232,1194
321,Chris Paul,PG,21,NOK,64,64,2353,381,871,50,143,331,728,292,357,54,226,280,569,118,3,161,154,1104
322,Sasha Pavlović,SG,23,CLE,67,28,1534,222,490,60,148,162,342,100,126,23,135,158,105,55,17,102,145,604
323,Gary Payton*,PG,38,MIA,68,28,1503,144,366,32,123,112,243,38,57,18,114,132,201,43,3,66,117,358
324,Kendrick Perkins,C,22,BOS,72,53,1576,132,269,0,3,132,266,60,100,113,259,372,94,23,96,113,214,324
325,Morris Peterson,SF,29,TOR,71,12,1515,222,517,106,295,116,222,84,123,32,205,237,47,45,12,53,126,634
326,Johan Petro,C,21,SEA,81,13,1510,226,438,0,0,226,438,50,77,92,243,335,45,39,47,82,237,502
327,Eric Piatkowski,SG,36,PHO,11,0,73,9,25,7,18,2,7,2,2,2,7,9,4,0,1,5,6,27
328,Paul Pierce,SG,29,BOS,47,46,1740,373,850,107,275,266,575,320,402,39,238,277,194,48,13,152,122,1173
329,Mickaël Piétrus,SF,24,GSW,72,38,1937,286,586,93,240,193,346,136,210,81,246,327,62,48,55,105,220,801
330,Kevinn Pinkney,PF,23,BOS,6,0,100,12,27,1,2,11,25,6,9,7,8,15,5,3,3,4,12,31
331,Scot Pollard,C,31,CLE,24,0,109,11,26,0,0,11,26,2,4,15,16,31,3,4,1,4,27,24
332,James Posey,SF,30,MIA,71,19,1919,186,432,97,259,89,173,81,98,66,291,357,94,71,23,55,193,550
333,Vitaly Potapenko,C,31,SAC,3,0,13,0,4,0,0,0,4,0,0,0,2,2,0,0,0,2,3,0
334,Leon Powe,C,23,BOS,63,2,720,79,177,0,2,79,175,106,144,97,118,215,10,14,22,47,104,264
335,Josh Powell,PF,24,TOT,37,0,353,43,93,0,0,43,93,30,42,24,64,88,21,5,12,29,61,116
336,Roger Powell,SF,24,UTA,3,0,13,0,3,0,1,0,2,2,2,3,0,3,0,0,0,3,2,2
337,Ronnie Price,PG,23,SAC,58,1,563,67,172,21,65,46,107,37,55,15,56,71,48,28,4,33,64,192
338,Tayshaun Prince,SF,26,DET,82,82,3001,459,997,81,210,378,787,172,224,144,285,429,227,51,55,98,116,1171
339,Joel Przybilla,C,27,POR,43,43,701,37,78,0,0,37,78,10,27,59,109,168,12,10,67,40,124,84
340,Chris Quinn,PG,23,MIA,42,1,408,48,131,20,57,28,74,25,37,6,24,30,65,15,0,21,32,141
341,Vladimir Radmanović,PF,26,LAL,55,15,986,134,316,40,118,94,198,53,73,53,127,180,66,25,18,69,125,361
342,Shavlik Randolph,PF,23,PHI,13,6,179,23,48,0,0,23,48,12,22,19,35,54,4,7,10,9,23,58
343,Zach Randolph,PF,25,POR,68,67,2425,600,1286,14,48,586,1238,394,481,199,489,688,147,53,15,215,184,1608
344,Theo Ratliff,C,33,BOS,2,2,44,1,3,0,0,1,3,3,4,2,5,7,0,1,3,1,6,5
345,Allan Ray,SG,22,BOS,47,5,710,100,259,48,116,52,143,42,55,18,51,69,43,20,3,42,85,290
346,Michael Redd,SF,27,MIL,53,53,2036,477,1025,117,306,360,719,345,416,42,154,196,124,63,9,122,78,1416
347,J.J. Redick,PG,22,ORL,42,0,622,80,195,38,98,42,97,54,60,10,42,52,36,12,0,21,52,252
348,Justin Reed,PF,25,MIN,41,3,318,40,107,0,0,40,107,26,30,15,31,46,17,5,3,22,44,106
349,Jared Reiner,C,24,MIL,27,2,244,15,43,0,0,15,43,3,10,21,50,71,13,5,6,14,45,33
350,Jason Richardson,SG,26,GSW,51,49,1675,306,734,110,301,196,433,92,140,71,188,259,172,54,32,82,129,814
352,Quentin Richardson,SF,26,NYK,49,47,1621,228,545,97,258,131,287,83,120,65,287,352,108,36,7,70,133,636
353,Luke Ridnour,PG,25,SEA,71,58,2091,301,695,49,139,252,556,128,159,28,136,164,368,83,19,156,181,779
354,Anthony Roberson,PG,23,GSW,20,1,227,44,104,21,55,23,49,2,3,2,19,21,10,12,0,13,27,111
355,Lawrence Roberts,PF,24,MEM,54,18,969,94,208,0,2,94,206,95,131,101,160,261,30,36,13,36,133,283
357,Clifford Robinson,C,40,NJN,50,1,955,81,218,25,66,56,152,16,36,31,91,122,51,12,23,30,98,203
358,Nate Robinson,PG,22,NYK,64,5,1356,227,523,83,213,144,310,108,139,55,97,152,90,50,6,72,160,645
359,Sergio Rodríguez,PG,20,POR,67,1,862,101,239,24,85,77,154,21,26,20,71,91,218,35,2,77,72,247
360,Rajon Rondo,PG,20,BOS,78,25,1831,188,450,6,29,182,421,119,184,74,218,292,297,128,8,137,181,501
361,Jalen Rose,SF,34,PHO,29,0,246,38,86,21,47,17,39,11,12,3,20,23,16,5,2,9,22,108
362,Malik Rose,PF,32,NYK,65,2,810,74,186,2,8,72,178,42,52,47,128,175,65,26,9,65,120,192
363,Quinton Ross,SG,25,LAC,81,43,1700,177,379,2,10,175,369,68,87,60,130,190,86,70,32,33,179,424
364,Brandon Roy,SG,22,POR,57,55,2015,349,765,55,146,294,619,202,241,58,192,250,230,67,10,116,139,955
365,Michael Ruffin,PF,30,WAS,30,0,271,5,18,0,0,5,18,7,19,35,27,62,6,6,8,12,43,17
366,John Salmons,SG,27,SAC,79,19,2135,236,517,40,112,196,405,159,204,47,217,264,254,73,27,119,177,671
367,Jamal Sampson,C,23,DEN,22,3,125,9,14,0,1,9,13,6,14,15,33,48,5,2,7,10,17,24
368,Brian Scalabrine,PF,28,BOS,54,17,1027,77,191,44,110,33,81,18,23,24,81,105,59,23,18,44,130,216
369,Luke Schenscher,C,24,POR,11,0,118,7,23,0,0,7,23,5,7,10,15,25,1,2,4,4,25,19
370,Thabo Sefolosha,SG,22,CHI,71,4,868,109,256,15,42,94,214,23,45,35,118,153,60,33,11,60,100,256
371,Mouhamed Sene,C,20,SEA,28,3,169,18,49,0,0,18,49,17,29,16,29,45,0,3,12,11,33,53
372,Wayne Simien,PF,23,MIA,8,0,93,9,23,0,0,9,23,5,7,5,6,11,4,2,0,3,13,23
373,Cedric Simmons,PF,21,NOK,43,4,534,55,132,0,0,55,132,16,33,44,63,107,12,8,23,22,75,126
374,James Singleton,PF,25,LAC,53,0,376,30,82,3,14,27,68,22,29,36,70,106,17,15,17,17,45,85
375,Brian Skinner,PF,30,MIL,67,44,1523,124,253,0,0,124,253,46,79,106,279,385,58,18,64,75,195,294
376,Uroš Slokar,C,23,TOR,20,0,72,14,26,1,2,13,24,9,13,7,7,14,1,1,2,9,11,38
377,Craig Smith,PF,23,MIN,82,5,1537,246,463,0,6,246,457,116,186,149,267,416,49,51,18,74,223,608
378,J.R. Smith,SG,21,DEN,63,24,1471,284,644,149,382,135,262,102,126,30,113,143,91,49,9,85,147,819
379,Joe Smith,PF,31,TOT,65,11,1503,214,477,0,5,214,472,125,148,120,280,400,49,37,27,76,148,553
380,Josh Smith,SF,21,ATL,72,72,2647,436,993,38,152,398,841,268,387,165,456,621,236,101,207,227,241,1178
381,Steven Smith,PF,23,PHI,8,0,28,2,8,0,0,2,8,1,2,1,5,6,0,1,0,2,4,5
382,Eric Snow,PG,33,CLE,82,45,1929,135,324,0,4,135,320,72,113,35,153,188,330,55,16,111,185,342
383,Kirk Snyder,SF,23,HOU,39,1,563,66,146,11,44,55,102,49,75,17,66,83,39,11,12,26,51,192
384,Darius Songaila,PF,28,WAS,37,1,700,118,225,0,2,118,223,46,54,44,90,134,38,17,10,43,105,282
385,Pape Sow,C,25,TOR,7,0,34,3,9,0,0,3,9,4,6,6,5,11,2,1,1,1,2,10
386,Vassilis Spanoulis,SG,24,HOU,31,0,272,23,72,5,29,18,43,34,42,5,17,22,28,7,1,29,33,85
387,Jerry Stackhouse,SF,32,DAL,67,8,1615,280,654,62,162,218,492,182,215,39,106,145,187,51,10,117,78,804
388,DeShawn Stevenson,SG,25,WAS,82,82,2419,347,753,74,183,273,570,152,216,55,161,216,218,65,19,119,155,920
389,Peja Stojaković,SF,29,NOK,13,13,425,83,196,34,84,49,112,31,38,11,43,54,11,8,4,19,29,231
390,Damon Stoudamire,PG,33,MEM,62,51,1501,171,437,59,175,112,262,66,83,31,108,139,299,47,2,101,95,467
391,Salim Stoudamire,SG,24,ATL,61,0,1034,177,425,56,155,121,270,61,68,6,68,74,61,21,2,55,88,471
392,Amar'e Stoudemire,C,24,PHO,82,78,2689,607,1055,0,3,607,1052,457,585,222,564,786,84,78,110,232,295,1671
393,Mike Sweetney,C,24,CHI,48,0,385,58,134,0,0,58,134,37,66,45,75,120,28,9,11,42,79,153
394,Stromile Swift,C,27,MEM,54,18,1029,161,346,0,5,161,341,97,134,85,165,250,17,30,62,69,146,419
395,Wally Szczerbiak,SF,29,BOS,32,19,900,161,388,44,106,117,282,113,126,16,82,98,55,18,3,54,65,479
396,Donell Taylor,SG,24,WAS,47,1,369,56,140,3,17,53,123,11,21,14,39,53,45,17,3,25,34,126
397,Maurice Taylor,PF,30,SAC,12,2,103,8,28,0,0,8,28,8,13,10,18,28,5,4,1,6,16,24
398,Sebastian Telfair,PG,21,BOS,78,30,1578,176,474,37,128,139,346,90,110,17,91,108,218,43,11,98,166,479
399,Jason Terry,SG,29,DAL,81,80,2846,514,1063,162,370,352,693,160,199,41,190,231,422,81,17,152,170,1350
400,Etan Thomas,C,28,WAS,65,32,1246,159,277,0,0,159,277,77,138,136,241,377,29,22,89,71,162,395
401,Kenny Thomas,PF,29,SAC,62,53,1412,146,303,0,1,146,302,39,76,134,243,377,76,43,16,90,141,331
402,Kurt Thomas,C,34,PHO,67,13,1208,126,259,0,1,126,258,56,71,86,293,379,24,24,29,35,156,308
403,Tim Thomas,PF,29,LAC,76,24,2054,299,723,136,356,163,367,102,144,63,315,378,171,55,28,106,228,836
404,Tyrus Thomas,PF,20,CHI,72,4,966,134,282,0,2,134,280,106,175,89,180,269,40,46,76,94,162,374
405,Dijon Thompson,SF,23,ATL,6,0,50,6,15,0,2,6,13,5,6,3,5,8,2,0,0,1,2,17
406,Jamaal Tinsley,PG,28,IND,72,72,2243,346,889,61,193,285,696,172,239,60,180,240,494,117,25,200,190,925
407,Jake Tsakalidis,C,27,TOT,36,7,390,29,72,0,0,29,72,26,39,42,62,104,5,8,12,24,51,84
408,P.J. Tucker,SF,21,TOR,17,0,83,11,22,0,0,11,22,8,14,11,12,23,3,2,0,6,12,30
409,Ronny Turiaf,C,24,LAL,72,1,1087,147,268,0,1,147,267,89,134,88,171,259,63,17,78,52,202,383
410,Hedo Türkoğlu,SF,27,ORL,73,73,2268,345,823,109,281,236,542,171,219,57,236,293,233,70,16,143,221,970
411,Ime Udoka,SF,29,POR,75,75,2144,237,514,89,219,148,295,66,89,95,184,279,112,71,17,73,207,629
412,Beno Udrih,PG,24,SAS,73,1,948,127,344,33,115,94,229,53,60,11,71,82,122,27,1,56,70,340
413,Anderson Varejão,C,24,CLE,81,6,1932,191,401,0,9,191,392,165,268,191,354,545,75,76,52,67,269,547
414,Jacque Vaughn,PG,31,SAS,64,4,760,71,167,1,2,70,165,49,65,8,60,68,131,24,2,40,74,192
415,Charlie Villanueva,PF,22,MIL,39,17,984,180,383,29,86,151,297,73,89,62,166,228,36,24,12,54,108,462
416,Marcus Vinicius,SF,22,NOK,13,0,103,7,15,3,7,4,8,5,7,2,9,11,5,2,1,6,10,22
417,Jake Voskuhl,C,29,CHA,73,9,1043,121,255,0,0,121,255,77,113,84,172,256,44,30,24,56,199,319
418,Sasha Vujačić,SG,22,LAL,73,4,935,105,268,60,161,45,107,43,49,28,79,107,64,41,1,30,103,313
419,Dwyane Wade,SG,25,MIA,51,50,1931,472,962,21,79,451,883,432,535,51,188,239,384,107,62,216,117,1397
420,Von Wafer,SF,21,LAC,1,0,1,0,1,0,1,0,0,0,0,0,0,0,0,0,0,0,0,0
421,Dajuan Wagner,SG,23,GSW,1,0,7,1,1,1,1,0,0,1,2,0,0,0,1,0,0,1,1,4
422,Antoine Walker,PF,30,MIA,78,15,1818,265,668,84,305,181,363,46,105,92,247,339,130,48,17,141,173,660
423,Ben Wallace,C,32,CHI,77,77,2697,192,424,1,5,191,419,109,267,303,518,821,186,111,156,101,153,494
424,Gerald Wallace,SF,24,CHA,72,71,2640,478,952,39,120,439,832,309,447,142,376,518,185,144,69,160,209,1304
425,Rasheed Wallace,C,32,DET,75,72,2419,357,843,104,296,253,547,108,137,90,453,543,127,75,118,94,225,926
426,Luke Walton,SF,26,LAL,60,60,1982,264,557,48,124,216,433,108,145,87,215,302,257,60,21,118,117,684
427,Hakim Warrick,PF,24,MEM,82,43,2152,373,712,0,8,373,704,299,388,130,290,420,75,43,30,161,232,1045
428,Earl Watson,PG,27,SEA,77,25,2152,263,687,92,280,171,407,108,147,34,151,185,437,99,23,167,152,726
429,Chris Webber,PF,33,TOT,61,60,1821,289,639,4,11,285,628,102,160,124,313,437,188,60,41,107,143,684
430,Martell Webster,SF,20,POR,82,27,1759,195,492,91,250,104,242,93,132,43,197,240,52,35,19,76,126,574
431,Bonzi Wells,SF,30,HOU,28,1,590,85,207,1,7,84,200,46,82,26,94,120,31,24,13,57,62,217
432,David Wesley,SG,36,CLE,35,5,352,22,75,9,38,13,37,20,28,3,32,35,37,12,4,17,32,73
433,David West,PF,26,NOK,52,52,1900,377,792,8,25,369,767,187,227,126,298,424,114,42,38,98,143,949
434,Delonte West,SG,23,BOS,69,47,2219,306,717,65,178,241,539,168,197,32,176,208,304,74,34,140,152,845
435,James White,SG,24,SAS,6,2,137,18,41,2,7,16,34,12,15,3,17,20,5,3,1,5,7,50
436,Chris Wilcox,PF,24,SEA,82,81,2586,433,819,0,6,433,813,240,351,178,451,629,82,70,38,127,248,1106
437,Damien Wilkins,SF,27,SEA,82,31,2037,262,602,50,122,212,480,150,170,87,142,229,156,92,16,116,157,724
438,Mike Wilks,PG,27,SEA,47,4,534,66,141,5,15,61,126,33,42,15,39,54,79,15,4,31,53,170
439,Aaron Williams,PF,35,LAC,38,7,374,29,53,0,1,29,52,18,22,27,58,85,7,7,14,18,56,76
440,Alvin Williams,PG,32,LAC,2,0,10,0,2,0,1,0,1,2,4,1,0,1,3,2,0,3,0,2
441,Deron Williams,PG,22,UTA,80,80,2950,494,1083,82,255,412,828,227,296,41,226,267,745,78,13,246,254,1297
442,Eric Williams,SF,34,TOT,21,0,121,19,47,8,19,11,28,8,14,3,14,17,7,3,0,7,12,54
443,Jason Williams,PG,31,MIA,61,55,1865,235,569,100,295,135,274,94,103,18,123,141,322,58,1,100,68,664
444,Justin Williams,C,22,SAC,26,1,333,54,88,0,1,54,87,23,63,51,64,115,2,5,16,15,51,131
445,Lou Williams,PG,20,PHI,61,0,688,93,211,12,37,81,174,64,92,17,53,70,110,22,1,46,42,262
446,Marcus Williams,PG,21,NJN,79,2,1315,208,526,46,163,162,363,72,85,29,134,163,260,29,2,142,96,534
447,Marvin Williams,PF,20,ATL,64,63,2179,306,706,11,45,295,661,216,265,84,253,337,121,52,30,127,191,839
448,Mo Williams,PG,24,MIL,68,68,2472,468,1049,79,228,389,821,159,186,54,275,329,416,85,6,203,201,1174
449,Shammond Williams,PG,31,LAL,30,0,345,35,86,20,50,15,36,4,6,11,29,40,31,12,0,13,20,94
450,Shawne Williams,SG,20,IND,46,3,556,75,160,19,52,56,108,11,20,33,50,83,22,6,8,24,69,180
451,Shelden Williams,PF,23,ATL,81,31,1514,166,365,2,4,164,361,110,144,131,304,435,44,52,39,96,199,444
452,Corliss Williamson,PF,33,SAC,68,1,1337,236,463,0,2,236,461,148,207,63,158,221,39,29,15,97,183,620
453,Kevin Willis,PF,44,DAL,5,0,43,5,13,0,0,5,13,2,2,2,6,8,1,2,1,2,11,12
454,Metta World Peace,SF,27,SAC,70,65,2641,458,1040,93,260,365,780,307,415,102,352,454,235,149,43,146,205,1316
455,Antoine Wright,SG,22,NJN,63,23,1137,110,251,19,59,91,192,44,73,38,137,175,55,30,10,43,120,283
456,Bracey Wright,SG,22,MIN,19,0,190,24,60,6,20,18,40,13,18,7,14,21,15,9,1,6,6,67
457,Dorell Wright,SF,21,MIA,66,19,1292,162,364,5,34,157,330,64,86,40,232,272,95,41,46,65,112,393
458,Lorenzen Wright,C,31,ATL,67,31,1035,82,183,0,0,82,183,9,32,85,131,216,40,28,28,39,204,173
1,Shareef Abdur-Rahim,PF,31,SAC,6,0,51,3,14,0,0,3,14,4,4,6,4,10,4,1,0,1,9,10
2,Arron Afflalo,SG,22,DET,75,9,970,99,241,10,48,89,193,68,87,36,101,137,52,31,8,34,83,276
3,Maurice Ager,SG,23,TOT,26,3,165,21,65,3,19,18,46,6,12,4,9,13,8,0,1,6,17,51
4,Blake Ahearn,PG,23,MIA,12,0,177,15,57,10,34,5,23,30,31,1,18,19,19,6,0,16,20,70
5,LaMarcus Aldridge,PF,22,POR,76,76,2649,561,1160,1,7,560,1153,227,298,220,358,578,122,55,94,126,240,1350
6,Malik Allen,PF,29,TOT,73,16,1096,157,327,1,2,156,325,23,25,66,130,196,44,19,31,45,149,338
7,Ray Allen*,SG,32,BOS,73,73,2624,439,986,180,452,259,534,215,237,75,193,268,225,65,16,127,147,1273
8,Tony Allen,SG,26,BOS,75,11,1373,169,389,18,57,151,332,138,181,34,134,168,114,62,21,109,168,494
9,Lance Allred,C,26,CLE,3,0,10,1,4,0,0,1,4,1,2,0,1,1,0,0,0,0,1,3
10,Morris Almond,SG,22,UTA,9,0,39,4,15,1,4,3,11,4,6,0,2,2,3,1,0,2,5,13
11,Rafer Alston,PG,31,HOU,74,74,2526,364,924,143,407,221,517,98,137,28,232,260,392,98,18,160,139,969
12,Lou Amundson,PF,25,PHI,16,0,64,8,16,0,0,8,16,2,7,7,5,12,0,1,1,2,13,18
13,Chris Andersen,C,29,NOH,5,0,34,2,7,0,0,2,7,2,4,2,7,9,0,0,4,1,6,6
14,Derek Anderson,SG,33,CHA,28,0,396,47,125,19,52,28,73,28,38,9,43,52,44,12,1,25,49,141
15,Carmelo Anthony,SF,23,DEN,77,77,2806,728,1481,58,164,670,1317,464,590,178,393,571,259,98,39,253,253,1978
16,Joel Anthony,PF,25,MIA,24,1,498,28,60,0,0,28,60,29,49,38,55,93,3,9,31,17,55,85
17,Gilbert Arenas,PG,26,WAS,13,8,425,78,196,22,78,56,118,74,96,6,45,51,66,23,1,49,30,252
18,Trevor Ariza,SF,22,TOT,35,3,546,69,136,5,18,64,118,49,75,30,78,108,44,31,11,23,45,192
19,Darrell Armstrong,PG,39,NJN,50,2,549,40,110,23,69,17,41,20,30,17,50,67,73,28,2,41,53,123
20,Hilton Armstrong,C,23,NOH,65,3,732,67,148,0,0,67,148,44,70,65,98,163,23,15,34,59,130,178
21,Carlos Arroyo,PG,28,ORL,62,20,1269,157,348,29,84,128,264,87,102,10,103,113,219,26,2,77,85,430
22,Chucky Atkins,SG,33,DEN,24,0,352,42,122,25,79,17,43,4,9,3,28,31,47,9,1,10,27,113
23,James Augustine,PF,23,ORL,25,0,149,18,34,0,0,18,34,4,8,16,14,30,2,5,2,6,18,40
24,Kelenna Azubuike,SG,24,GSW,81,17,1732,261,587,71,195,190,392,99,138,107,217,324,75,45,34,58,159,692
25,Renaldo Balkman,SF,23,NYK,65,0,952,91,186,1,12,90,174,41,95,83,133,216,40,44,30,37,132,224
26,Marcus Banks,PG,26,TOT,36,3,569,86,191,40,102,46,89,27,35,4,41,45,61,14,13,37,65,239
27,Leandro Barbosa,SG,25,PHO,82,12,2421,472,1021,164,422,308,599,175,213,40,191,231,216,75,18,117,195,1283
28,J.J. Barea,PG,23,DAL,44,9,460,71,170,21,54,50,116,28,35,4,43,47,58,14,1,35,48,191
29,Andrea Bargnani,PF,22,TOR,78,53,1861,280,725,90,261,190,464,142,169,50,238,288,89,23,37,88,211,792
30,Matt Barnes,PF,27,GSW,73,18,1414,187,442,53,181,134,261,59,79,94,230,324,139,48,36,85,159,486
31,Andre Barrett,PG,25,LAC,4,0,25,2,5,1,3,1,2,1,2,0,1,1,7,0,0,1,1,6
32,Earl Barron,C,26,MIA,46,15,889,132,327,1,13,131,314,61,87,67,131,198,29,19,8,48,114,326
33,Brent Barry,SF,36,SAS,31,1,554,77,160,48,112,29,48,19,20,12,43,55,54,17,3,18,43,221
34,Brandon Bass,C,22,DAL,79,1,1557,246,493,0,4,246,489,162,197,120,227,347,58,22,48,82,150,654
35,Maceo Baston,PF,32,TOR,15,2,103,17,25,0,0,17,25,7,10,9,17,26,3,2,4,4,20,41
36,Shane Battier,SF,29,HOU,80,78,2907,265,619,139,369,126,250,75,101,131,276,407,155,77,90,78,196,744
37,Marco Belinelli,SG,21,GSW,33,0,241,36,93,16,41,20,52,7,9,3,11,14,15,5,0,12,15,95
38,Charlie Bell,SG,28,MIL,68,5,1628,185,486,74,217,111,269,70,87,31,136,167,210,52,2,76,121,514
39,Raja Bell,SG,31,PHO,75,75,2646,317,753,176,439,141,314,79,91,47,227,274,168,54,27,65,220,889
40,Mike Bibby,PG,29,TOT,48,44,1573,248,603,93,248,155,355,78,100,16,144,160,290,54,4,119,97,667
41,Andris Biedriņš,C,21,GSW,76,59,2078,340,543,0,0,340,543,116,187,256,488,744,75,56,94,85,262,796
42,Chauncey Billups,PG,31,DET,78,78,2522,393,877,137,342,256,535,401,437,42,170,212,529,101,17,160,130,1324
43,Steve Blake,PG,27,POR,81,78,2424,261,640,121,298,140,342,49,64,31,164,195,413,55,4,113,133,692
44,Andray Blatche,PF,21,WAS,82,15,1675,254,536,3,13,251,523,107,154,164,261,425,92,53,114,112,258,618
45,Mark Blount,C,32,MIA,69,46,1542,238,515,17,44,221,471,88,138,69,194,263,41,33,34,70,133,581
46,Keith Bogans,SG,27,ORL,82,35,2198,241,588,148,409,93,179,81,110,42,224,266,104,59,10,53,164,711
47,Andrew Bogut,C,23,MIL,78,78,2720,465,910,0,7,465,903,189,322,245,518,763,199,64,135,172,254,1119
48,Matt Bonner,PF,27,SAS,68,3,853,121,291,46,137,75,154,38,44,53,139,192,32,14,17,39,111,326
49,Josh Boone,PF,23,NJN,70,53,1773,238,434,0,0,238,434,99,217,192,317,509,55,36,61,68,155,575
50,Calvin Booth,C,31,PHI,31,0,204,9,27,0,0,9,27,6,10,6,32,38,8,6,18,4,35,24
51,Carlos Boozer,PF,26,UTA,81,81,2827,709,1297,0,1,709,1296,290,393,197,647,844,233,100,41,210,293,1708
52,Chris Bosh,C,23,TOR,67,67,2425,507,1027,10,25,497,1002,472,559,174,409,583,171,63,67,153,157,1496
53,Bruce Bowen,SF,36,SAS,81,81,2448,174,428,90,215,84,213,45,69,33,201,234,91,54,22,46,177,483
54,Ryan Bowen,SF,32,NOH,53,4,660,49,100,0,1,49,99,16,29,55,45,100,25,32,11,15,77,114
55,Earl Boykins,PG,31,CHA,36,0,577,61,172,14,44,47,128,49,59,9,25,34,96,13,0,41,21,185
56,Elton Brand,PF,28,LAC,8,6,274,52,114,0,0,52,114,37,47,21,43,64,16,3,15,17,21,141
57,Corey Brewer,SF,21,MIN,79,35,1803,182,486,7,36,175,450,88,110,82,210,292,111,76,25,89,188,459
58,Ronnie Brewer,SG,22,UTA,76,76,2088,354,634,11,50,343,584,195,257,97,121,218,134,129,19,69,110,914
59,Primož Brezec,C,28,TOT,50,18,475,44,94,0,0,44,94,24,40,30,51,81,11,3,7,24,83,112
60,Aaron Brooks,PG,23,HOU,51,0,608,93,225,36,109,57,116,42,49,13,43,56,87,13,5,44,69,264
61,Andre Brown,PF,26,MEM,33,1,286,39,78,0,0,39,78,22,49,37,55,92,8,7,4,14,38,100
62,Devin Brown,SG,29,CLE,78,20,1762,217,531,45,146,172,385,107,142,65,198,263,175,52,7,99,144,586
63,Kwame Brown,C,25,TOT,38,15,713,72,142,0,0,72,142,40,98,51,137,188,45,22,23,51,82,184
64,P.J. Brown,PF,38,BOS,18,0,209,14,41,0,1,14,40,11,16,29,39,68,10,5,8,10,29,39
65,Shannon Brown,SG,22,TOT,21,4,240,44,126,9,30,35,96,17,29,6,14,20,17,11,3,24,29,114
66,Kobe Bryant,SG,29,LAL,82,82,3192,775,1690,150,415,625,1275,623,742,94,423,517,441,151,40,257,227,2323
67,Greg Buckner,SG,31,MIN,31,4,520,45,117,15,50,30,67,19,22,10,55,65,39,21,2,29,63,124
68,Caron Butler,SF,27,WAS,58,58,2314,439,943,66,185,373,758,236,262,93,295,388,284,128,20,150,160,1180
69,Rasual Butler,SF,28,NOH,51,8,875,91,260,44,133,47,127,26,31,16,84,100,36,15,21,10,66,252
70,Andrew Bynum,C,20,LAL,35,25,1008,189,297,0,0,189,297,82,118,105,251,356,61,12,72,52,98,460
71,José Calderón,PG,26,TOR,82,56,2484,367,707,79,184,288,523,109,120,34,202,236,678,87,6,126,134,922
72,Marcus Camby,C,33,DEN,79,79,2758,286,635,6,20,280,615,143,202,230,807,1037,259,85,285,118,216,721
73,Brian Cardinal,PF,30,MEM,37,1,440,43,126,25,81,18,45,13,19,26,70,96,22,10,2,23,62,124
74,Rodney Carney,SF,23,PHI,70,6,1039,158,392,38,120,120,272,55,81,50,99,149,32,39,23,34,96,409
75,Matt Carroll,SG,27,CHA,80,18,2016,252,589,105,241,147,348,111,138,33,193,226,73,46,19,58,187,720
76,Anthony Carter,PG,32,DEN,70,67,1960,218,476,45,129,173,347,64,85,27,173,200,388,107,28,124,172,545
77,Vince Carter,SG,31,NJN,76,72,2959,587,1287,98,273,489,1014,350,429,112,341,453,389,93,33,181,241,1622
78,Sam Cassell,PG,38,TOT,55,34,1274,233,532,23,76,210,456,127,144,17,119,136,214,37,6,97,98,616
79,Tyson Chandler,C,25,NOH,79,79,2783,377,605,0,1,377,604,175,295,322,606,928,81,45,84,136,243,929
80,Wilson Chandler,SF,20,NYK,35,16,685,106,242,9,30,97,212,34,54,38,89,127,33,15,16,27,83,255
81,Josh Childress,SF,24,ATL,76,0,2274,327,573,22,60,305,513,222,275,174,199,373,117,71,43,98,129,898
82,Jarron Collins,C,29,UTA,70,9,702,36,82,0,1,36,81,46,74,40,76,116,37,10,6,22,106,118
83,Jason Collins,C,29,TOT,74,26,1172,53,113,0,1,53,112,34,74,64,114,178,25,23,25,48,194,140
84,Mardy Collins,SG,23,NYK,46,8,634,57,175,8,32,49,143,23,38,19,56,75,89,24,8,56,56,145
85,Nick Collison,PF,27,SEA,78,35,2223,322,641,0,2,322,639,123,167,254,476,730,113,47,60,118,250,767
86,Mike Conley,PG,20,MEM,53,46,1381,189,442,30,91,159,351,90,123,21,118,139,222,44,2,89,85,498
87,Brian Cook,PF,27,TOT,51,2,629,88,234,43,115,45,119,19,21,28,81,109,27,13,12,39,93,238
88,Daequan Cook,SG,20,MIA,59,19,1441,196,514,79,238,117,276,47,57,20,157,177,75,23,9,63,157,518
89,Jamal Crawford,SG,27,NYK,80,80,3190,570,1391,176,494,394,897,329,381,37,170,207,398,81,17,192,144,1645
90,Javaris Crittenton,SG,20,TOT,50,0,679,98,233,10,37,88,196,72,104,27,83,110,51,19,2,55,47,278
91,Austin Croshere,PF,32,GSW,44,0,457,61,137,22,61,39,76,29,32,33,71,104,30,8,6,22,60,173
92,Eddy Curry,C,25,NYK,59,58,1530,297,544,0,0,297,544,187,300,111,164,275,32,14,29,126,157,781
93,Samuel Dalembert,C,26,PHI,82,82,2724,339,661,0,1,339,660,186,263,304,545,849,45,40,192,155,269,864
94,Erick Dampier,C,32,DAL,72,64,1755,178,277,0,0,178,277,84,146,207,332,539,63,24,106,80,226,440
95,Antonio Daniels,PG,32,WAS,71,63,2161,205,447,17,74,188,373,170,219,23,180,203,340,69,2,91,78,597
96,Marquis Daniels,SG,27,IND,74,1,1546,241,561,27,102,214,459,97,139,66,146,212,137,79,18,112,121,606
97,Jermareo Davidson,SF,23,CHA,38,2,322,51,125,0,0,51,125,18,28,21,41,62,13,7,15,17,46,120
98,Baron Davis,PG,28,GSW,82,82,3196,650,1526,173,525,477,1001,318,424,96,289,385,623,191,43,232,247,1791
99,Glen Davis,C,22,BOS,69,1,940,107,221,0,0,107,221,99,150,95,113,208,28,31,20,65,160,313
100,Paul Davis,PF,23,LAC,22,1,194,24,65,0,0,24,65,6,10,25,22,47,10,6,6,9,33,54
101,Ricky Davis,SF,28,MIA,82,47,2963,420,971,135,333,285,638,155,197,55,298,353,276,87,14,191,187,1130
102,Carlos Delfino,SG,25,TOR,82,0,1928,251,632,120,314,131,318,116,156,66,293,359,145,69,11,75,177,738
103,Luol Deng,SF,22,CHI,63,59,2128,429,896,8,22,421,874,204,265,136,258,394,155,57,29,120,117,1070
104,Boris Diaw,PF,25,PHO,82,19,2308,308,646,13,41,295,605,96,129,97,281,378,317,61,39,155,166,725
105,Yakhouba Diawara,SG,25,DEN,54,14,542,55,134,21,66,34,68,22,31,23,39,62,37,8,3,16,61,153
106,Guillermo Díaz,SG,22,LAC,6,0,18,1,4,0,1,1,3,3,5,2,0,2,1,0,0,0,0,5
107,Dan Dickau,PG,29,LAC,67,8,1040,124,296,36,108,88,188,68,82,13,84,97,172,32,3,55,108,352
108,Kaniel Dickens,PF,29,CLE,5,0,12,1,3,0,0,1,3,0,0,0,1,1,1,0,1,0,1,2
109,Travis Diener,PG,25,IND,66,21,1356,159,430,74,233,85,197,64,71,26,89,115,251,35,4,55,107,456
110,Ike Diogu,PF,24,IND,30,1,305,64,134,0,0,64,134,40,47,38,47,85,10,7,3,20,43,168
111,DeSagana Diop,C,26,TOT,79,23,1295,94,180,0,0,94,180,38,70,160,232,392,40,26,88,58,146,226
112,Juan Dixon,PG,29,TOT,53,0,668,106,258,30,72,76,186,21,26,15,60,75,97,21,2,54,62,263
113,Michael Doleac,C,30,MIN,24,8,257,28,63,0,0,28,63,1,2,16,33,49,7,10,10,12,44,57
114,Keyon Dooling,PG,27,ORL,72,1,1334,198,423,22,65,176,358,163,193,7,94,101,133,36,5,61,131,581
115,Quincy Douby,PG,23,SAC,74,0,876,132,335,42,122,90,213,48,52,17,66,83,53,30,12,59,80,354
116,Jared Dudley,PF,22,CHA,73,14,1384,163,348,9,41,154,307,87,118,121,165,286,81,55,10,50,128,422
117,Chris Duhon,PG,25,CHI,66,18,1490,133,344,54,155,79,189,65,80,19,97,116,263,48,2,71,92,385
118,Tim Duncan,C,31,SAS,78,78,2651,585,1178,0,4,585,1174,338,463,237,644,881,218,56,152,178,185,1508
119,Mike Dunleavy,SG,27,IND,82,82,2953,532,1117,165,389,367,728,336,403,59,365,424,288,86,31,190,208,1565
120,Ronald Dupree,SF,27,TOT,5,0,21,1,3,0,0,1,3,2,2,1,7,8,1,1,0,0,0,4
121,Kevin Durant,SG,19,SEA,80,80,2768,587,1366,59,205,528,1161,391,448,70,278,348,192,78,75,232,122,1624
122,Monta Ellis,SG,22,GSW,81,72,3071,652,1227,12,52,640,1175,320,417,133,271,404,315,124,27,173,195,1636
123,Francisco Elson,C,31,TOT,63,5,813,92,236,0,1,92,235,26,37,50,150,200,24,15,20,47,96,210
124,Melvin Ely,C,29,NOH,52,1,621,85,180,0,0,85,180,32,58,28,117,145,22,7,18,42,79,202
125,Maurice Evans,SG,29,TOT,75,47,1720,262,545,81,209,181,336,59,83,92,126,218,81,46,10,40,142,664
126,Reggie Evans,PF,27,PHI,81,61,1879,152,346,1,1,151,345,120,257,224,387,611,65,86,8,108,213,425
127,Jordan Farmar,PG,21,LAL,82,0,1690,291,631,114,307,177,324,53,78,39,144,183,225,77,5,108,105,749
128,Nick Fazekas,PF,22,TOT,26,0,269,46,82,0,2,46,80,15,22,34,55,89,11,8,11,13,25,107
129,Raymond Felton,PG,23,CHA,79,79,2972,412,997,56,200,356,797,260,325,37,199,236,583,96,12,213,184,1140
130,Kyrylo Fesenko,C,21,UTA,9,0,70,6,16,0,0,6,16,2,4,14,11,25,2,0,3,8,19,14
131,Michael Finley,SG,34,SAS,82,61,2204,315,761,132,357,183,404,64,80,27,227,254,114,29,10,56,93,826
132,Derek Fisher,PG,33,LAL,82,82,2249,339,777,112,276,227,501,166,188,24,146,170,239,86,3,90,188,956
133,T.J. Ford,PG,24,TOR,51,26,1199,246,524,15,51,231,473,110,125,23,77,100,313,54,0,102,93,617
134,Jeff Foster,C,31,IND,77,52,1884,205,373,0,3,205,370,86,145,264,404,668,129,56,32,62,221,496
135,Randy Foye,PG,24,MIN,39,31,1259,198,462,61,148,137,314,53,65,13,115,128,164,36,3,79,102,510
136,Adonal Foyle,C,32,ORL,82,0,774,70,153,0,0,70,153,16,34,71,137,208,18,16,45,32,94,156
137,Richie Frahm,SG,30,LAC,10,2,163,20,54,7,25,13,29,0,2,4,10,14,8,2,0,6,7,47
138,Steve Francis,PG,30,HOU,10,3,199,19,57,4,17,15,40,13,23,8,15,23,30,9,5,14,25,55
139,Channing Frye,C,24,POR,78,20,1342,221,453,3,10,218,443,85,109,107,247,354,57,29,27,55,208,530
140,Dan Gadzuric,C,29,MIL,51,4,534,64,154,0,1,64,153,33,63,67,77,144,11,20,24,34,83,161
141,Jorge Garbajosa,PF,30,TOR,7,0,74,8,25,6,16,2,9,0,0,2,13,15,3,3,0,1,2,22
142,Francisco García,SF,26,SAC,79,20,2096,348,752,113,289,235,463,162,208,52,212,264,128,96,50,128,232,971
143,Thomas Gardner,SG,22,CHI,4,0,45,9,23,3,12,6,11,0,2,3,1,4,1,0,0,4,4,21
144,Kevin Garnett,PF,31,BOS,71,71,2328,534,990,0,11,534,979,269,336,135,520,655,244,100,89,138,163,1337
145,Pat Garrity,PF,31,ORL,31,0,284,27,80,8,37,19,43,4,5,9,35,44,13,6,1,17,35,66
146,Pau Gasol,C,27,TOT,66,66,2351,475,890,4,16,471,874,292,362,155,398,553,211,30,98,124,139,1246
147,Rudy Gay,SF,21,MEM,81,81,3000,625,1355,134,387,491,968,248,316,140,359,499,158,111,79,190,230,1632
148,Mickaël Gelabale,SG,24,SEA,39,0,465,69,157,16,37,53,120,14,18,16,42,58,33,10,9,27,31,168
149,Devean George,SF,30,DAL,53,4,821,74,207,22,68,52,139,24,34,28,109,137,35,19,13,24,90,194
150,Daniel Gibson,PG,21,CLE,58,26,1765,201,465,118,268,83,197,85,105,30,104,134,145,47,14,76,163,605
151,Eddie Gill,PG,29,TOT,14,1,154,12,31,5,15,7,16,9,9,1,21,22,22,7,2,9,18,38
152,Manu Ginóbili,SG,30,SAS,74,23,2299,453,984,156,389,297,595,380,442,63,291,354,332,109,33,200,173,1442
153,Gordan Giriček,SG,30,TOT,56,0,831,133,302,36,99,97,203,23,26,16,80,96,62,24,4,52,82,325
154,Ryan Gomes,PF,25,MIN,82,74,2434,392,857,59,179,333,678,190,229,133,342,475,145,65,10,96,154,1033
155,Drew Gooden,PF,26,TOT,69,65,2122,332,740,0,6,332,734,162,215,175,415,590,81,48,53,122,203,826
156,Ben Gordon,SG,24,CHI,72,27,2291,464,1069,142,346,322,723,266,293,40,181,221,213,55,8,150,171,1336
157,Marcin Gortat,C,23,ORL,6,0,41,8,17,0,0,8,17,2,3,8,8,16,2,1,1,2,4,18
158,Joey Graham,SF,25,TOR,38,3,331,49,113,2,3,47,110,38,45,18,49,67,15,3,0,23,47,138
159,Stephen Graham,SF,25,IND,22,0,128,34,58,7,14,27,44,12,16,4,18,22,9,4,1,10,14,87
160,Danny Granger,SF,24,IND,80,80,2876,537,1205,171,423,366,782,322,378,93,393,486,166,95,84,171,290,1567
161,Aaron Gray,C,23,CHI,61,1,613,103,204,0,1,103,203,56,99,70,98,168,41,21,16,57,117,262
162,Gerald Green,SF,22,TOT,30,0,362,52,151,15,39,37,112,34,41,13,51,64,29,8,4,32,45,153
163,Jeff Green,SF,21,SEA,80,52,2253,320,749,21,76,299,673,177,238,101,278,379,119,46,49,158,198,838
165,Willie Green,SG,26,PHI,74,74,1970,379,870,51,179,328,691,112,148,32,150,182,151,54,22,109,119,921
166,Orien Greene,SG,25,SAC,7,2,61,3,11,0,1,3,10,0,0,0,6,6,3,3,1,7,9,6
168,Richard Hamilton,SG,29,DET,72,72,2424,499,1030,62,141,437,889,184,221,75,160,235,299,73,10,132,171,1244
169,Anfernee Hardaway,SF,36,MIA,16,8,325,22,60,8,19,14,41,8,9,3,32,35,35,19,1,13,24,60
170,Matt Harpring,SF,31,UTA,76,0,1374,237,474,2,10,235,464,146,205,96,144,240,82,45,14,95,162,622
171,Al Harrington,C,27,GSW,81,59,2190,401,923,153,408,248,515,147,190,107,332,439,132,74,16,90,266,1102
172,Othella Harrington,C,34,CHA,22,0,166,18,42,0,0,18,42,10,16,11,31,42,4,1,4,11,34,46
173,Devin Harris,PG,24,TOT,64,61,2022,321,693,56,167,265,526,248,301,28,145,173,369,90,10,161,190,946
174,Mike Harris,PF,24,HOU,17,0,159,27,54,0,2,27,52,8,13,24,30,54,3,6,3,9,16,62
175,David Harrison,C,25,IND,55,0,702,90,170,0,0,90,170,49,96,43,75,118,14,20,59,58,164,229
176,Jason Hart,PG,29,UTA,57,0,606,58,180,11,31,47,149,38,45,5,50,55,86,30,3,28,75,165
177,Udonis Haslem,PF,27,MIA,49,48,1805,237,507,0,0,237,507,115,142,107,336,443,68,39,18,67,145,589
178,Trenton Hassell,SG,28,TOT,63,6,773,57,135,2,9,55,126,7,10,20,63,83,41,13,3,22,90,123
179,Spencer Hawes,C,19,SAC,71,8,931,146,318,4,21,142,297,38,58,68,162,230,44,14,40,56,128,334
180,Chuck Hayes,PF,24,HOU,79,44,1575,113,221,0,3,113,218,11,24,132,295,427,91,85,43,62,212,237
181,Jarvis Hayes,SF,26,DET,82,1,1287,217,504,73,194,144,310,45,60,35,143,178,62,47,6,47,137,552
182,Brendan Haywood,C,28,WAS,80,80,2228,316,599,0,0,316,599,216,294,273,303,576,71,31,133,108,216,848
183,Luther Head,SG,25,HOU,73,17,1379,206,477,79,225,127,252,66,81,18,117,135,138,44,9,70,75,557
184,Walter Herrmann,PF,28,TOT,45,0,373,56,144,20,64,36,80,21,25,22,51,73,18,7,1,12,24,153
185,Nenê Hilário,PF,25,DEN,16,1,266,29,71,0,1,29,70,27,49,30,57,87,15,9,14,21,46,85
186,Grant Hill*,SF,35,PHO,70,68,2222,358,712,33,104,325,608,170,196,74,279,353,203,65,56,96,153,919
187,Kirk Hinrich,PG,27,CHI,75,72,2380,330,797,84,240,246,557,118,142,28,216,244,452,87,19,157,224,862
188,Ryan Hollins,PF,23,CHA,60,1,532,46,94,0,0,46,94,55,82,53,54,107,14,10,30,25,96,147
189,Al Horford,C,21,ATL,81,77,2540,333,668,0,5,333,663,155,212,248,537,785,124,60,76,137,267,821
190,Robert Horry,PF,37,SAS,45,5,583,38,119,18,70,20,49,18,28,35,74,109,47,21,19,22,55,112
191,Eddie House,PG,29,BOS,78,2,1480,217,531,117,298,100,233,33,36,19,148,167,152,59,10,76,114,584
192,Dwight Howard,C,22,ORL,82,82,3088,583,974,0,4,583,970,529,897,279,882,1161,110,74,176,263,274,1695
193,Josh Howard,SF,27,DAL,76,76,2757,567,1247,67,210,500,1037,312,384,120,412,532,164,59,32,114,202,1513
194,Juwan Howard,PF,34,DAL,50,0,353,23,64,0,0,23,64,11,14,21,60,81,17,5,2,17,62,57
195,Troy Hudson,PG,31,GSW,9,0,93,9,31,4,12,5,19,6,6,0,7,7,9,3,0,7,4,28
197,Kris Humphries,PF,22,TOR,70,0,925,161,333,0,2,161,331,75,124,90,169,259,28,25,28,47,107,397
198,Lindsey Hunter,PG,37,DET,24,0,215,22,64,7,26,15,38,7,9,4,9,13,33,13,2,13,30,58
199,Steven Hunter,C,26,DEN,19,2,120,15,28,0,0,15,28,9,20,10,19,29,0,0,6,7,20,39
200,Andre Iguodala,SF,24,PHI,82,82,3242,582,1277,101,307,481,970,365,506,85,361,446,391,171,49,214,187,1630
201,Zydrunas Ilgauskas,C,32,CLE,73,73,2222,417,879,0,1,417,878,195,243,263,419,682,104,34,120,135,247,1029
202,Didier Ilunga-Mbenga,C,27,TOT,42,0,326,39,84,0,0,39,84,5,12,28,44,72,10,7,26,12,70,83
203,Allen Iverson*,SG,32,DEN,82,82,3424,712,1556,95,275,617,1281,645,797,47,196,243,586,160,12,245,109,2164
204,Royal Ivey,PG,26,MIL,75,20,1437,149,378,35,107,114,271,85,117,38,80,118,160,45,7,75,166,418
205,Jarrett Jack,SG,24,POR,82,16,2229,267,620,65,190,202,430,215,248,31,203,234,313,61,1,178,129,814
207,Luke Jackson,SF,26,MIA,14,1,228,26,80,11,30,15,50,16,23,7,26,33,17,8,0,9,22,79
208,Stephen Jackson,SF,29,GSW,73,73,2855,488,1204,182,501,306,703,308,370,67,251,318,300,92,29,197,171,1466
209,Casey Jacobsen,SG,26,MEM,53,0,547,39,115,16,72,23,43,13,17,12,53,65,20,5,1,16,34,107
210,Jerome James,C,32,NYK,2,0,5,1,1,0,0,1,1,2,2,0,3,3,0,0,0,0,0,4
211,LeBron James,SF,23,CLE,75,74,3027,794,1642,113,359,681,1283,549,771,133,459,592,539,138,81,255,165,2250
212,Mike James,PG,32,TOT,54,1,720,101,290,31,97,70,193,39,48,14,55,69,60,21,2,36,56,272
213,Antawn Jamison,PF,31,WAS,79,79,3061,618,1417,120,354,498,1063,333,438,215,591,806,120,106,34,113,195,1689
214,Marko Jarić,SG,29,MIN,75,56,2189,227,528,46,127,181,401,121,163,38,184,222,311,97,32,128,180,621
215,Al Jefferson,C,23,MIN,82,82,2919,721,1441,0,5,721,1436,284,394,308,603,911,117,74,119,167,222,1726
216,Richard Jefferson,SF,27,NJN,82,82,3200,619,1328,77,213,542,1115,542,679,93,249,342,252,76,21,199,225,1857
217,Jared Jeffries,SF,26,NYK,73,19,1325,108,270,4,25,104,245,49,93,118,125,243,66,36,23,64,132,269
218,Yi Jianlian,PF,20,MIL,66,49,1647,219,520,6,21,213,499,122,145,106,238,344,55,36,56,90,153,566
219,Alexander Johnson,PF,24,MIA,43,6,549,61,125,0,0,61,125,57,83,32,62,94,13,13,10,42,80,179
220,Amir Johnson,PF,20,DET,62,0,764,92,165,0,0,92,165,37,55,87,148,235,29,24,82,39,141,221
221,Anthony Johnson,PG,33,TOT,69,52,1531,155,355,42,93,113,262,35,43,22,115,137,262,52,9,84,115,387
222,DerMarr Johnson,SF,27,SAS,5,0,28,7,14,3,9,4,5,0,2,0,1,1,1,1,0,0,4,17
223,Joe Johnson,SG,26,ATL,82,82,3343,647,1497,169,444,478,1053,316,379,83,284,367,474,84,18,223,168,1779
224,Linton Johnson,PF,27,TOT,8,0,63,9,19,1,3,8,16,2,2,5,9,14,4,0,1,5,11,21
225,Bobby Jones,SF,24,TOT,47,2,531,60,140,18,53,42,87,40,51,29,63,92,28,15,3,28,85,178
226,Dahntay Jones,SG,27,SAC,25,0,206,23,53,1,6,22,47,34,51,7,28,35,12,8,6,10,28,81
227,Damon Jones,SG,31,CLE,67,3,1336,151,363,115,276,36,87,20,28,5,67,72,126,19,1,36,66,437
228,Dwayne Jones,PF,24,CLE,56,0,472,25,47,0,1,25,46,28,58,69,71,140,10,10,25,17,88,78
229,Eddie Jones,SG,36,DAL,47,33,922,66,180,34,116,32,64,10,14,18,114,132,69,26,8,29,72,176
230,Fred Jones,SG,28,NYK,70,26,1757,182,432,74,192,108,240,94,126,30,140,170,166,48,18,78,140,532
231,James Jones,SF,27,POR,58,3,1276,143,327,91,205,52,122,86,98,43,118,161,34,24,15,28,96,463
232,Solomon Jones,PF,23,ATL,35,0,145,12,30,0,2,12,28,11,20,19,23,42,0,3,5,11,28,35
233,Chris Kaman,C,25,LAC,56,55,2083,338,700,0,4,338,696,202,265,173,538,711,107,33,155,164,179,878
234,Jason Kapono,SF,26,TOR,81,7,1530,243,498,57,118,186,380,37,43,31,89,120,65,34,2,58,131,580
235,Coby Karl,SG,24,LAL,17,0,71,9,26,4,13,5,13,8,10,3,11,14,9,4,2,5,4,30
236,Viktor Khryapa,PF,25,CHI,9,0,105,12,31,0,1,12,30,8,14,6,14,20,8,6,0,6,11,32
237,Jason Kidd*,PG,34,TOT,80,80,2906,305,793,119,312,186,481,135,165,94,506,600,806,136,26,266,165,864
238,Tarence Kinsey,SG,23,MEM,11,0,96,16,38,3,7,13,31,5,6,3,9,12,2,3,0,3,11,40
239,Andrei Kirilenko,SF,26,UTA,72,72,2217,275,544,44,116,231,428,198,257,121,218,339,285,86,109,140,165,792
240,Linas Kleiza,SF,23,DEN,79,13,1889,311,659,94,277,217,382,164,213,92,241,333,95,44,19,89,181,880
241,Brevin Knight,PG,32,LAC,74,39,1674,138,342,0,6,138,336,62,71,15,127,142,328,100,11,71,160,338
243,Nenad Krstić,C,24,NJN,45,38,812,123,300,0,2,123,298,52,69,35,165,200,27,9,17,41,111,298
244,Raef LaFrentz,C,31,POR,39,0,291,27,61,0,4,27,57,11,19,28,39,67,6,12,17,10,59,65
245,Carl Landry,PF,24,HOU,42,0,711,135,219,0,1,135,218,72,109,96,111,207,21,17,7,26,98,342
246,Keith Langford,SG,24,SAS,2,0,10,1,4,0,0,1,4,0,0,0,2,2,0,0,0,0,1,2
248,Acie Law,PG,23,ATL,56,6,865,95,237,7,34,88,203,38,48,12,45,57,113,29,0,56,73,235
249,David Lee,PF,24,NYK,81,29,2356,341,618,0,2,341,616,194,237,242,482,724,95,55,29,97,210,876
250,Rashard Lewis,PF,28,ORL,81,81,3076,516,1135,226,553,290,582,218,260,97,340,437,196,99,38,140,214,1476
251,Kyle Lowry,PG,21,MEM,82,9,2089,256,592,36,140,220,452,243,348,41,209,250,296,92,22,127,185,791
252,Tyronn Lue,PG,30,TOT,50,3,736,113,253,39,86,74,167,25,32,9,45,54,74,11,1,27,66,290
253,Mark Madsen,PF,32,MIN,20,6,151,3,19,0,0,3,19,3,12,18,20,38,4,3,2,9,25,9
254,Corey Maggette,SF,28,LAC,70,65,2502,458,1000,78,203,380,797,553,681,78,316,394,189,71,7,195,210,1547
255,Jamaal Magloire,C,29,TOT,31,2,286,18,55,0,0,18,55,20,44,19,70,89,7,1,10,30,50,56
256,Ian Mahinmi,C,21,SAS,6,0,23,6,12,0,0,6,12,9,9,0,5,5,1,0,4,2,4,21
257,Stephon Marbury,PG,30,NYK,24,19,805,111,265,28,74,83,191,83,116,17,42,59,113,21,2,48,57,333
258,Shawn Marion,PF,29,TOT,63,62,2315,400,787,66,198,334,589,106,150,136,507,643,138,125,85,86,150,972
259,Sean Marks,C,32,PHO,19,0,130,23,43,1,4,22,39,12,19,9,27,36,4,3,10,8,23,59
260,Donyell Marshall,PF,34,TOT,26,1,340,32,98,15,53,17,45,19,22,24,52,76,10,6,16,15,31,98
261,Darrick Martin,PG,36,TOR,17,0,141,10,43,2,16,8,27,5,6,3,4,7,21,6,0,1,12,27
262,Kenyon Martin,PF,30,DEN,71,71,2159,376,699,2,11,374,688,123,212,105,356,461,90,88,85,91,235,877
263,Kevin Martin,SG,24,SAC,61,57,2216,417,914,107,266,310,648,502,578,48,225,273,129,62,5,131,150,1443
264,Desmond Mason,SF,30,MIL,59,56,1702,230,477,0,0,230,477,114,173,75,181,256,121,40,30,83,106,574
265,Roger Mason,PG,27,WAS,80,9,1708,266,600,130,327,136,273,62,71,17,113,130,134,40,18,69,140,724
266,Jason Maxiell,C,24,DET,82,7,1768,240,446,0,1,240,445,171,270,177,256,433,46,21,94,71,183,651
267,Rashad McCants,SG,23,MIN,75,24,2020,428,944,142,349,286,595,116,155,50,156,206,162,66,18,172,234,1114
268,Jelani McCoy,C,30,DEN,6,1,33,1,1,0,0,1,1,1,2,1,6,7,0,0,5,4,7,3
269,Antonio McDyess,PF,33,DET,78,78,2285,293,600,0,2,293,598,97,156,204,462,666,89,61,53,75,246,683
270,Tracy McGrady*,SG,28,HOU,66,62,2440,548,1307,86,295,462,1012,245,358,42,297,339,387,68,30,160,91,1427
271,Dominic McGuire,SG,22,WAS,70,1,695,39,103,1,6,38,97,14,32,53,86,139,40,20,26,40,76,93
272,Jeff McInnis,PG,33,CHA,54,26,1410,108,249,3,19,105,230,23,30,16,80,96,220,23,3,76,120,242
273,Josh McRoberts,PF,20,POR,8,0,28,6,10,0,1,6,9,0,0,2,8,10,2,1,0,2,1,12
274,Chris Mihm,C,28,LAL,23,5,278,32,95,0,0,32,95,18,27,28,49,77,13,4,14,17,42,82
275,C.J. Miles,SG,20,UTA,60,13,689,113,236,30,77,83,159,41,52,16,62,78,53,32,8,27,98,297
276,Darko Miličić,C,22,MEM,70,64,1663,219,500,0,1,219,499,67,121,127,297,424,58,32,114,101,185,505
277,Andre Miller,PG,31,PHI,82,82,3016,569,1156,3,34,566,1122,257,333,95,229,324,565,105,6,206,181,1398
278,Brad Miller,C,31,SAC,72,72,2513,337,728,28,90,309,638,262,309,167,514,681,264,69,74,164,247,964
279,Mike Miller,SG,27,MEM,70,70,2474,414,824,155,359,259,465,164,212,51,416,467,240,35,16,182,145,1147
280,Paul Millsap,PF,22,UTA,82,2,1702,253,502,0,4,253,498,155,229,167,293,460,81,72,73,87,269,661
281,Yao Ming*,C,27,HOU,55,55,2044,432,852,0,2,432,850,345,406,172,422,594,129,25,111,183,171,1209
282,Cuttino Mobley,SG,32,LAC,77,38,2702,377,870,67,192,310,678,163,199,50,225,275,202,78,34,123,152,984
283,Nazr Mohammed,C,30,TOT,82,29,1650,272,528,0,1,272,527,95,163,194,300,494,72,45,60,101,230,639
284,Jamario Moon,SF,27,TOR,78,75,2166,279,575,40,122,239,453,63,85,92,392,484,90,80,108,51,152,661
285,Mikki Moore,PF,32,SAC,82,79,2385,282,489,0,2,282,487,134,182,160,334,494,84,35,46,110,310,698
286,Randolph Morris,C,22,NYK,18,2,181,21,58,0,0,21,58,14,29,12,25,37,2,4,2,9,37,56
287,Alonzo Mourning*,C,37,MIA,25,0,389,52,95,0,0,52,95,45,76,34,59,93,7,4,42,25,56,149
288,Troy Murphy,PF,27,IND,75,61,2106,315,693,94,236,221,457,192,241,108,435,543,165,49,32,96,217,916
289,Ronald Murray,PG,28,TOT,42,19,874,154,367,20,63,134,304,68,98,23,60,83,144,38,4,84,50,396
290,Dikembe Mutombo*,C,41,HOU,39,25,619,43,80,0,0,43,80,32,45,68,131,199,5,11,48,17,55,118
291,Boštjan Nachbar,PF,27,NJN,75,1,1660,245,609,94,262,151,347,154,196,56,204,260,88,44,21,85,182,738
292,Eduardo Nájera,PF,31,DEN,78,3,1664,174,368,53,147,121,221,63,89,113,224,337,95,69,40,59,199,464
293,Steve Nash*,PG,33,PHO,81,81,2780,485,962,179,381,306,581,222,245,28,254,282,898,53,5,295,113,1371
294,Juan Carlos Navarro,SG,27,MEM,82,30,2117,308,766,156,432,152,334,124,146,34,176,210,177,48,1,134,94,896
295,Jameer Nelson,PG,25,ORL,69,62,1961,283,603,64,154,219,449,125,151,28,215,243,383,63,4,141,167,755
296,Rasho Nesterović,C,31,TOR,71,39,1486,257,467,1,3,256,464,37,49,130,212,342,82,20,52,60,132,552
298,Demetris Nichols,SF,23,TOT,14,0,44,6,23,3,13,3,10,0,0,0,5,5,1,0,3,4,4,15
299,Joakim Noah,C,22,CHI,74,31,1534,177,367,0,1,177,366,134,194,174,242,416,84,68,64,89,173,488
300,Andrés Nocioni,SF,28,CHI,82,27,2021,379,877,126,346,253,531,196,243,48,294,342,95,25,43,133,245,1080
301,Steve Novak,SF,24,HOU,35,0,264,49,102,34,71,15,31,3,4,4,31,35,6,2,3,4,17,135
302,Dirk Nowitzki,PF,29,DAL,77,77,2769,630,1314,79,220,551,1094,478,544,95,564,659,266,51,71,160,198,1817
303,Patrick O'Bryant,C,21,GSW,24,0,99,16,29,0,0,16,29,3,5,10,19,29,4,4,9,7,27,35
304,Jermaine O'Neal,C,29,IND,42,34,1206,225,512,0,5,225,507,121,163,82,201,283,93,20,87,106,129,571
305,Shaquille O'Neal*,C,35,TOT,61,61,1748,331,558,0,0,331,558,170,338,166,388,554,93,32,88,181,228,832
306,Fabricio Oberto,PF,32,SAS,82,64,1644,180,296,0,1,180,295,37,61,153,277,430,95,37,20,51,203,397
307,Lamar Odom,PF,28,LAL,77,77,2921,417,795,31,113,386,682,229,328,197,622,819,273,75,72,156,222,1094
308,Emeka Okafor,C,25,CHA,82,82,2718,460,860,0,0,460,860,213,374,255,621,876,70,62,138,164,241,1133
309,Mehmet Okur,C,28,UTA,72,72,2390,374,841,114,294,260,547,185,230,132,424,556,145,55,29,104,236,1047
310,Kevin Ollie,SG,35,PHI,40,0,300,29,69,0,1,29,68,12,15,4,15,19,38,10,0,5,28,70
311,Bo Outlaw,PF,36,ORL,2,0,7,2,3,0,0,2,3,0,0,0,0,0,0,0,0,1,1,4
312,Travis Outlaw,PF,23,POR,82,6,2186,417,964,40,101,377,863,218,294,96,280,376,106,59,63,107,173,1092
313,Andre Owens,PG,27,IND,31,7,392,40,107,18,40,22,67,25,34,13,34,47,47,13,3,24,37,123
314,Zaza Pachulia,C,23,ATL,62,5,944,107,245,0,3,107,242,108,153,89,159,248,36,24,13,69,140,322
315,Jannero Pargo,SG,28,NOH,80,5,1497,254,652,65,186,189,466,71,81,26,104,130,192,50,5,93,123,644
316,Anthony Parker,SG,32,TOR,82,82,2634,395,829,133,304,262,525,102,125,50,284,334,183,79,17,87,157,1025
317,Smush Parker,PG,26,TOT,28,2,592,64,184,18,78,46,106,19,28,4,47,51,84,24,6,44,60,165
318,Tony Parker,PG,25,SAS,69,68,2312,515,1043,17,66,498,977,248,347,30,191,221,411,55,8,164,93,1295
319,Ruben Patterson,SF,32,LAC,20,5,327,39,86,0,2,39,84,24,43,24,40,64,17,21,7,27,37,102
320,Chris Paul,PG,22,NOH,80,80,3006,630,1291,92,249,538,1042,332,390,62,259,321,925,217,4,201,185,1684
321,Sasha Pavlović,SG,24,CLE,51,45,1188,146,403,34,114,112,289,53,77,35,93,128,82,29,6,55,117,379
322,Oleksiy Pecherov,C,22,WAS,35,0,320,44,125,17,60,27,65,20,31,21,45,66,7,6,5,17,30,125
323,Kendrick Perkins,C,23,BOS,78,78,1912,214,348,0,1,214,347,114,183,145,329,474,84,31,114,125,242,542
324,Kosta Perović,C,22,GSW,7,0,38,3,10,0,0,3,10,4,6,6,7,13,1,0,2,1,6,10
325,Morris Peterson,SG,30,NOH,76,76,1796,215,516,113,287,102,229,65,85,36,170,206,67,47,7,41,125,608
326,Johan Petro,C,22,SEA,72,28,1310,184,439,0,1,184,438,64,87,98,272,370,32,35,42,73,173,432
327,Eric Piatkowski,SF,37,PHO,16,0,113,12,33,11,26,1,7,4,4,1,11,12,10,0,1,6,11,39
328,Paul Pierce,SF,30,BOS,80,80,2874,509,1098,143,365,366,733,409,485,53,358,411,363,101,36,221,200,1570
329,Mickaël Piétrus,SF,25,GSW,66,16,1316,170,387,66,183,104,204,66,98,67,175,242,49,66,43,48,200,472
330,Scot Pollard,C,32,BOS,22,0,173,12,23,0,0,12,23,15,22,14,23,37,3,3,6,5,43,39
331,James Posey,PF,31,BOS,74,2,1821,173,414,106,279,67,135,93,115,30,292,322,114,72,19,65,182,545
332,Leon Powe,C,24,BOS,56,5,809,154,269,0,1,154,268,137,193,95,132,227,15,15,16,43,127,445
333,Josh Powell,C,25,LAC,64,25,1228,145,315,0,3,145,312,63,87,115,216,331,47,14,23,65,130,353
334,Kasib Powell,SF,26,MIA,11,4,304,35,95,8,33,27,62,6,9,8,36,44,18,9,2,5,18,84
335,Ronnie Price,PG,24,UTA,61,3,588,88,204,26,75,62,129,26,38,8,38,46,78,32,3,30,83,228
336,Tayshaun Prince,SF,27,DET,82,82,2694,421,940,53,146,368,794,185,241,109,289,398,268,42,33,91,90,1080
337,Gabe Pruitt,PG,21,BOS,15,0,95,14,39,3,12,11,27,1,2,1,7,8,13,5,0,5,10,32
338,Joel Przybilla,C,28,POR,77,67,1819,144,250,0,1,144,249,83,122,195,454,649,27,13,93,95,234,371
339,Chris Quinn,PG,24,MIA,60,25,1340,158,373,64,159,94,214,85,98,11,107,118,178,46,4,55,90,465
340,Vladimir Radmanović,SF,27,LAL,65,41,1483,198,437,95,234,103,203,52,65,56,159,215,123,46,12,73,147,543
341,Shavlik Randolph,PF,24,PHI,9,0,27,4,14,0,0,4,14,0,0,9,2,11,3,1,3,2,5,8
342,Zach Randolph,C,26,NYK,69,68,2244,486,1058,22,80,464,978,223,289,184,526,710,140,59,16,186,194,1217
344,Michael Redd,SG,28,MIL,72,71,2702,550,1243,130,359,420,884,402,490,85,224,309,247,65,13,181,120,1632
345,J.J. Redick,SG,23,ORL,34,0,276,48,108,17,43,31,65,27,34,1,22,23,16,4,0,15,29,140
346,Chris Richard,C,23,MIN,52,3,556,41,87,0,0,41,87,16,27,52,83,135,18,10,12,24,83,98
347,Jason Richardson,SF,27,CHA,82,82,3149,648,1468,243,599,405,869,249,331,80,361,441,258,116,57,166,241,1788
349,Quentin Richardson,SF,27,NYK,65,65,1841,199,555,69,214,130,341,60,88,56,259,315,116,44,15,69,153,527
350,Luke Ridnour,PG,26,SEA,61,5,1223,147,368,21,71,126,297,78,91,13,81,94,241,37,14,80,120,393
351,Nate Robinson,PG,23,NYK,72,17,1883,331,782,97,292,234,490,154,196,51,171,222,212,60,1,103,186,913
352,Sergio Rodríguez,PG,21,POR,72,0,628,69,196,17,58,52,138,25,38,13,45,58,123,24,0,53,57,180
353,Rajon Rondo,PG,21,BOS,77,77,2306,351,713,5,19,346,694,107,175,78,244,322,393,129,13,147,187,814
354,Malik Rose,PF,33,NYK,49,3,494,66,180,2,7,64,173,37,51,31,72,103,28,16,7,40,80,171
355,Quinton Ross,SG,26,LAC,76,44,1505,131,335,9,21,122,314,40,60,54,118,172,88,43,33,29,132,311
356,Brandon Roy,SG,23,POR,74,74,2792,531,1170,73,215,458,955,281,373,81,267,348,430,79,16,136,147,1416
357,Michael Ruffin,C,31,MIL,46,2,632,33,62,0,0,33,62,25,63,90,96,186,24,31,19,19,93,91
358,Kareem Rush,SG,27,IND,71,15,1504,228,569,102,262,126,307,30,42,19,149,168,89,42,19,62,108,588
359,John Salmons,SG,28,SAC,81,41,2517,381,799,39,120,342,679,214,260,76,273,349,208,93,31,170,171,1015
360,Cheikh Samb,C,23,DET,4,0,31,3,4,0,0,3,4,1,2,3,4,7,0,1,2,1,8,7
361,Brian Scalabrine,PF,29,BOS,48,9,512,29,94,15,46,14,48,15,20,22,57,79,40,9,8,26,63,88
362,Luis Scola,PF,27,HOU,82,39,2024,345,670,0,3,345,667,157,235,174,351,525,106,60,19,105,235,847
363,Thabo Sefolosha,SG,23,CHI,69,22,1436,180,421,29,88,151,333,75,104,50,205,255,129,61,30,93,128,464
364,Mouhamed Sene,C,21,SEA,13,0,62,11,24,0,0,11,24,8,17,7,9,16,1,0,7,0,9,30
365,Ramon Sessions,PG,21,MIL,17,7,450,51,117,3,7,48,110,32,41,8,50,58,127,17,3,36,26,137
366,Bobby Simmons,SF,27,MIL,70,21,1521,209,496,60,171,149,325,53,70,67,159,226,80,50,5,78,140,531
367,Cedric Simmons,PF,22,TOT,14,0,87,4,14,0,0,4,14,0,10,6,12,18,0,2,5,6,8,8
368,Courtney Sims,C,24,IND,3,0,11,0,1,0,0,0,1,0,0,1,1,2,1,0,0,0,2,0
369,Brian Skinner,C,31,PHO,66,0,844,92,198,2,3,90,195,33,63,63,175,238,15,21,77,39,112,219
370,Craig Smith,PF,24,MIN,77,11,1547,297,528,0,9,297,519,133,200,123,230,353,60,36,17,89,217,727
371,J.R. Smith,SG,22,DEN,74,0,1421,311,674,157,390,154,284,128,178,43,109,152,128,62,12,112,144,907
372,Jason Smith,PF,21,PHI,76,1,1107,141,310,4,14,137,296,54,82,77,153,230,20,22,50,48,142,340
373,Joe Smith,PF,32,TOT,77,36,1726,312,653,0,3,312,650,154,204,163,238,401,66,34,47,71,186,778
374,Josh Smith,PF,22,ATL,81,81,2873,518,1133,25,99,493,1034,333,469,161,506,667,272,123,227,245,269,1394
375,Eric Snow,PG,34,CLE,22,5,305,6,38,0,2,6,36,10,22,4,16,20,42,10,4,10,30,22
377,Darius Songaila,C,29,WAS,80,13,1554,214,467,0,2,214,465,67,73,81,190,271,135,53,16,86,181,495
378,Jerry Stackhouse,SG,33,DAL,58,13,1412,213,526,60,184,153,342,132,148,33,100,133,145,28,10,86,82,618
379,DeShawn Stevenson,SG,26,WAS,82,82,2564,301,780,158,413,143,367,157,197,37,198,235,252,65,15,102,110,917
380,Peja Stojaković,SF,30,NOH,77,77,2711,451,1026,231,524,220,502,130,140,64,267,331,96,57,10,61,127,1263
381,Awvee Storey,SG,30,MIL,26,0,259,39,89,0,7,39,82,14,29,31,23,54,16,7,1,10,41,92
382,Damon Stoudamire,PG,34,TOT,60,33,1037,120,337,50,149,70,188,27,34,20,98,118,165,30,2,80,76,317
383,Salim Stoudamire,PG,25,ATL,35,0,402,65,180,29,85,36,95,41,50,4,20,24,28,7,5,21,34,200
384,Amar'e Stoudemire,C,25,PHO,79,79,2677,714,1211,5,31,709,1180,556,691,178,541,719,118,64,163,174,294,1989
385,D.J. Strawberry,SG,22,PHO,33,0,270,29,92,6,25,23,67,9,19,9,19,28,30,12,6,11,36,73
386,Rodney Stuckey,PG,21,DET,57,2,1081,153,382,3,16,150,366,127,156,32,97,129,160,49,6,78,113,436
387,Robert Swift,C,22,SEA,8,4,98,6,17,0,0,6,17,2,2,6,12,18,1,5,6,10,16,14
388,Stromile Swift,PF,28,TOT,56,4,844,135,265,0,2,135,263,73,109,64,135,199,26,15,54,51,113,343
389,Wally Szczerbiak,SF,30,TOT,75,2,1736,311,722,90,218,221,504,149,175,34,183,217,104,23,12,76,103,861
390,Sebastian Telfair,PG,22,MIN,60,51,1933,223,556,32,114,191,442,78,105,16,119,135,355,59,11,111,171,556
391,Jason Terry,SG,30,DAL,82,34,2579,471,1008,136,363,335,645,191,223,30,178,208,264,88,18,92,170,1269
392,Billy Thomas,SF,32,TOT,11,0,42,4,17,4,16,0,1,2,2,0,2,2,0,1,0,4,4,14
393,Kenny Thomas,PF,30,SAC,23,3,281,16,38,0,0,16,38,0,5,18,43,61,13,6,1,21,38,32
395,Tim Thomas,PF,30,LAC,63,51,1940,291,705,83,271,208,434,115,153,62,261,323,171,40,29,98,192,780
396,Tyrus Thomas,PF,21,CHI,74,27,1330,186,440,1,6,185,434,129,174,102,240,342,90,48,72,77,170,502
397,Al Thornton,PF,24,LAC,79,31,2158,374,871,43,130,331,741,214,288,98,260,358,98,46,43,128,195,1005
398,Jamaal Tinsley,PG,29,IND,39,36,1293,176,463,40,141,136,322,72,100,24,117,141,326,66,10,130,97,464
399,Alando Tucker,SF,23,PHO,6,0,48,8,22,1,4,7,18,5,6,4,4,8,0,0,1,0,2,22
400,Ronny Turiaf,C,25,LAL,78,21,1458,188,397,0,1,188,396,140,186,95,211,306,128,28,108,72,199,516
401,Hedo Türkoğlu,SF,28,ORL,82,82,3026,556,1219,166,415,390,804,324,391,83,388,471,409,74,25,246,244,1602
402,Ime Udoka,PF,30,SAS,73,0,1316,159,375,61,165,98,210,44,58,36,192,228,63,56,17,58,127,423
403,Beno Udrih,PG,25,SAC,65,51,2080,328,708,53,137,275,571,125,147,34,183,217,282,56,10,148,138,834
404,Anderson Varejão,C,25,CLE,48,13,1320,136,295,0,2,136,293,49,82,134,265,399,53,37,26,59,134,321
405,Jacque Vaughn,PG,32,SAS,74,9,1139,121,283,3,10,118,273,61,80,13,61,74,159,23,1,54,97,306
406,Charlie Villanueva,PF,23,MIL,76,31,1829,354,814,55,185,299,629,123,157,145,321,466,78,30,35,107,174,886
407,Marcus Vinicius,SF,23,NOH,13,0,69,9,20,5,12,4,8,5,11,1,7,8,2,1,1,3,4,28
408,Jake Voskuhl,C,30,MIL,44,0,386,37,80,0,0,37,80,24,29,30,67,97,13,9,21,29,83,98
409,Sasha Vujačić,SG,23,LAL,72,0,1279,219,482,118,270,101,212,76,91,19,135,154,72,36,5,52,107,632
410,Dwyane Wade,SG,26,MIA,51,49,1954,439,937,22,77,417,860,354,467,45,169,214,354,87,37,224,137,1254
411,Von Wafer,SG,22,TOT,29,0,154,17,61,4,26,13,35,8,12,1,18,19,7,2,3,13,7,46
412,Antoine Walker,PF,31,MIN,46,1,892,136,375,61,188,75,187,35,66,56,112,168,45,33,8,46,80,368
414,Gerald Wallace,PF,25,CHA,62,59,2376,408,908,71,221,337,687,313,428,58,315,373,216,131,58,180,189,1200
415,Rasheed Wallace,C,33,DET,77,76,2346,376,870,112,315,264,555,115,150,84,427,511,137,91,129,86,213,979
416,Luke Walton,SF,27,LAL,74,31,1729,215,478,28,84,187,394,77,109,85,206,291,218,60,18,100,133,535
417,Hakim Warrick,PF,25,MEM,75,30,1754,328,653,13,48,315,605,183,260,123,233,356,53,36,28,85,156,852
418,Darius Washington,SG,22,SAS,18,0,146,21,48,4,12,17,36,7,13,4,16,20,15,5,0,14,16,53
419,Darryl Watkins,C,23,SAC,9,0,71,5,15,0,0,5,15,2,5,5,7,12,0,2,2,7,8,12
420,C.J. Watson,PG,23,GSW,32,0,368,43,101,9,26,34,75,23,29,13,19,32,35,15,0,18,19,118
421,Earl Watson,PG,28,SEA,78,73,2269,339,747,49,132,290,615,111,145,43,182,225,531,69,11,175,158,838
422,Chris Webber,PF,34,GSW,9,8,126,15,31,0,0,15,31,5,12,2,30,32,18,4,6,11,17,35
423,Martell Webster,SF,21,POR,75,70,2132,277,656,123,317,154,339,122,166,54,242,296,90,42,28,83,159,799
424,Bonzi Wells,SG,31,TOT,73,7,1562,252,569,12,50,240,519,146,227,84,247,331,97,75,32,103,157,662
425,David West,PF,27,NOH,76,76,2870,629,1305,6,25,623,1280,300,353,180,495,675,177,62,99,165,208,1564
426,Delonte West,PG,24,TOT,61,31,1533,196,475,48,135,148,340,67,91,31,162,193,229,59,29,117,103,507
427,Mario West,SG,23,ATL,64,2,269,21,49,0,4,21,45,17,26,26,22,48,13,12,4,9,61,59
428,Chris Wilcox,PF,25,SEA,62,55,1739,334,638,0,3,334,635,160,248,126,307,433,74,46,36,103,174,828
429,Damien Wilkins,SF,28,SEA,76,31,1843,271,673,50,155,221,518,106,144,72,173,245,150,62,19,89,128,698
430,Mike Wilks,PG,28,TOT,15,0,188,17,36,3,8,14,28,4,4,5,14,19,14,9,0,9,13,41
431,Aaron Williams,C,36,LAC,30,5,297,27,55,0,0,27,55,14,18,15,46,61,9,12,15,13,44,68
432,Deron Williams,PG,23,UTA,82,82,3059,566,1117,83,210,483,907,330,411,34,209,243,862,90,23,279,200,1545
433,Jason Williams,PG,32,MIA,67,53,1886,211,550,97,275,114,275,69,80,12,118,130,307,83,5,91,93,588
434,Justin Williams,C,23,TOT,23,0,123,13,29,0,0,13,29,8,26,20,29,49,0,5,5,4,17,34
435,Lou Williams,PG,21,PHI,80,0,1862,319,752,55,153,264,599,227,290,41,126,167,253,81,13,125,130,920
436,Marcus Williams,PG,22,NJN,53,7,854,111,293,54,142,57,151,37,47,14,87,101,140,25,3,75,52,313
438,Marvin Williams,SF,21,ATL,80,80,2765,424,918,1,10,423,908,336,409,119,338,457,137,81,33,127,225,1185
439,Mo Williams,PG,25,MIL,66,66,2410,441,919,89,231,352,688,166,194,37,193,230,419,78,10,182,188,1137
440,Sean Williams,C,21,NJN,73,29,1278,164,305,0,0,164,305,81,133,115,207,322,28,28,106,70,193,409
441,Shawne Williams,SF,21,IND,65,3,967,159,372,43,137,116,235,76,106,54,122,176,59,26,26,58,132,437
442,Shelden Williams,PF,24,TOT,64,0,776,92,212,0,2,92,210,71,105,68,137,205,19,22,21,35,110,255
443,Loren Woods,C,29,HOU,7,0,17,3,5,0,0,3,5,0,0,0,1,1,2,0,0,0,2,6
444,Metta World Peace,SF,28,SAC,57,54,2172,436,962,84,221,352,741,212,295,101,227,328,199,133,38,148,159,1168
445,Antoine Wright,SG,23,TOT,56,10,1232,136,329,32,110,104,219,46,67,40,107,147,80,28,21,50,127,350
446,Brandan Wright,PF,20,GSW,38,6,376,62,112,0,0,62,112,27,40,38,61,99,9,6,22,13,36,151
447,Dorell Wright,SF,22,MIA,44,34,1104,143,293,4,11,139,282,57,69,48,172,220,60,29,41,29,79,347
448,Julian Wright,SF,20,NOH,57,1,640,90,169,10,24,80,145,33,52,33,84,117,40,29,12,34,43,223
449,Lorenzen Wright,C,32,TOT,18,1,161,6,21,0,0,6,21,3,6,8,30,38,4,3,3,4,31,15
450,Nick Young,SG,22,WAS,75,2,1158,210,478,40,100,170,378,101,124,23,92,115,63,35,7,94,130,561
451,Thaddeus Young,PF,19,PHI,74,22,1554,264,490,6,19,258,471,76,103,120,192,312,58,73,8,64,126,610
1,Alex Acker,SG,26,TOT,25,0,199,30,76,7,20,23,56,5,10,8,16,24,12,5,4,7,9,72
2,Hassan Adams,SG,24,TOR,12,0,52,4,13,0,0,4,13,3,6,1,6,7,1,1,1,4,4,11
3,Arron Afflalo,SG,23,DET,74,8,1234,131,300,43,107,88,193,58,71,30,104,134,44,28,13,43,144,363
4,Maurice Ager,SG,24,NJN,20,0,97,15,43,0,6,15,37,4,8,3,7,10,3,1,2,4,17,34
5,Blake Ahearn,PG,24,SAS,3,0,19,2,6,2,4,0,2,2,2,0,1,1,2,1,0,1,3,8
6,Alexis Ajinça,PF,20,CHA,31,4,182,25,69,0,2,25,67,20,28,9,21,30,3,7,6,12,34,70
7,LaMarcus Aldridge,PF,23,POR,81,81,3004,601,1243,7,28,594,1215,261,334,234,371,605,157,77,77,121,207,1470
8,Joe Alexander,SF,22,MIL,59,0,716,102,245,16,46,86,199,58,83,44,71,115,42,15,29,52,107,278
9,Malik Allen,PF,30,MIL,49,3,579,73,170,0,1,73,169,10,21,35,68,103,35,7,12,20,89,156
10,Ray Allen*,SG,33,BOS,79,79,2876,499,1040,199,486,300,554,237,249,66,212,278,218,69,13,134,157,1434
11,Tony Allen,SG,27,BOS,46,2,887,137,284,6,27,131,257,79,109,22,82,104,66,54,23,77,98,359
12,Morris Almond,SG,23,UTA,25,1,255,33,81,5,17,28,64,21,26,9,27,36,7,4,4,16,31,92
13,Rafer Alston,PG,32,TOT,77,76,2447,316,820,112,331,204,489,156,208,33,194,227,406,108,10,140,135,900
14,Lou Amundson,PF,26,PHO,76,0,1044,134,250,0,1,134,249,53,120,128,142,270,28,32,65,56,154,321
15,Chris Andersen,C,30,DEN,71,1,1460,160,292,2,10,158,282,130,181,163,279,442,31,41,175,69,174,452
16,Ryan Anderson,PF,20,NJN,66,30,1312,160,407,69,189,91,218,98,116,104,207,311,52,44,20,63,157,487
17,Carmelo Anthony,SF,24,DEN,66,66,2277,535,1207,63,170,472,1037,371,468,106,344,450,222,75,24,199,195,1504
18,Joel Anthony,C,26,MIA,65,28,1048,57,118,0,0,57,118,30,46,89,108,197,27,20,93,41,139,144
19,Gilbert Arenas,PG,27,WAS,2,2,63,6,23,2,7,4,16,12,16,1,8,9,20,0,1,1,4,26
20,Trevor Ariza,SF,23,LAL,82,20,1999,274,596,61,191,213,405,120,169,111,241,352,145,137,24,87,166,729
21,Hilton Armstrong,C,24,NOH,70,29,1092,138,246,0,2,138,244,62,98,81,114,195,29,26,45,80,181,338
22,Darrell Arthur,PF,20,MEM,76,64,1464,191,436,0,2,191,434,40,60,108,238,346,43,52,52,47,206,422
23,Chucky Atkins,PG,34,TOT,33,0,412,34,113,15,57,19,56,15,16,5,19,24,59,10,2,23,27,98
24,D.J. Augustin,PG,21,CHA,72,12,1908,267,621,108,246,159,375,208,233,17,116,133,250,42,2,119,140,850
25,Kelenna Azubuike,SF,25,GSW,74,51,2375,392,845,94,210,298,635,185,229,112,258,370,117,57,50,95,183,1063
26,Renaldo Balkman,PF,24,DEN,53,10,780,110,197,2,7,108,190,42,65,86,117,203,34,47,23,35,98,264
27,Marcus Banks,PG,27,TOT,22,0,206,21,57,3,19,18,38,11,18,1,17,18,28,11,2,14,26,56
28,Leandro Barbosa,SG,26,PHO,70,11,1705,366,759,90,240,276,519,171,194,34,147,181,162,82,7,93,115,993
29,J.J. Barea,SG,24,DAL,79,15,1600,246,557,55,154,191,403,70,93,36,141,177,269,37,5,105,121,617
30,Andrea Bargnani,PF,23,TOR,78,59,2453,431,958,119,291,312,667,221,266,70,346,416,94,34,97,135,242,1202
31,Matt Barnes,PF,28,PHO,77,40,2082,285,674,117,341,168,333,101,136,79,342,421,212,52,26,130,209,788
32,Brent Barry,SG,37,HOU,56,1,857,70,172,49,131,21,41,19,20,17,77,94,78,24,3,48,45,208
33,Brandon Bass,C,23,DAL,81,0,1574,252,508,0,6,252,502,182,210,129,238,367,43,27,55,86,140,686
34,Maceo Baston,PF,33,IND,27,0,217,25,46,0,1,25,45,17,27,22,30,52,7,6,10,12,39,67
35,Tony Battie,PF,32,ORL,77,3,1202,158,323,2,9,156,314,54,82,92,186,278,31,26,25,46,112,372
36,Shane Battier,SG,30,HOU,60,59,2031,145,354,91,237,54,117,55,67,52,233,285,137,48,54,49,114,436
37,Nicolas Batum,SF,20,POR,79,76,1454,161,361,62,168,99,193,42,52,84,136,220,74,50,40,50,139,426
38,Jerryd Bayless,PG,20,POR,53,0,655,69,189,7,27,62,162,83,103,8,49,57,78,16,2,56,81,228
39,Michael Beasley,PF,20,MIA,81,19,2009,452,957,33,81,419,876,186,241,110,329,439,83,41,37,121,184,1123
40,Marco Belinelli,SG,22,GSW,42,23,882,140,317,52,131,88,186,40,52,10,61,71,88,36,1,59,73,372
41,Charlie Bell,SG,29,MIL,70,23,1783,217,524,87,240,130,284,66,80,32,102,134,151,50,7,76,138,587
42,Raja Bell,SG,32,TOT,67,66,2315,299,684,114,271,185,413,87,102,41,202,243,142,50,8,86,166,799
43,Mike Bibby,PG,30,ATL,79,79,2740,437,1005,167,428,270,577,135,171,38,240,278,392,98,11,128,145,1176
44,Andris Biedriņš,C,22,GSW,62,58,1863,308,533,0,1,308,532,119,216,223,470,693,121,63,96,110,236,735
45,Chauncey Billups,PG,32,TOT,79,79,2789,410,980,162,397,248,583,418,458,32,207,239,506,93,18,177,161,1400
46,Steve Blake,PG,28,POR,69,69,2188,277,647,140,328,137,319,63,75,28,145,173,348,69,4,108,126,757
47,Andray Blatche,C,22,WAS,71,36,1703,297,630,5,21,292,609,114,162,126,252,378,118,53,74,117,211,713
48,Mark Blount,C,33,MIA,20,0,207,30,78,11,27,19,51,8,13,10,31,41,4,1,7,14,17,79
49,Keith Bogans,SG,28,TOT,65,15,1272,119,324,74,218,45,106,52,57,31,171,202,64,43,4,41,105,364
50,Andrew Bogut,C,24,MIL,36,33,1124,183,317,0,0,183,317,56,98,117,252,369,72,23,37,86,130,422
51,Matt Bonner,PF,28,SAS,81,67,1928,266,536,118,268,148,268,17,23,97,289,386,82,47,26,37,190,667
52,Josh Boone,C,24,NJN,62,7,995,113,214,0,0,113,214,32,85,104,154,258,31,22,48,31,106,258
53,Calvin Booth,C,32,TOT,8,0,56,5,10,0,0,5,10,6,8,5,6,11,0,1,2,1,10,16
54,Carlos Boozer,PF,27,UTA,37,37,1197,251,512,0,0,251,512,97,139,111,274,385,79,39,7,79,132,599
55,Chris Bosh,C,24,TOR,77,77,2928,615,1263,12,49,603,1214,504,617,215,556,771,191,67,77,174,189,1746
56,Bruce Bowen,SF,37,SAS,80,10,1506,79,187,42,98,37,89,14,26,16,129,145,40,36,13,25,123,214
57,Ryan Bowen,SF,33,NOH,21,3,219,22,38,0,0,22,38,3,5,10,14,24,9,14,5,5,37,47
58,Elton Brand,PF,29,PHI,29,23,920,163,365,0,0,163,365,73,108,77,177,254,37,17,45,68,78,399
59,Corey Brewer,SF,22,MIN,15,8,307,37,90,5,12,32,78,14,19,18,31,49,25,15,3,13,37,93
60,Ronnie Brewer,SF,23,UTA,81,80,2605,421,828,22,85,399,743,247,352,101,199,300,179,138,30,110,128,1111
61,Aaron Brooks,PG,24,HOU,80,35,1998,316,783,113,309,203,474,149,172,33,124,157,238,46,8,125,152,894
62,Andre Brown,PF,27,CHA,4,0,41,1,7,0,0,1,7,2,2,7,5,12,1,1,0,5,9,4
64,Dee Brown,PG,24,TOT,19,11,261,18,49,7,24,11,25,3,5,7,22,29,36,10,0,17,28,46
65,Devin Brown,SG,30,NOH,63,5,869,111,313,28,97,83,216,78,100,31,88,119,54,32,5,54,81,328
66,Kwame Brown,C,26,DET,58,30,999,90,169,0,0,90,169,63,122,91,199,290,32,24,24,50,138,243
67,Shannon Brown,SG,23,TOT,48,0,477,78,165,14,37,64,128,32,39,11,33,44,38,22,7,38,42,202
68,Kobe Bryant,SG,30,LAL,82,82,2960,800,1712,118,336,682,1376,483,564,90,339,429,399,120,37,210,189,2201
69,Greg Buckner,SF,32,MEM,63,0,878,61,159,13,51,48,108,20,25,32,98,130,57,29,8,38,108,155
70,Caron Butler,SG,28,WAS,67,67,2585,491,1085,65,210,426,875,345,402,118,296,414,290,106,20,210,165,1392
71,Rasual Butler,SF,29,NOH,82,74,2614,348,803,140,359,208,444,86,110,49,222,271,75,51,61,59,159,922
72,Andrew Bynum,C,21,LAL,50,50,1446,281,502,0,0,281,502,152,215,137,261,398,71,18,90,85,157,714
73,Will Bynum,PG,26,DET,57,1,803,156,342,3,19,153,323,95,119,19,56,75,157,34,2,76,85,410
74,José Calderón,PG,27,TOR,68,68,2333,320,644,82,202,238,442,151,154,16,178,194,607,74,7,143,114,873
75,Marcus Camby,C,34,LAC,62,55,1925,254,496,1,4,253,492,132,182,161,529,690,127,51,132,93,129,641
76,Brian Cardinal,PF,31,MIN,64,4,909,65,169,30,92,35,77,30,35,39,103,142,76,37,13,48,135,190
77,Rodney Carney,SG,24,MIN,67,6,1199,176,423,79,226,97,197,50,66,36,90,126,26,45,29,43,94,481
78,Matt Carroll,SG,28,TOT,55,10,616,65,171,13,53,52,118,21,25,7,62,69,27,21,6,33,67,164
79,Anthony Carter,PG,33,DEN,78,5,1787,167,386,21,88,146,298,57,78,40,165,205,364,96,13,155,142,412
80,Vince Carter,SG,32,NJN,80,80,2946,588,1345,151,392,437,953,335,410,74,336,410,376,82,38,166,234,1662
81,Mario Chalmers,PG,22,MIA,82,82,2626,278,662,114,311,164,351,148,193,37,191,228,403,160,8,165,240,818
82,Tyson Chandler,C,26,NOH,45,45,1445,160,283,0,0,160,283,77,133,163,230,393,22,15,56,70,144,397
83,Wilson Chandler,SF,21,NYK,82,70,2735,455,1054,103,314,352,740,171,215,91,354,445,170,71,75,139,250,1184
84,Speedy Claxton,PG,30,ATL,2,0,15,2,7,0,0,2,7,1,2,0,0,0,3,0,0,0,1,5
85,Jarron Collins,C,30,UTA,26,3,201,16,35,0,0,16,35,8,11,20,17,37,7,2,1,9,35,40
86,Jason Collins,C,30,MIN,31,22,422,22,70,0,0,22,70,13,28,28,42,70,11,9,13,12,73,57
88,Nick Collison,C,28,OKC,71,40,1831,243,428,0,2,243,426,98,136,181,308,489,66,51,50,73,239,584
89,Mike Conley,PG,21,MEM,82,61,2508,323,730,88,217,235,513,161,197,25,251,276,354,90,8,143,146,895
90,Brian Cook,PF,28,TOT,30,0,171,28,76,13,30,15,46,5,6,7,25,32,5,3,3,13,26,74
91,Daequan Cook,SF,21,MIA,75,4,1833,242,645,153,395,89,250,49,56,19,170,189,71,39,10,42,125,686
93,Joe Crawford,SF,22,NYK,2,0,23,3,10,1,4,2,6,2,2,1,3,4,1,1,0,0,2,9
95,Austin Croshere,PF,33,TOT,14,0,100,14,39,5,15,9,24,7,12,11,23,34,9,1,1,6,5,40
96,Eddy Curry,C,26,NYK,3,0,12,2,2,0,0,2,2,1,3,0,4,4,0,0,0,2,5,5
97,Samuel Dalembert,C,27,PHI,82,82,2036,216,434,0,2,216,432,91,124,214,487,701,18,33,146,117,248,523
98,Erick Dampier,C,33,DAL,80,80,1836,182,280,0,0,182,280,90,141,216,349,565,77,24,95,74,191,454
99,Antonio Daniels,PG,33,TOT,74,9,1021,99,236,22,60,77,176,80,100,5,72,77,177,26,1,62,55,300
100,Marquis Daniels,SF,28,IND,54,43,1700,311,689,18,90,293,599,93,129,80,168,248,114,62,26,94,120,733
101,Jermareo Davidson,SF,24,GSW,14,0,111,17,35,0,0,17,35,8,17,10,24,34,1,2,3,5,12,42
102,Baron Davis,PG,29,LAC,65,60,2248,355,959,99,328,256,631,159,210,46,192,238,501,108,35,193,193,968
103,Glen Davis,C,23,BOS,76,16,1637,199,450,2,5,197,445,130,178,121,180,301,69,53,19,71,230,530
104,Paul Davis,PF,24,LAC,27,1,320,40,98,0,1,40,97,27,34,28,39,67,12,10,3,13,44,107
105,Ricky Davis,SG,29,LAC,36,9,785,83,245,35,111,48,134,31,36,9,51,60,82,19,5,39,63,232
106,Luol Deng,SF,23,CHI,49,46,1665,265,591,8,20,257,571,152,191,80,215,295,94,60,25,72,85,690
107,Boris Diaw,PF,26,TOT,81,59,2754,448,884,75,181,373,703,101,147,118,314,432,333,61,53,215,202,1072
108,Yakhouba Diawara,SF,26,MIA,63,21,851,76,217,51,163,25,54,10,19,26,56,82,27,13,6,16,75,213
109,Travis Diener,PG,26,IND,55,0,719,74,179,46,118,28,61,12,15,6,80,86,122,26,5,21,42,206
110,Ike Diogu,PF,25,TOT,29,1,215,39,74,1,2,38,72,40,53,26,30,56,3,3,3,12,23,119
111,DeSagana Diop,C,27,TOT,75,1,1036,74,171,0,0,74,171,22,66,114,159,273,32,29,56,39,128,170
112,Juan Dixon,PG,30,WAS,50,6,816,101,256,25,75,76,181,34,39,8,59,67,118,35,6,70,74,261
113,Keyon Dooling,PG,28,NJN,77,18,2074,261,598,99,235,162,363,127,154,24,131,155,270,71,8,105,135,748
114,Joey Dorsey,PF,25,HOU,3,0,6,1,2,0,0,1,2,0,0,0,1,1,1,0,0,0,0,2
115,Quincy Douby,PG,24,TOT,27,0,300,42,110,14,46,28,64,17,19,6,26,32,25,5,5,13,27,115
116,Chris Douglas-Roberts,SG,22,NJN,44,3,585,81,176,3,12,78,164,51,62,14,36,50,52,12,7,31,34,216
117,Goran Dragić,PG,22,PHO,55,1,728,88,224,20,54,68,170,50,65,33,70,103,111,29,3,73,87,246
118,Jared Dudley,SF,23,TOT,68,7,1155,136,285,29,74,107,211,71,105,82,123,205,56,57,8,43,105,372
119,Chris Duhon,PG,26,NYK,79,78,2906,287,681,127,325,160,356,179,209,45,201,246,566,72,7,221,126,880
120,Tim Duncan,C,32,SAS,75,75,2524,558,1107,0,2,558,1105,334,483,201,599,800,264,38,126,165,173,1450
121,Mike Dunleavy,SG,28,IND,18,14,495,93,232,32,90,61,142,53,65,14,54,68,44,12,9,38,36,271
122,Kevin Durant,SF,20,OKC,74,74,2885,661,1390,97,230,564,1160,452,524,77,405,482,205,96,53,225,134,1871
123,Monta Ellis,SG,23,GSW,25,25,892,194,430,8,26,186,404,78,94,14,94,108,93,39,8,67,67,474
124,Francisco Elson,C,32,MIL,59,23,977,83,169,1,4,82,165,33,39,100,129,229,32,36,36,48,144,200
125,Melvin Ely,C,30,NOH,31,4,373,37,95,0,0,37,95,23,36,30,34,64,18,2,9,23,58,97
126,Maurice Evans,SF,30,ATL,80,25,1840,208,482,98,248,110,234,60,73,88,155,243,54,50,10,43,163,574
127,Reggie Evans,PF,28,PHI,79,7,1137,79,178,0,1,79,177,104,175,135,226,361,26,41,8,69,161,262
128,Jordan Farmar,PG,22,LAL,65,0,1192,161,412,49,146,112,266,45,77,22,95,117,155,57,10,87,105,416
129,Desmon Farmer,SG,27,SAS,3,0,54,4,14,3,12,1,2,2,2,0,6,6,2,0,0,4,6,13
130,Raymond Felton,PG,24,CHA,82,81,3086,442,1083,59,207,383,876,219,272,54,256,310,553,126,30,228,191,1162
131,Rudy Fernández,SG,23,POR,78,4,1993,268,630,159,398,109,232,120,143,47,160,207,159,69,12,86,111,815
132,Kyrylo Fesenko,C,22,UTA,21,1,156,21,36,0,0,21,36,7,21,14,23,37,4,7,15,9,35,49
133,Michael Finley,SF,35,SAS,81,77,2336,301,689,131,319,170,370,51,62,26,244,270,114,37,17,61,82,784
134,Derek Fisher,PG,34,LAL,82,82,2441,292,688,120,302,172,386,110,130,25,163,188,261,95,6,72,187,814
135,T.J. Ford,PG,25,IND,74,49,2258,413,913,35,104,378,809,245,281,59,200,259,392,89,16,180,180,1106
136,Jeff Foster,C,32,IND,74,26,1828,177,353,2,7,175,346,96,146,215,293,508,130,53,49,88,229,452
137,Randy Foye,SG,25,MIN,70,61,2494,399,981,111,308,288,673,230,272,34,180,214,303,72,26,150,201,1139
138,Adonal Foyle,C,33,TOT,10,0,62,7,11,0,0,7,11,3,6,9,17,26,1,0,8,3,5,17
139,Channing Frye,PF,25,POR,63,1,746,113,267,11,33,102,234,26,36,41,99,140,24,17,16,29,106,263
140,Dan Gadzuric,C,30,MIL,67,26,941,117,244,0,2,117,242,37,68,95,160,255,39,32,43,41,162,271
141,Danilo Gallinari,SG,20,NYK,28,2,412,56,125,32,72,24,53,26,27,13,42,55,15,14,4,15,48,170
142,Francisco García,SF,27,SAC,65,36,1975,295,665,88,221,207,444,146,178,56,162,218,150,80,67,112,196,824
143,Thomas Gardner,SG,23,ATL,16,0,98,9,36,4,23,5,13,2,4,0,7,7,2,4,1,3,4,24
144,Kevin Garnett,PF,32,BOS,57,57,1772,393,740,2,8,391,732,111,132,78,407,485,144,63,68,90,128,899
145,Marc Gasol,C,24,MEM,82,75,2521,350,661,0,1,350,660,275,375,201,404,605,143,63,90,164,265,975
146,Pau Gasol,C,28,LAL,81,81,2999,592,1045,1,2,591,1043,343,439,262,518,780,284,52,81,157,172,1528
147,Rudy Gay,SF,22,MEM,79,78,2945,572,1262,85,242,487,1020,264,344,109,328,437,135,98,59,203,221,1493
148,Devean George,SF,31,DAL,43,17,708,54,142,22,76,32,66,17,22,25,53,78,15,23,11,17,57,147
149,Daniel Gibson,PG,22,CLE,75,0,1795,206,527,108,283,98,244,66,86,31,124,155,132,44,16,61,163,586
150,J.R. Giddens,SF,23,BOS,6,0,8,2,3,0,0,2,3,0,0,2,1,3,0,1,0,1,1,4
151,Eddie Gill,PG,30,MIL,6,0,43,6,9,2,3,4,6,0,0,0,4,4,11,3,1,5,10,14
152,Manu Ginóbili,SG,31,SAS,44,7,1181,223,491,69,209,154,282,168,190,24,174,198,157,64,16,88,90,683
153,Ryan Gomes,SF,26,MIN,82,76,2614,420,974,106,285,314,689,146,181,106,286,392,135,63,22,128,183,1092
154,Drew Gooden,PF,27,TOT,51,28,1264,237,506,0,4,237,502,131,156,113,249,362,48,30,18,76,144,605
155,Ben Gordon,SG,25,CHI,82,76,2999,598,1315,173,422,425,893,330,382,52,231,283,279,71,22,200,184,1699
156,Eric Gordon,SG,20,LAC,78,65,2677,411,901,131,337,280,564,299,350,45,156,201,215,78,35,164,172,1252
157,Marcin Gortat,PF,24,ORL,63,3,794,106,187,1,1,105,186,26,45,96,190,286,14,18,53,25,111,239
158,Joey Graham,SF,26,TOR,78,10,1541,231,480,3,16,228,464,132,160,95,197,292,48,35,12,74,191,597
159,Stephen Graham,SG,26,IND,52,6,684,106,256,20,66,86,190,50,62,21,75,96,33,10,4,45,82,282
160,Danny Granger,SF,25,IND,67,66,2424,571,1277,182,450,389,827,404,460,49,292,341,183,69,97,165,207,1728
161,Aaron Gray,C,24,CHI,56,18,715,81,167,0,1,81,166,34,59,84,136,220,46,14,18,40,135,196
162,Gerald Green,SG,23,DAL,38,12,376,79,180,14,46,65,134,27,32,14,40,54,15,10,5,33,51,199
163,Jeff Green,PF,22,OKC,78,78,2873,476,1068,96,247,380,821,242,307,120,399,519,155,81,33,173,202,1290
164,Willie Green,SG,27,PHI,81,60,1828,286,658,51,161,235,497,62,85,29,97,126,158,53,13,64,154,685
165,Donté Greene,SF,20,SAC,55,4,725,77,236,26,100,51,136,29,34,19,67,86,30,16,14,37,68,209
166,Hamed Haddadi,C,23,MEM,19,0,120,15,31,0,0,15,31,18,30,16,31,47,8,1,12,9,20,48
167,Malik Hairston,SG,21,SAS,15,0,155,24,49,0,1,24,48,2,7,11,17,28,13,6,7,12,19,50
168,Richard Hamilton,SG,30,DET,67,51,2279,466,1043,70,190,396,853,223,263,44,163,207,297,40,4,133,176,1225
169,Matt Harpring,SG,32,UTA,63,2,693,111,241,0,2,111,239,55,72,47,76,123,28,29,9,29,102,277
170,Al Harrington,PF,28,TOT,73,56,2546,532,1212,171,470,361,742,234,295,99,356,455,102,88,22,161,227,1469
171,Devin Harris,PG,25,NJN,69,69,2494,455,1039,64,220,391,819,496,605,30,201,231,476,114,13,212,164,1470
172,Jason Hart,PG,30,TOT,39,2,348,30,94,0,6,30,88,18,23,13,33,46,48,12,4,22,39,78
173,Udonis Haslem,PF,28,MIA,75,75,2560,333,643,0,0,333,643,128,170,169,449,618,85,43,25,82,204,794
174,Trenton Hassell,SF,29,NJN,53,31,1094,86,191,2,8,84,183,20,25,50,96,146,51,21,16,30,92,194
175,Spencer Hawes,C,20,SAC,77,51,2259,373,800,40,115,333,685,90,136,148,401,549,149,44,93,160,249,876
176,Chuck Hayes,C,25,HOU,71,1,858,42,113,0,4,42,109,7,19,74,176,250,42,34,19,25,134,91
177,Jarvis Hayes,SF,27,NJN,74,1,1832,257,577,94,244,163,333,36,52,27,240,267,54,52,7,49,162,644
178,Brendan Haywood,C,29,WAS,6,5,175,24,50,0,0,24,50,10,21,13,31,44,8,4,15,9,14,58
180,Walter Herrmann,SF,29,DET,59,0,630,82,207,41,120,41,87,19,25,28,79,107,22,7,4,17,43,224
181,Roy Hibbert,C,22,IND,70,42,1009,198,420,0,0,198,420,98,147,115,128,243,49,20,76,55,215,494
182,J.J. Hickson,C,20,CLE,62,0,705,100,194,0,0,100,194,45,67,52,113,165,9,14,30,45,81,245
183,Nenê Hilário,C,26,DEN,77,76,2510,428,709,1,5,427,704,266,368,183,415,598,108,95,101,147,278,1123
184,George Hill,PG,22,SAS,77,7,1270,150,372,24,73,126,299,114,146,30,128,158,136,45,21,74,150,438
185,Grant Hill*,SF,36,PHO,82,68,2445,390,745,24,76,366,669,181,224,64,341,405,186,90,54,126,182,985
186,Steven Hill,PF,23,OKC,1,0,2,1,1,0,0,1,1,0,0,2,1,3,0,0,0,0,0,2
187,Kirk Hinrich,SG,28,CHI,51,4,1339,183,419,69,169,114,250,68,86,16,107,123,197,66,19,87,126,503
188,Ryan Hollins,C,24,TOT,45,3,444,50,94,0,0,50,94,43,72,46,51,97,7,7,32,24,78,143
189,Al Horford,C,22,ATL,67,67,2242,312,594,0,1,312,593,149,205,145,479,624,163,53,95,103,190,773
190,Eddie House,PG,30,BOS,81,0,1479,249,560,151,340,98,220,42,53,11,146,157,92,61,7,55,113,691
191,Dwight Howard,C,23,ORL,79,79,2821,560,979,0,2,560,977,504,849,336,757,1093,112,77,231,240,270,1624
192,Josh Howard,SF,28,DAL,52,51,1663,353,783,58,168,295,615,172,220,59,204,263,83,55,30,89,135,936
195,Kris Humphries,SF,23,TOR,29,0,265,38,90,0,0,38,90,38,48,24,46,70,10,8,6,8,31,114
196,Lindsey Hunter,PG,38,CHI,28,0,266,27,82,16,48,11,34,3,5,2,10,12,37,20,1,19,28,73
197,Othello Hunter,PF,22,ATL,16,0,92,11,20,0,0,11,20,0,5,9,15,24,1,2,5,2,11,22
198,Andre Iguodala,SF,25,PHI,82,82,3269,542,1147,80,261,462,886,377,521,92,379,471,434,131,36,222,152,1541
199,Zydrunas Ilgauskas,C,33,CLE,65,65,1765,342,724,15,39,327,685,139,174,157,333,490,64,28,84,90,183,838
200,Didier Ilunga-Mbenga,C,28,LAL,23,0,181,27,57,0,1,27,56,7,8,9,22,31,9,10,24,13,33,61
202,Royal Ivey,SG,27,PHI,71,0,861,69,208,39,114,30,94,34,43,19,57,76,43,36,7,23,76,211
203,Jarrett Jack,SG,25,IND,82,53,2716,386,853,78,221,308,632,224,263,44,232,276,338,88,17,184,179,1074
204,Bobby Jackson,PG,35,SAC,71,10,1484,193,485,60,197,133,288,86,101,42,158,200,143,62,4,66,100,532
205,Darnell Jackson,PF,23,CLE,51,2,430,37,86,0,2,37,84,24,35,32,55,87,8,10,4,14,77,98
206,Stephen Jackson,SF,30,GSW,59,59,2339,413,997,103,305,310,692,294,356,70,233,303,381,88,31,229,153,1223
207,Jerome James,C,33,NYK,2,0,10,3,8,0,0,3,8,0,0,1,2,3,0,1,1,1,2,6
208,LeBron James,SF,24,CLE,81,81,3054,789,1613,132,384,657,1229,594,762,106,507,613,587,137,93,241,139,2304
209,Mike James,PG,33,TOT,61,50,1649,197,514,69,184,128,330,68,82,25,108,133,201,44,6,94,108,531
210,Antawn Jamison,PF,32,WAS,81,81,3096,674,1441,112,319,562,1122,341,452,196,525,721,153,95,25,125,218,1801
211,Marko Jarić,SG,30,MEM,53,0,605,48,145,11,28,37,117,29,41,23,42,65,74,29,11,49,62,136
212,Nathan Jawai,PF,22,TOR,6,0,19,1,4,0,0,1,4,0,0,1,1,2,0,0,0,2,3,2
213,Al Jefferson,C,24,MIN,50,50,1836,485,975,0,4,485,971,186,252,172,376,548,79,39,83,92,141,1156
214,Dontell Jefferson,SG,25,CHA,6,0,84,11,22,1,2,10,20,6,9,1,11,12,9,4,1,6,9,29
215,Richard Jefferson,SF,28,MIL,82,82,2939,537,1222,116,292,421,930,417,518,57,317,374,199,66,14,165,252,1607
216,Jared Jeffries,SF,27,NYK,56,36,1310,120,273,1,12,119,261,55,90,128,103,231,80,47,33,65,153,296
217,Yi Jianlian,PF,21,NJN,61,52,1421,191,500,48,140,143,360,95,123,67,259,326,60,29,36,70,157,525
218,Amir Johnson,PF,21,DET,62,24,911,97,163,0,0,97,163,23,35,102,130,232,20,20,60,33,171,217
219,Anthony Johnson,PG,34,ORL,80,12,1481,154,381,52,133,102,248,61,81,29,118,147,200,46,5,82,111,421
220,Joe Johnson,SG,27,ATL,79,79,3124,620,1420,149,414,471,1006,299,362,65,281,346,455,84,19,195,176,1688
221,Linton Johnson,PF,28,TOT,10,0,55,4,11,1,2,3,9,0,0,3,5,8,2,1,0,2,7,9
222,Trey Johnson,SG,24,CLE,4,0,14,0,5,0,0,0,5,4,4,0,1,1,0,0,0,1,4,4
223,Dahntay Jones,SG,28,DEN,79,71,1426,154,336,11,17,143,319,110,151,58,110,168,78,49,19,68,199,429
224,Damon Jones,PG,32,MIL,18,0,108,11,34,11,28,0,6,0,0,0,6,6,7,3,0,6,4,33
225,Dwayne Jones,PF,25,CHA,6,0,52,4,7,0,0,4,7,4,6,6,6,12,0,0,1,4,6,12
226,Fred Jones,SF,29,LAC,52,21,1495,129,317,54,147,75,170,66,81,23,103,126,188,53,11,66,112,378
227,James Jones,SF,28,MIA,40,1,630,55,149,33,96,22,53,26,31,12,50,62,20,12,14,12,58,169
228,Solomon Jones,C,24,ATL,63,0,675,67,111,1,2,66,109,53,74,52,90,142,15,7,34,27,125,188
229,DeAndre Jordan,C,20,LAC,53,13,771,93,147,0,0,93,147,42,109,72,165,237,11,11,59,41,96,228
230,Chris Kaman,C,26,LAC,31,24,921,161,305,0,0,161,305,51,75,75,172,247,46,17,45,84,93,373
231,Jason Kapono,SG,27,TOR,80,12,1831,261,604,98,229,163,375,34,42,26,137,163,105,22,3,70,144,654
232,Jason Kidd*,PG,35,DAL,81,81,2886,257,618,131,323,126,295,86,105,85,415,500,702,160,39,185,168,731
233,Tarence Kinsey,SG,24,CLE,50,3,277,31,69,7,18,24,51,33,38,10,28,38,10,12,0,22,34,102
234,Andrei Kirilenko,PF,27,UTA,67,10,1831,256,570,20,73,236,497,244,311,84,235,319,175,83,77,121,127,776
235,Linas Kleiza,SF,24,DEN,82,7,1824,289,646,87,267,202,379,148,204,92,235,327,64,31,14,82,155,813
236,Brevin Knight,PG,33,UTA,74,0,938,66,189,0,6,66,183,48,64,13,75,88,190,68,4,66,98,180
237,Kyle Korver,SF,27,UTA,78,2,1874,245,560,103,267,142,293,112,127,35,223,258,137,47,30,90,170,705
238,Kosta Koufos,C,19,UTA,48,7,565,94,185,0,0,94,185,36,51,50,88,138,20,12,31,26,70,224
239,Nenad Krstić,C,25,OKC,46,29,1141,191,407,0,0,191,407,63,79,85,168,253,29,21,49,45,114,445
240,Rob Kurz,SF,23,GSW,40,5,442,51,131,15,38,36,93,40,50,33,48,81,20,14,19,16,78,157
241,Carl Landry,PF,25,HOU,69,0,1467,240,418,1,3,239,415,157,193,124,219,343,39,26,31,68,166,638
242,Acie Law,PG,24,ATL,55,1,560,52,139,9,29,43,110,49,60,6,52,58,86,11,3,29,43,162
243,Courtney Lee,SG,23,ORL,77,42,1939,243,540,82,203,161,337,78,94,18,160,178,91,76,14,69,157,646
244,David Lee,C,25,NYK,81,74,2824,522,951,0,3,522,948,249,330,256,695,951,174,80,22,150,260,1293
245,Rashard Lewis,PF,29,ORL,79,79,2859,478,1089,220,554,258,535,225,269,92,361,453,205,81,51,158,194,1401
246,Shaun Livingston,PG,23,TOT,12,1,231,31,60,0,0,31,60,9,10,3,25,28,20,7,2,9,12,71
247,Brook Lopez,C,20,NJN,82,75,2501,448,844,0,2,448,842,172,217,225,440,665,86,44,151,147,257,1068
248,Robin Lopez,C,20,PHO,60,7,614,71,137,0,1,71,136,47,68,52,66,118,8,11,41,28,97,189
249,Kevin Love,C,20,MIN,81,37,2048,316,688,2,19,314,669,265,336,274,460,734,84,35,50,118,205,899
250,Kyle Lowry,PG,22,TOT,77,21,1679,189,434,25,98,164,336,181,226,26,163,189,275,69,17,117,146,584
251,Tyronn Lue,PG,31,TOT,44,0,521,71,162,27,62,44,100,14,19,6,40,46,60,8,0,23,54,183
252,Mark Madsen,C,33,MIN,19,1,116,3,14,0,0,3,14,0,4,10,8,18,4,1,1,3,18,6
253,Corey Maggette,PF,29,GSW,51,19,1588,292,634,24,95,268,539,342,415,49,233,282,92,44,8,120,192,950
254,Jamaal Magloire,C,30,MIA,55,12,709,65,131,0,0,65,131,29,60,82,140,222,22,11,25,32,121,159
255,Stephon Marbury,PG,31,BOS,23,4,414,38,111,6,25,32,86,6,13,2,26,28,75,10,3,37,34,88
256,Shawn Marion,SF,30,TOT,69,68,2470,382,788,10,53,372,735,117,147,180,409,589,139,88,66,105,132,891
257,Sean Marks,C,33,NOH,60,5,838,80,165,2,10,78,155,30,44,62,125,187,14,7,33,35,121,192
258,Donyell Marshall,PF,35,PHI,25,0,189,33,73,25,55,8,18,3,6,6,34,40,15,4,5,6,24,94
259,Cartier Martin,SF,24,CHA,33,1,266,28,77,10,33,18,44,20,25,7,26,33,13,8,4,9,33,86
260,Kenyon Martin,PF,31,DEN,66,66,2111,318,648,14,38,304,610,119,197,81,314,395,132,96,74,104,201,769
261,Kevin Martin,SG,25,SAC,51,46,1947,341,811,115,277,226,534,457,527,29,154,183,138,61,8,146,116,1254
262,Desmond Mason,SG,31,OKC,39,19,1064,124,285,0,3,124,282,46,85,41,116,157,46,15,30,56,96,294
263,Roger Mason,SG,28,SAS,82,71,2496,349,822,166,394,183,428,105,118,16,235,251,173,40,12,100,160,969
264,Jason Maxiell,C,25,DET,78,4,1408,184,320,0,1,184,319,84,158,169,155,324,24,25,63,45,157,452
265,Sean May,PF,24,CHA,24,12,301,39,98,1,1,38,97,14,20,20,49,69,10,5,4,26,32,93
266,O.J. Mayo,SG,21,MEM,82,82,3120,562,1283,145,378,417,905,247,281,56,252,308,262,91,13,226,204,1516
267,Luc Mbah a Moute,PF,22,MIL,82,52,2114,227,491,0,4,227,487,140,192,189,298,487,87,87,45,100,204,594
268,Rashad McCants,SG,24,TOT,58,3,1101,192,488,63,189,129,299,107,141,21,89,110,68,47,14,64,103,554
269,Antonio McDyess,PF,34,DET,62,30,1866,268,525,0,0,268,525,60,86,185,422,607,83,41,50,51,191,596
270,JaVale McGee,C,21,WAS,75,14,1143,191,387,0,0,191,387,107,162,120,174,294,23,33,75,61,155,489
271,Tracy McGrady*,SG,29,HOU,35,35,1181,188,485,44,117,144,368,125,156,20,134,154,175,42,15,69,38,545
272,Dominic McGuire,SF,23,WAS,79,57,2072,140,324,2,4,138,320,74,102,113,315,428,198,62,74,92,153,356
273,Josh McRoberts,PF,21,IND,33,0,279,35,83,0,10,35,73,10,13,26,48,74,16,12,16,12,41,80
274,Pops Mensah-Bonsu,PF,25,TOT,22,0,283,39,103,0,2,39,101,33,48,55,58,113,6,9,5,19,43,111
275,Chris Mihm,C,29,LAL,18,0,105,15,40,0,0,15,40,6,7,15,19,34,10,1,6,10,23,36
276,C.J. Miles,SG,21,UTA,72,72,1623,258,562,63,179,195,383,78,89,45,122,167,107,46,15,64,187,657
277,Darius Miles,SF,27,MEM,34,0,298,48,99,1,6,47,93,23,31,19,38,57,17,11,20,21,32,120
278,Darko Miličić,C,23,MEM,61,15,1034,137,266,0,0,137,266,59,105,83,181,264,34,22,51,48,134,333
279,Andre Miller,PG,32,PHI,82,82,2976,492,1041,15,53,477,988,338,409,123,245,368,534,109,14,199,196,1337
280,Brad Miller,C,32,TOT,70,43,2100,292,614,23,56,269,558,224,272,150,395,545,234,52,36,130,223,831
281,Mike Miller,SF,28,MIN,73,47,2356,264,548,85,225,179,323,109,149,73,410,483,326,30,31,145,139,722
282,Paul Millsap,PF,23,UTA,76,38,2290,400,749,0,4,400,745,228,326,251,403,654,138,78,73,129,288,1028
283,Yao Ming*,C,28,HOU,77,77,2589,566,1032,1,1,565,1031,381,440,204,557,761,137,30,150,234,257,1514
284,Cuttino Mobley,SG,33,LAC,11,11,365,63,146,12,35,51,111,13,18,9,20,29,12,15,2,18,21,151
285,Nazr Mohammed,C,31,CHA,39,1,341,41,101,0,0,41,101,22,40,35,44,79,8,5,16,23,63,104
286,Jamario Moon,SF,28,TOT,80,60,2068,222,474,65,183,157,291,68,80,58,307,365,95,86,60,43,133,577
288,Randolph Morris,C,23,ATL,23,0,89,7,17,0,0,7,17,4,4,4,16,20,2,2,1,7,25,18
289,Adam Morrison,SF,24,TOT,52,5,711,80,223,32,96,48,127,17,23,18,62,80,41,9,4,32,77,209
290,Anthony Morrow,SG,23,GSW,67,17,1515,255,534,86,184,169,350,80,92,78,121,199,80,36,12,52,130,676
291,Troy Murphy,PF,28,IND,73,73,2482,364,767,161,358,203,409,152,184,146,715,861,172,58,34,114,226,1041
292,Ronald Murray,SG,29,ATL,80,2,1975,355,795,87,242,268,553,177,233,22,146,168,158,88,17,128,173,974
293,Dikembe Mutombo*,C,42,HOU,9,2,96,5,13,0,0,5,13,6,9,12,21,33,0,0,11,6,11,16
294,Eduardo Nájera,PF,32,NJN,27,0,319,33,74,5,25,28,49,8,22,17,50,67,19,10,4,18,50,79
295,Steve Nash*,PG,34,PHO,74,74,2484,428,851,108,246,320,605,196,210,19,204,223,717,55,10,248,108,1160
296,DeMarcus Nelson,PG,23,GSW,13,5,171,24,54,0,3,24,51,5,14,6,18,24,13,9,2,15,24,53
297,Jameer Nelson,PG,26,ORL,42,42,1309,267,531,82,181,185,350,86,97,20,125,145,226,51,3,83,123,702
298,Rasho Nesterović,C,32,IND,70,19,1214,224,437,0,1,224,436,25,32,93,147,240,109,30,38,63,171,473
299,Demetris Nichols,SF,24,TOT,4,0,14,3,9,0,2,3,7,1,2,0,2,2,1,0,1,0,1,7
300,Joakim Noah,C,23,CHI,80,55,1938,207,372,0,1,207,371,123,182,244,362,606,106,49,110,82,238,537
302,Steve Novak,PF,25,LAC,71,3,1161,176,396,119,286,57,110,21,23,19,106,125,40,20,5,23,71,492
303,Dirk Nowitzki,PF,30,DAL,81,81,3050,774,1616,61,170,713,1446,485,545,88,593,681,197,61,63,157,176,2094
304,Patrick O'Bryant,C,22,TOT,39,3,255,45,84,0,2,45,82,11,20,13,53,66,11,6,19,22,61,101
305,Jermaine O'Neal,C,30,TOT,68,61,2027,365,770,0,1,365,769,175,222,126,307,433,122,29,136,144,211,905
306,Shaquille O'Neal*,C,36,PHO,75,75,2252,512,841,0,1,512,840,309,519,187,446,633,126,49,108,168,253,1333
307,Fabricio Oberto,C,33,SAS,54,11,677,61,104,0,1,61,103,20,35,65,77,142,59,7,11,38,95,142
308,Greg Oden,C,21,POR,61,39,1314,198,351,0,0,198,351,144,226,169,255,424,31,25,69,87,238,540
309,Lamar Odom,PF,29,LAL,78,32,2316,346,703,33,103,313,600,160,257,176,461,637,204,77,98,138,235,885
310,Emeka Okafor,C,26,CHA,82,81,2691,433,772,0,0,433,772,219,369,275,552,827,53,48,136,144,247,1085
311,Mehmet Okur,C,29,UTA,72,72,2409,431,888,90,202,341,686,273,334,124,433,557,120,54,53,132,219,1225
312,Kevin Ollie,PG,36,MIN,50,21,850,61,150,0,1,61,149,80,96,13,62,75,117,19,4,34,79,202
313,Travis Outlaw,SF,24,POR,81,6,2246,385,850,89,236,296,614,175,242,70,261,331,83,47,57,94,168,1034
314,Zaza Pachulia,C,24,ATL,77,26,1473,159,320,0,3,159,317,163,230,173,263,436,57,35,26,91,208,481
315,Anthony Parker,SG,33,TOR,80,71,2637,321,754,94,241,227,513,121,145,45,272,317,269,100,15,114,145,857
316,Tony Parker,PG,26,SAS,72,71,2456,639,1263,19,65,620,1198,284,363,27,196,223,496,67,4,186,110,1581
317,Chris Paul,PG,23,NOH,78,78,3002,631,1255,64,176,567,1079,455,524,69,363,432,861,216,10,231,212,1781
318,Sasha Pavlović,SF,25,CLE,66,12,1053,116,275,48,117,68,158,25,54,31,96,127,72,22,16,48,122,305
319,Oleksiy Pecherov,C,23,WAS,32,0,277,39,101,14,43,25,58,24,29,35,41,76,2,6,3,10,34,116
320,Kendrick Perkins,C,24,BOS,76,76,2253,276,478,0,2,276,476,96,160,204,415,619,96,22,150,165,253,648
321,Morris Peterson,SG,31,NOH,43,9,515,73,183,33,85,40,98,12,19,13,71,84,16,15,2,15,51,191
322,Johan Petro,C,23,TOT,49,22,559,73,176,0,2,73,174,16,29,42,116,158,16,19,15,28,107,162
323,Paul Pierce,SF,31,BOS,81,81,3035,540,1181,119,304,421,877,459,553,56,401,457,294,80,27,228,215,1658
324,Mickaël Piétrus,SG,26,ORL,54,25,1329,176,426,80,223,96,203,78,110,44,132,176,65,31,24,56,126,510
325,James Posey,SG,32,NOH,75,0,2140,216,524,116,314,100,210,120,146,38,324,362,82,58,21,79,216,668
326,Leon Powe,PF,25,BOS,70,7,1227,177,338,0,0,177,338,184,267,145,200,345,46,24,38,76,192,538
327,Josh Powell,PF,26,LAL,60,1,703,106,239,0,0,106,239,38,50,71,105,176,27,9,17,51,98,250
328,Ronnie Price,PG,25,UTA,52,17,738,77,203,19,61,58,142,34,45,12,57,69,108,39,5,61,74,207
329,Tayshaun Prince,SF,28,DET,82,82,3057,459,1020,56,141,403,879,189,243,128,348,476,253,44,51,101,104,1163
330,Gabe Pruitt,SG,22,BOS,47,0,366,31,101,14,48,17,53,17,21,9,34,43,39,15,3,19,34,93
331,Joel Przybilla,C,29,POR,82,43,1952,168,269,0,1,168,268,112,169,204,513,717,27,34,97,78,215,448
332,Chris Quinn,PG,25,MIA,66,0,962,118,289,56,137,62,152,47,58,8,67,75,132,24,2,33,79,339
333,Vladimir Radmanović,SF,28,TOT,78,31,1445,196,466,105,262,91,204,43,58,45,177,222,81,46,15,98,111,540
334,Anthony Randolph,PF,19,GSW,63,22,1129,199,431,0,4,199,427,101,141,128,235,363,49,42,74,80,141,499
335,Shavlik Randolph,PF,25,POR,10,0,37,8,13,1,1,7,12,1,4,10,8,18,0,0,1,6,4,18
337,Theo Ratliff,C,35,PHI,46,0,579,34,64,0,0,34,64,21,35,46,82,128,9,17,47,14,77,89
338,Michael Redd,SG,29,MIL,33,32,1203,249,547,70,191,179,356,131,161,24,83,107,88,35,2,53,45,699
339,J.J. Redick,SG,24,ORL,64,5,1111,117,299,67,179,50,120,81,93,8,101,109,73,21,1,54,72,382
340,Jason Richardson,SG,28,TOT,72,71,2410,465,974,129,325,336,649,153,199,77,242,319,146,76,28,95,146,1212
341,Jeremy Richardson,SF,24,ORL,12,0,93,14,49,6,17,8,32,3,6,1,13,14,3,0,0,3,6,37
342,Quentin Richardson,SG,28,NYK,72,51,1894,262,667,120,329,142,338,89,117,71,248,319,117,47,7,74,132,733
343,Luke Ridnour,PG,27,MIL,72,50,2033,250,621,55,157,195,464,133,153,33,185,218,365,92,16,128,200,688
344,Anthony Roberson,PG,25,TOT,29,0,276,44,120,26,81,18,39,5,5,6,16,22,20,10,1,8,18,119
345,Nate Robinson,PG,24,NYK,74,11,2209,449,1028,125,385,324,643,249,296,98,192,290,301,95,6,139,206,1272
346,Sergio Rodríguez,PG,22,POR,80,13,1225,129,329,37,114,92,215,61,77,43,87,130,286,54,2,119,133,356
347,Rajon Rondo,PG,22,BOS,80,80,2642,383,759,15,48,368,711,172,268,100,316,416,659,149,11,209,193,953
348,Derrick Rose,PG,20,CHI,81,80,3000,574,1208,16,72,558,1136,197,250,96,221,317,512,66,18,202,125,1361
350,Quinton Ross,SF,27,MEM,68,7,1164,99,259,33,88,66,171,34,42,29,97,126,47,32,14,36,114,265
351,Brandon Roy,SG,24,POR,78,78,2903,633,1318,83,220,550,1098,416,505,104,266,370,400,88,22,152,127,1765
352,Michael Ruffin,PF,32,POR,11,0,35,2,7,0,0,2,7,2,2,6,5,11,0,3,1,2,7,6
353,Brandon Rush,SG,23,IND,75,19,1803,243,575,78,209,165,366,46,66,34,199,233,66,38,37,75,128,610
354,Kareem Rush,SG,28,PHI,25,1,199,20,58,10,33,10,25,4,4,0,15,15,15,5,1,10,10,54
355,John Salmons,SF,29,TOT,79,74,2959,516,1093,126,302,390,791,288,347,59,274,333,249,83,24,165,182,1446
356,Cheikh Samb,C,24,TOT,18,0,83,6,32,0,3,6,29,3,7,10,14,24,1,3,10,3,7,15
357,Brian Scalabrine,C,30,BOS,39,8,504,48,114,24,61,24,53,16,18,7,43,50,18,7,10,12,73,136
358,Luis Scola,PF,28,HOU,82,82,2488,424,799,0,3,424,796,196,258,200,520,720,123,68,11,123,261,1044
360,Mouhamed Sene,C,22,TOT,6,0,29,6,9,0,0,6,9,8,10,5,9,14,0,1,3,4,2,20
361,Ramon Sessions,PG,22,MIL,79,39,2173,345,775,6,34,339,741,281,354,64,205,269,452,83,7,152,158,977
362,Walter Sharpe,PF,22,DET,8,0,20,4,11,0,2,4,9,0,2,0,3,3,0,0,2,0,3,8
363,Bobby Simmons,SF,28,NJN,71,44,1729,198,441,117,262,81,179,43,58,72,205,277,92,50,10,62,186,556
364,Cedric Simmons,PF,23,TOT,18,0,84,11,25,0,0,11,25,7,16,5,11,16,2,1,4,2,8,29
365,Courtney Sims,C,25,TOT,2,0,13,3,6,0,0,3,6,0,0,2,2,4,0,0,0,1,1,6
366,Sean Singletary,PG,23,TOT,37,2,303,31,85,10,25,21,60,18,21,10,25,35,29,11,0,23,45,90
367,James Singleton,PF,27,DAL,62,6,884,117,221,13,40,104,181,67,78,89,161,250,17,26,28,36,110,314
368,Brian Skinner,PF,32,LAC,51,21,843,92,205,0,2,92,203,30,47,72,131,203,27,17,52,43,94,214
369,Craig Smith,PF,25,MIN,74,31,1460,289,514,0,1,289,513,168,248,98,186,284,79,31,19,105,184,746
370,J.R. Smith,SG,23,DEN,81,18,2245,424,950,180,453,244,497,205,272,43,254,297,227,78,14,150,190,1233
371,Joe Smith,C,33,TOT,57,3,1102,156,333,3,7,153,326,59,82,89,174,263,41,17,40,25,122,374
372,Josh Smith,PF,23,ATL,69,69,2421,418,849,26,87,392,762,211,359,134,364,498,169,94,111,161,184,1073
373,Will Solomon,PG,30,TOT,53,9,712,105,245,28,86,77,159,25,34,12,52,64,133,27,4,54,71,263
374,Darius Songaila,C,30,WAS,77,29,1521,243,457,0,1,243,456,80,90,75,152,227,94,64,20,74,200,566
375,Marreese Speights,C,21,PHI,79,2,1263,252,502,2,8,250,494,102,132,123,170,293,30,27,56,46,181,608
376,Jerry Stackhouse,SG,34,DAL,10,1,162,16,60,3,19,13,41,7,7,5,12,17,12,4,1,9,6,42
377,DeShawn Stevenson,SG,27,WAS,32,25,886,72,231,35,129,37,102,32,60,11,65,76,98,21,2,32,43,211
378,Peja Stojaković,SF,31,NOH,61,59,2089,287,719,145,384,142,335,93,104,44,220,264,75,52,3,51,101,812
379,Amar'e Stoudemire,PF,26,PHO,53,53,1948,404,749,3,7,401,742,323,387,116,314,430,104,49,57,150,163,1134
380,Rodney Stuckey,PG,22,DET,79,65,2517,401,913,23,78,378,835,233,290,69,206,275,387,78,11,173,217,1058
381,Robert Swift,C,23,OKC,26,10,343,37,71,0,0,37,71,12,16,21,68,89,9,5,17,8,50,86
382,Stromile Swift,PF,29,TOT,19,0,185,24,56,1,1,23,55,13,26,16,30,46,3,4,8,16,40,62
383,Wally Szczerbiak,SF,31,CLE,74,5,1527,179,398,69,168,110,230,90,106,43,189,232,82,28,10,55,130,517
384,Mike Taylor,PG,23,LAC,51,5,771,110,267,13,40,97,227,56,81,22,65,87,106,36,0,73,84,289
385,Sebastian Telfair,PG,23,MIN,75,43,2095,267,697,73,211,194,486,131,160,32,95,127,343,73,12,146,184,738
386,Jason Terry,SG,31,DAL,74,11,2491,541,1168,167,456,374,712,198,225,39,138,177,251,97,20,119,141,1447
387,Etan Thomas,C,30,WAS,26,7,306,32,66,0,0,32,66,16,23,25,41,66,6,3,18,18,35,80
388,Kenny Thomas,PF,31,SAC,8,0,62,3,8,0,0,3,8,0,0,4,11,15,1,6,1,1,9,6
389,Kurt Thomas,PF,36,SAS,79,10,1404,153,304,0,2,153,302,37,45,134,271,405,66,34,58,42,170,343
390,Tim Thomas,PF,31,TOT,64,6,1247,189,438,78,189,111,249,89,121,42,159,201,68,31,11,70,144,545
391,Tyrus Thomas,PF,22,CHI,79,61,2175,308,683,3,9,305,674,238,304,148,360,508,77,91,151,129,220,857
392,Jason Thompson,PF,22,SAC,82,56,2303,356,717,0,8,356,709,198,286,234,372,606,93,46,59,146,314,910
393,Al Thornton,SF,25,LAC,71,67,2654,469,1051,20,79,449,972,236,313,122,246,368,103,59,62,130,227,1194
394,Anthony Tolliver,PF,23,SAS,19,0,208,19,65,9,41,10,24,5,10,12,29,41,17,5,1,7,16,52
395,Alando Tucker,SG,24,PHO,30,1,282,52,121,8,23,44,98,26,33,19,12,31,12,5,1,14,14,138
396,Ronny Turiaf,C,26,GSW,79,26,1696,186,366,0,3,186,363,98,124,88,272,360,166,34,168,70,243,470
397,Hedo Türkoğlu,SF,29,ORL,77,77,2815,423,1025,134,376,289,649,314,389,45,365,410,375,64,19,204,218,1294
398,Ime Udoka,SF,31,SAS,67,3,1035,110,287,41,125,69,162,28,46,28,159,187,54,36,12,38,86,289
399,Beno Udrih,PG,26,SAC,73,72,2270,321,696,35,113,286,583,123,150,46,174,220,342,81,12,158,192,800
400,Roko Ukić,PG,24,TOR,72,0,890,123,324,11,62,112,262,44,60,27,48,75,153,30,2,60,77,301
401,Anderson Varejão,PF,26,CLE,81,42,2306,270,504,0,2,270,502,154,250,166,415,581,81,75,66,80,239,694
402,Jacque Vaughn,PG,33,SAS,30,0,292,24,75,1,1,23,74,16,18,4,18,22,55,6,0,15,26,65
403,Charlie Villanueva,PF,24,MIL,78,47,2095,487,1089,89,258,398,831,201,240,154,366,520,137,50,56,138,254,1264
404,Jake Voskuhl,C,31,TOR,38,1,240,12,45,0,0,12,45,11,14,21,38,59,8,3,4,17,60,35
405,Sasha Vujačić,SG,24,LAL,80,0,1293,155,401,81,223,74,178,70,76,19,116,135,113,77,7,35,154,461
406,Dwyane Wade,SG,27,MIA,79,79,3048,854,1739,88,278,766,1461,590,771,89,309,398,589,173,106,272,178,2386
407,Von Wafer,SG,23,HOU,63,11,1225,229,512,64,164,165,348,88,117,19,94,113,71,40,8,59,71,610
408,Henry Walker,SF,21,BOS,29,0,216,36,58,0,1,36,57,16,23,8,21,29,13,6,2,18,51,88
409,Ben Wallace,PF,34,CLE,56,53,1314,69,155,0,0,69,155,27,64,136,226,362,44,48,75,34,82,165
410,Gerald Wallace,SF,26,CHA,71,71,2669,389,811,39,131,350,680,365,454,112,441,553,189,121,67,148,210,1182
411,Rasheed Wallace,C,34,DET,66,63,2123,302,720,113,319,189,401,78,101,56,434,490,91,62,86,59,197,795
412,Luke Walton,SF,28,LAL,65,34,1166,134,307,17,57,117,250,41,57,55,125,180,177,32,10,69,105,326
413,Hakim Warrick,PF,26,MEM,82,7,2029,340,693,5,23,335,670,266,374,129,277,406,66,48,39,98,170,951
414,C.J. Watson,PG,24,GSW,77,18,1883,257,562,48,120,209,442,168,193,39,153,192,206,96,4,92,137,730
415,Earl Watson,PG,29,OKC,68,18,1776,174,453,20,85,154,368,80,106,36,147,183,391,50,11,156,137,448
416,Kyle Weaver,SG,22,OKC,56,19,1166,113,246,32,93,81,153,41,58,31,99,130,101,47,25,69,81,299
417,Martell Webster,SF,22,POR,1,0,5,0,1,0,1,0,0,0,0,0,0,0,0,0,0,0,0,0
418,Sonny Weems,SG,22,DEN,12,0,55,8,25,0,3,8,22,3,8,0,4,4,3,1,0,6,8,19
419,David West,PF,28,NOH,76,76,2982,610,1292,6,25,604,1267,367,415,160,486,646,173,49,68,163,207,1593
420,Delonte West,SG,25,CLE,64,64,2152,285,624,91,228,194,396,90,108,31,172,203,226,94,13,92,125,751
421,Mario West,SG,24,ATL,53,3,269,14,34,1,1,13,33,14,30,24,32,56,19,18,4,13,35,43
422,Russell Westbrook,PG,20,OKC,82,65,2668,436,1095,35,129,401,966,349,428,178,221,399,435,110,16,274,191,1256
423,D.J. White,PF,22,OKC,7,0,130,26,50,0,0,26,50,10,13,10,22,32,6,3,5,3,10,62
424,James White,SF,26,HOU,4,0,11,3,5,1,2,2,3,0,0,0,0,0,1,1,1,3,2,7
425,Chris Wilcox,C,26,TOT,62,6,1049,184,370,0,4,184,366,79,140,96,181,277,47,26,16,75,137,447
426,Damien Wilkins,SG,29,OKC,41,14,636,77,213,27,72,50,141,37,46,20,50,70,37,22,7,37,55,218
427,Deron Williams,PG,24,UTA,68,68,2505,463,984,70,226,393,758,326,384,24,171,195,725,73,20,228,134,1322
428,Jawad Williams,SF,25,CLE,10,0,20,5,12,2,6,3,6,0,0,1,1,2,0,1,0,1,2,12
429,Lou Williams,SG,22,PHI,81,0,1919,336,844,63,220,273,624,304,385,36,129,165,242,85,14,151,128,1039
430,Marcus Williams,PG,23,GSW,9,0,54,4,17,2,6,2,11,2,6,0,4,4,13,1,1,4,6,12
432,Marvin Williams,SF,22,ATL,61,59,2093,285,622,55,155,230,467,220,273,110,272,382,81,57,39,70,127,845
433,Mo Williams,PG,26,CLE,81,81,2834,526,1126,183,420,343,706,208,228,47,232,279,329,69,9,179,215,1443
434,Sean Williams,PF,22,NJN,33,0,366,30,72,0,0,30,72,20,32,34,45,79,13,7,29,20,72,80
435,Shawne Williams,SF,22,DAL,15,0,170,16,56,1,17,15,39,9,11,19,27,46,2,2,9,5,19,42
436,Shelden Williams,PF,25,TOT,45,0,512,70,157,0,2,70,155,46,63,49,104,153,12,22,18,34,64,186
437,Metta World Peace,SF,29,HOU,69,55,2452,416,1037,153,383,263,654,196,262,65,294,359,229,105,24,140,155,1181
438,Antoine Wright,SF,24,DAL,65,53,1552,179,431,45,149,134,282,71,95,31,105,136,77,46,27,54,172,474
439,Brandan Wright,PF,21,GSW,39,23,688,130,246,0,4,130,242,63,85,62,95,157,21,22,37,23,74,323
440,Dorell Wright,SF,23,MIA,6,0,73,8,20,0,0,8,20,2,6,2,18,20,2,2,0,6,8,18
441,Julian Wright,SF,21,NOH,54,19,772,109,234,2,21,107,213,17,30,46,106,152,43,35,19,43,49,237
442,Lorenzen Wright,C,33,CLE,17,2,125,10,27,0,0,10,27,3,8,7,18,25,3,4,5,9,17,23
443,Nick Young,SG,23,WAS,82,5,1837,336,756,56,164,280,592,164,193,31,119,150,95,39,20,92,140,892
444,Thaddeus Young,PF,20,PHI,75,71,2580,475,960,56,164,419,796,139,189,139,238,377,86,100,23,118,165,1145
445,Sun Yue,SG,23,LAL,10,0,28,3,11,0,6,3,5,0,0,0,0,0,2,1,1,3,10,6
1,Arron Afflalo,SG,24,DEN,82,75,2221,272,585,108,249,164,336,72,98,59,193,252,138,46,30,74,225,724
2,Alexis Ajinça,C,21,CHA,6,0,30,5,10,0,0,5,10,0,1,1,3,4,0,1,1,2,5,10
3,LaMarcus Aldridge,PF,24,POR,78,78,2922,579,1169,5,16,574,1153,230,304,192,435,627,160,67,48,104,231,1393
4,Joe Alexander,SF,23,CHI,8,0,29,1,6,0,1,1,5,2,3,2,3,5,2,1,1,0,9,4
5,Malik Allen,PF,31,DEN,51,3,456,46,116,1,6,45,110,12,13,36,46,82,16,11,5,22,68,105
6,Ray Allen*,SG,34,BOS,80,80,2819,464,973,145,399,319,574,231,253,45,208,253,210,64,25,129,182,1304
7,Tony Allen,SG,28,BOS,54,8,889,129,253,0,5,129,248,72,119,52,93,145,72,59,19,66,109,330
8,Rafer Alston,PG,33,TOT,52,38,1421,155,446,58,168,97,278,59,81,13,116,129,176,50,10,95,103,427
9,Lou Amundson,PF,27,PHO,79,0,1168,152,276,0,1,152,275,67,123,128,218,346,31,24,73,57,169,371
10,Chris Andersen,PF,31,DEN,76,0,1695,142,251,0,3,142,248,164,236,147,336,483,33,42,143,59,171,448
11,David Andersen,C,29,HOU,63,0,891,147,340,27,78,120,262,46,67,54,154,208,44,15,12,37,119,367
12,Antonio Anderson,SF,24,OKC,1,0,15,1,3,0,0,1,3,0,0,1,0,1,0,0,0,1,1,2
13,Ryan Anderson,PF,21,ORL,63,6,911,169,388,78,211,91,177,71,82,70,132,202,37,25,14,56,81,487
14,Carmelo Anthony,SF,25,DEN,69,69,2634,688,1502,59,187,629,1315,508,612,152,302,454,222,88,30,209,225,1943
15,Joel Anthony,C,27,MIA,80,16,1322,76,159,0,0,76,159,66,92,123,126,249,12,20,109,45,158,218
16,Gilbert Arenas,PG,28,WAS,32,32,1169,253,616,63,181,190,435,153,207,17,116,133,230,41,9,117,95,722
17,Trevor Ariza,SF,24,HOU,72,71,2629,394,999,136,407,258,592,148,228,78,325,403,276,126,40,161,162,1072
19,Carlos Arroyo,PG,30,MIA,72,35,1585,178,375,7,25,171,350,76,90,26,104,130,225,36,6,54,102,439
20,Darrell Arthur,PF,21,MEM,32,1,457,63,146,0,1,63,145,17,30,37,73,110,15,14,14,22,60,143
21,Chucky Atkins,PG,35,DET,40,11,644,57,157,22,73,35,84,25,27,5,24,29,91,17,0,32,53,161
22,D.J. Augustin,PG,22,CHA,80,2,1472,168,435,70,178,98,257,102,131,11,86,97,193,45,5,74,127,508
23,Jeff Ayres,C,22,POR,39,4,405,43,65,0,0,43,65,18,20,25,73,98,1,7,16,12,76,104
24,Kelenna Azubuike,SF,26,GSW,9,7,231,48,88,10,27,38,61,19,28,12,29,41,10,5,9,7,16,125
25,Renaldo Balkman,SF,25,DEN,13,1,91,6,18,0,7,6,11,2,6,4,19,23,7,8,2,6,16,14
26,Marcus Banks,PG,28,TOR,22,0,244,39,73,7,24,32,49,24,29,3,20,23,26,12,2,20,30,109
27,Leandro Barbosa,PG,27,PHO,44,5,786,155,365,44,136,111,229,64,73,11,58,69,64,23,12,46,71,418
28,J.J. Barea,PG,25,DAL,78,18,1546,232,527,56,157,176,370,76,90,17,129,146,258,35,6,102,119,596
29,Andrea Bargnani,PF,24,TOR,80,80,2799,537,1143,121,325,416,818,181,234,105,388,493,93,25,111,120,215,1376
30,Matt Barnes,SF,29,ORL,81,58,2097,271,557,66,207,205,350,108,146,106,339,445,134,59,30,112,185,716
31,Earl Barron,C,28,NYK,7,6,232,30,68,0,0,30,68,22,29,31,46,77,8,4,4,11,24,82
32,Brandon Bass,PF,24,ORL,50,3,648,119,233,0,0,119,233,52,63,54,73,127,19,12,27,31,69,290
33,Tony Battie,C,33,NJN,15,0,134,14,40,1,4,13,36,7,10,4,19,23,3,4,2,3,19,36
34,Shane Battier,SG,31,HOU,67,62,2168,178,447,101,279,77,168,77,106,74,238,312,164,53,76,64,139,534
35,Nicolas Batum,SF,21,POR,37,25,918,139,268,54,132,85,136,43,51,32,109,141,44,24,25,27,83,375
36,Jerryd Bayless,SG,21,POR,74,11,1304,200,483,29,92,171,391,201,242,18,102,120,172,26,5,94,152,630
37,Michael Beasley,PF,21,MIA,78,78,2328,468,1040,28,102,440,938,192,240,123,375,498,100,80,49,131,221,1156
38,Rodrigue Beaubois,PG,21,DAL,56,16,700,155,299,45,110,110,189,42,52,12,66,78,74,29,12,54,84,397
39,Marco Belinelli,SG,23,TOR,66,1,1121,154,379,60,158,94,221,101,121,14,81,95,89,42,5,60,80,469
40,Charlie Bell,SG,30,MIL,71,39,1611,169,443,73,200,96,243,48,67,31,101,132,104,39,12,54,136,459
41,Raja Bell,SG,33,TOT,6,5,180,28,61,12,27,16,34,3,3,5,18,23,13,4,2,5,15,71
42,Jonathan Bender,SF,29,NYK,25,1,292,40,100,14,39,26,61,24,26,15,37,52,16,2,17,28,33,118
43,Mike Bibby,PG,31,ATL,80,80,2195,268,644,126,324,142,320,68,79,20,164,184,310,67,3,90,157,730
44,Andris Biedriņš,C,23,GSW,33,29,763,81,137,0,0,81,137,4,25,63,196,259,57,20,44,32,117,166
45,Chauncey Billups,PG,33,DEN,73,73,2490,402,962,157,407,245,555,466,512,25,203,228,409,82,9,177,153,1427
46,DeJuan Blair,PF,20,SAS,82,23,1494,275,495,0,2,275,493,88,161,200,326,526,65,50,39,112,224,638
47,Steve Blake,PG,29,TOT,80,38,2159,217,522,116,294,101,228,36,48,21,166,187,380,58,6,128,123,586
48,Andray Blatche,PF,23,WAS,81,36,2256,478,999,13,44,465,955,174,234,158,351,509,170,85,71,182,218,1143
49,Keith Bogans,SF,29,SAS,79,50,1559,120,298,70,196,50,102,37,50,25,151,176,95,45,12,53,156,347
50,Andrew Bogut,C,25,MIL,69,69,2229,473,910,0,2,473,908,149,237,208,493,701,127,39,175,131,222,1095
51,Matt Bonner,PF,29,SAS,65,8,1161,166,372,90,231,76,141,35,48,52,162,214,68,30,24,39,109,457
52,Josh Boone,PF,25,NJN,63,28,1045,117,223,0,0,117,223,19,58,124,191,315,29,30,48,37,111,253
53,Carlos Boozer,PF,28,UTA,78,78,2673,617,1098,0,0,617,1098,285,384,181,693,874,247,84,36,212,270,1519
54,Chris Bosh,C,25,TOR,70,70,2526,600,1158,8,22,592,1136,470,590,205,554,759,166,43,68,169,170,1678
55,Ryan Bowen,SF,34,OKC,1,0,8,1,1,0,0,1,1,2,2,1,1,2,0,1,0,0,2,4
56,Earl Boykins,PG,33,WAS,67,1,1117,172,403,19,60,153,343,77,89,17,58,75,171,24,3,69,48,440
57,Elton Brand,PF,30,PHI,76,57,2297,412,858,0,1,412,857,172,233,179,282,461,109,82,80,131,232,996
58,Corey Brewer,SG,23,MIN,82,82,2482,409,949,82,237,327,712,166,256,70,209,279,193,117,29,164,224,1066
59,Ronnie Brewer,SG,24,TOT,58,53,1742,209,429,8,31,201,398,85,133,45,142,187,154,91,15,53,80,511
60,Primož Brezec,C,30,TOT,21,0,95,9,26,0,0,9,26,1,6,12,13,25,1,1,3,2,19,19
61,Jon Brockman,PF,22,SAC,52,4,654,55,103,0,0,55,103,37,62,105,108,213,22,15,5,23,115,147
62,Aaron Brooks,PG,25,HOU,82,82,2919,575,1331,209,525,366,806,245,298,54,161,215,434,69,14,232,199,1604
63,Bobby Brown,PG,25,TOT,45,0,519,88,237,26,98,62,139,13,15,9,29,38,88,15,1,46,42,215
64,Derrick Brown,SF,22,CHA,57,0,535,68,147,2,7,66,140,48,72,31,47,78,19,21,10,19,53,186
65,Devin Brown,SG,31,TOT,50,37,1060,136,361,58,164,78,197,69,86,29,95,124,65,33,6,62,72,399
66,Kwame Brown,C,27,DET,48,1,660,62,124,0,1,62,123,33,98,53,124,177,22,15,12,43,93,157
67,Shannon Brown,SG,24,LAL,82,7,1700,253,592,62,189,191,403,99,121,30,153,183,108,57,31,67,129,667
68,Kobe Bryant,SG,31,LAL,73,73,2835,716,1569,99,301,617,1268,439,541,78,313,391,365,113,20,233,187,1970
69,Chase Budinger,SF,21,HOU,74,4,1488,249,565,92,249,157,316,67,87,38,182,220,88,34,11,48,85,657
71,Rasual Butler,SF,30,LAC,82,64,2702,356,870,145,432,211,438,122,145,39,201,240,116,36,68,79,121,979
72,Andrew Bynum,C,22,LAL,65,65,1977,392,688,0,1,392,687,193,261,177,364,541,68,35,94,115,193,977
73,Will Bynum,PG,27,DET,63,20,1667,237,534,12,55,225,479,142,178,24,118,142,283,55,7,115,143,628
74,José Calderón,PG,28,TOR,68,39,1817,274,568,68,171,206,397,83,104,23,119,142,404,47,7,99,135,699
76,Brian Cardinal,PF,32,MIN,29,0,267,14,36,3,9,11,27,17,18,7,22,29,24,9,3,7,56,48
77,Rodney Carney,SG,25,PHI,68,0,857,113,282,41,135,72,147,52,63,26,111,137,37,25,20,21,79,319
78,DeMarre Carroll,SF,23,MEM,71,1,795,88,222,0,6,88,216,33,53,53,97,150,33,28,9,24,107,209
79,Matt Carroll,SG,29,DAL,25,0,121,18,50,4,19,14,31,6,6,4,8,12,6,5,0,7,13,46
80,Anthony Carter,PG,34,DEN,54,7,859,76,181,17,63,59,118,11,13,17,72,89,160,39,13,58,72,180
81,Vince Carter,SG,33,ORL,75,74,2310,434,1015,119,324,315,691,257,306,33,260,293,236,53,18,106,189,1244
82,Omri Casspi,SF,21,SAC,77,31,1931,300,672,75,203,225,469,117,174,75,274,349,95,54,17,98,125,792
83,Mario Chalmers,PG,23,MIA,73,22,1807,182,454,75,236,107,218,82,110,25,110,135,246,91,12,123,175,521
84,Tyson Chandler,C,27,CHA,51,27,1163,109,190,0,0,109,190,115,157,114,206,320,16,17,55,91,138,333
85,Wilson Chandler,SG,22,NYK,65,64,2320,412,860,40,150,372,710,129,160,93,255,348,138,46,49,108,184,993
86,Earl Clark,PF,22,PHO,51,0,383,56,151,2,5,54,146,26,36,18,44,62,21,7,13,23,25,140
87,Jarron Collins,C,31,PHO,34,10,261,12,31,0,0,12,31,10,25,22,40,62,6,2,3,10,42,34
88,Jason Collins,C,31,ATL,24,0,115,8,23,0,1,8,22,0,2,5,9,14,4,3,2,5,21,16
89,Mardy Collins,SG,25,LAC,43,0,470,47,128,4,17,43,111,13,21,13,37,50,44,23,1,32,45,111
90,Darren Collison,PG,22,NOH,76,37,2109,376,789,46,115,330,674,148,174,41,151,192,432,78,4,202,92,946
91,Nick Collison,C,29,OKC,75,5,1557,182,309,1,4,181,305,74,107,152,232,384,38,37,48,63,230,439
92,Mike Conley,PG,22,MEM,80,80,2569,369,830,82,212,287,618,139,187,30,161,191,425,109,12,170,178,959
93,Will Conroy,PG,27,HOU,5,0,36,3,10,0,3,3,7,0,2,0,3,3,7,0,0,4,5,6
94,Brian Cook,PF,29,HOU,15,0,44,7,23,2,9,5,14,5,7,1,8,9,1,0,2,6,5,21
95,Daequan Cook,SG,22,MIA,45,3,691,81,253,40,126,41,127,21,25,9,73,82,43,14,10,24,50,223
96,Jamal Crawford,SG,29,ATL,79,0,2460,496,1105,163,427,333,678,270,315,34,167,201,238,61,12,137,132,1425
97,Dante Cunningham,PF,22,POR,63,2,707,106,214,0,2,106,212,31,48,54,106,160,14,24,22,15,97,243
98,Eddy Curry,C,27,NYK,7,0,62,8,21,0,0,8,21,10,17,4,9,13,0,0,1,13,13,26
99,JamesOn Curry,PG,24,LAC,1,0,0,0,0,0,0,0,0,0,0,0,0,0,0,0,0,0,0,0
100,Stephen Curry,PG,21,GSW,80,77,2896,528,1143,166,380,362,763,177,200,48,308,356,472,152,19,243,252,1399
101,Samuel Dalembert,C,28,PHI,82,80,2124,285,523,0,0,285,523,97,133,239,545,784,64,42,151,123,252,667
102,Erick Dampier,C,34,DAL,55,47,1280,133,213,1,3,132,210,61,101,128,272,400,31,15,77,61,153,328
103,Marquis Daniels,SF,29,BOS,51,4,937,124,249,6,28,118,221,34,56,27,68,95,66,27,6,42,91,288
104,Baron Davis,PG,30,LAC,75,73,2523,412,1015,82,296,330,719,239,291,52,214,266,598,126,43,211,210,1145
105,Glen Davis,PF,24,BOS,54,1,933,122,279,0,4,122,275,96,138,101,104,205,35,21,14,53,132,340
106,Paul Davis,PF,25,WAS,2,0,8,2,4,0,0,2,4,1,2,0,0,0,3,0,1,0,0,5
107,Ricky Davis,SF,30,LAC,36,2,499,62,143,16,42,46,101,18,31,10,47,57,39,11,3,29,39,158
108,Austin Daye,SF,21,DET,69,4,915,137,295,29,95,108,200,46,56,34,140,174,34,25,26,48,114,349
109,Carlos Delfino,SF,27,MIL,75,66,2279,299,732,134,365,165,367,93,119,51,343,394,202,80,21,119,138,825
110,Luol Deng,SF,24,CHI,70,69,2651,473,1014,32,83,441,931,252,330,131,381,512,143,66,61,134,129,1230
111,DeMar DeRozan,SG,20,TOR,77,65,1664,255,512,4,16,251,496,148,194,66,157,223,53,43,18,62,176,662
112,Boris Diaw,PF,27,CHA,82,82,2906,373,773,66,206,307,567,113,147,131,293,424,325,60,57,178,219,925
113,Yakhouba Diawara,SG,27,MIA,6,2,44,2,10,1,6,1,4,0,0,1,3,4,3,1,0,3,8,5
114,Travis Diener,PG,27,TOT,9,0,51,2,10,1,7,1,3,1,4,0,3,3,8,4,0,0,2,6
115,DeSagana Diop,C,28,CHA,27,0,262,15,29,0,0,15,29,2,9,24,41,65,5,5,14,12,31,32
116,Keyon Dooling,PG,29,NJN,53,8,971,129,324,59,157,70,167,47,61,8,46,54,135,34,0,59,82,364
117,Joey Dorsey,PF,26,TOT,15,0,106,9,20,0,0,9,20,5,12,16,27,43,2,3,2,6,21,23
118,Toney Douglas,PG,23,NYK,56,12,1087,179,391,68,175,111,216,55,68,40,68,108,112,42,3,55,116,481
119,Chris Douglas-Roberts,SF,23,NJN,67,38,1730,255,573,14,54,241,519,133,157,45,153,198,93,55,19,97,101,657
120,Goran Dragić,PG,23,PHO,80,2,1442,222,491,74,188,148,303,117,159,38,133,171,241,48,8,126,131,635
121,Jared Dudley,SF,24,PHO,82,1,1991,225,490,120,262,105,228,104,138,99,182,281,115,81,16,68,162,674
122,Chris Duhon,PG,27,NYK,67,59,2072,168,451,90,258,78,193,68,95,28,150,178,378,59,3,110,83,494
123,Tim Duncan,C,33,SAS,78,77,2438,561,1082,2,11,559,1071,271,374,221,567,788,246,45,117,140,152,1395
124,Mike Dunleavy,SF,29,IND,67,15,1486,229,558,75,236,154,322,133,158,25,211,236,103,38,15,72,105,666
125,Kevin Durant,SF,21,OKC,82,82,3239,794,1668,128,351,666,1317,756,840,105,518,623,231,112,84,271,171,2472
126,Wayne Ellington,SG,22,MIN,76,1,1384,190,448,64,162,126,286,61,70,33,126,159,74,20,5,74,72,505
127,Monta Ellis,SG,24,GSW,64,64,2647,631,1406,77,228,554,1178,292,388,47,210,257,340,143,25,244,189,1631
128,Francisco Elson,C,33,TOT,12,0,66,5,15,0,0,5,15,2,5,6,8,14,2,1,0,1,7,12
129,Maurice Evans,SF,31,ATL,79,5,1317,175,393,57,169,118,224,46,61,59,95,154,48,34,17,20,125,453
130,Reggie Evans,PF,29,TOR,28,1,311,34,69,0,0,34,69,27,60,30,75,105,8,14,4,22,44,95
131,Tyreke Evans,SG,20,SAC,72,72,2677,533,1165,36,141,497,1024,348,465,66,314,380,414,109,26,216,204,1450
132,Jordan Farmar,PG,23,LAL,82,0,1474,224,515,86,229,138,286,57,85,14,117,131,127,52,11,72,109,591
133,Raymond Felton,PG,25,CHA,80,80,2643,388,846,60,156,328,690,132,173,53,235,288,446,123,22,168,172,968
134,Rudy Fernández,SG,24,POR,62,2,1441,160,423,98,266,62,157,85,98,35,129,164,127,62,11,72,87,503
135,Kyrylo Fesenko,C,23,UTA,49,5,408,52,95,0,1,52,94,24,57,33,57,90,15,6,19,24,78,128
136,Michael Finley,SF,36,TOT,46,7,709,81,184,32,82,49,102,8,15,6,65,71,43,10,6,21,33,202
137,Derek Fisher,PG,35,LAL,82,82,2227,212,558,78,224,134,334,113,132,25,145,170,201,90,9,78,202,615
138,Jonny Flynn,PG,20,MIN,81,81,2339,397,952,77,215,320,737,223,270,24,167,191,356,82,2,233,98,1094
139,T.J. Ford,PG,26,IND,47,32,1189,186,418,8,50,178,368,104,135,41,108,149,180,44,11,90,102,484
140,Jeff Foster,C,33,IND,16,3,255,22,46,0,1,22,45,5,9,34,47,81,21,3,4,14,45,49
141,Randy Foye,PG,26,WAS,70,38,1667,256,619,63,182,193,437,129,145,16,114,130,228,33,10,94,123,704
142,Channing Frye,C,26,PHO,81,41,2190,317,703,172,392,145,311,98,121,66,361,427,113,64,74,73,263,904
143,Dan Gadzuric,C,31,MIL,32,6,314,39,89,0,0,39,89,10,25,38,54,92,12,9,13,15,63,88
144,Sundiata Gaines,PG,23,UTA,32,0,217,38,82,7,26,31,56,23,46,6,23,29,39,12,0,14,17,106
145,Danilo Gallinari,SF,21,NYK,81,74,2747,392,927,186,488,206,439,251,307,65,333,398,135,75,58,110,191,1221
146,Francisco García,SG,28,SAC,25,4,575,82,176,23,59,59,117,15,17,11,55,66,45,10,19,21,49,202
147,Kevin Garnett,PF,33,BOS,69,69,2060,402,772,1,5,401,767,185,221,78,428,506,185,68,57,101,170,990
148,Marc Gasol,C,25,MEM,69,69,2469,378,651,0,1,378,650,252,376,208,432,640,165,69,109,135,254,1008
149,Pau Gasol,C,29,LAL,65,65,2403,452,844,0,5,452,839,286,362,243,491,734,218,37,113,143,152,1190
150,Rudy Gay,SF,23,MEM,80,80,3175,600,1288,66,202,534,1086,301,400,115,357,472,153,118,64,169,201,1567
151,Alonzo Gee,SG,22,WAS,11,2,182,28,59,7,9,21,50,18,29,15,18,33,7,7,1,10,13,81
152,Devean George,SF,32,GSW,45,4,761,89,206,48,123,41,83,16,23,21,93,114,32,41,10,15,89,242
153,Daniel Gibson,PG,23,CLE,56,10,1068,125,268,71,149,54,119,34,49,13,60,73,70,25,7,36,79,355
154,Taj Gibson,PF,24,CHI,82,70,2204,311,629,0,0,311,629,113,175,226,385,611,70,50,104,114,282,735
155,J.R. Giddens,SF,24,TOT,32,1,239,28,60,0,10,28,50,13,23,16,35,51,13,9,2,17,29,69
156,Trey Gilder,SF,25,MEM,2,0,5,1,1,0,0,1,1,0,0,0,1,1,0,1,0,0,0,2
157,Manu Ginóbili,SG,32,SAS,75,21,2150,398,903,132,350,266,553,309,355,68,216,284,370,103,24,154,154,1237
158,Ryan Gomes,SF,27,MIN,76,64,2210,327,732,74,199,253,533,104,126,76,272,348,124,62,16,95,155,832
160,Ben Gordon,SG,26,DET,62,17,1730,291,699,75,234,216,465,198,230,26,93,119,166,49,6,118,147,855
161,Eric Gordon,SG,21,LAC,62,60,2229,352,784,119,321,233,463,222,299,25,135,160,186,69,14,144,96,1045
162,Marcin Gortat,C,25,ORL,81,0,1088,121,227,0,3,121,224,51,75,104,237,341,17,17,70,46,138,293
163,Joey Graham,SF,27,DEN,63,18,759,105,202,2,13,103,189,54,73,39,84,123,22,23,7,43,104,266
164,Stephen Graham,SG,27,CHA,70,8,804,119,240,16,50,103,190,42,65,24,111,135,23,20,10,36,94,296
165,Danny Granger,SF,26,IND,62,62,2278,488,1139,158,438,330,701,363,428,67,275,342,171,94,51,157,183,1497
166,Aaron Gray,C,25,TOT,32,0,311,42,82,0,0,42,82,20,28,45,61,106,22,9,11,18,54,104
167,Danny Green,SG,22,CLE,20,0,115,15,39,6,22,9,17,4,6,8,9,17,5,6,3,5,9,40
168,Jeff Green,PF,23,OKC,82,82,3043,485,1070,104,312,381,758,165,223,112,378,490,134,104,72,135,221,1239
169,Willie Green,SG,28,PHI,73,18,1553,248,543,47,136,201,407,95,114,20,109,129,152,32,11,67,135,638
170,Donté Greene,SF,21,SAC,76,50,1630,244,553,69,183,175,370,90,140,53,181,234,71,41,53,93,150,647
171,Taylor Griffin,SF,23,PHO,8,0,32,4,10,0,2,4,8,2,4,0,2,2,1,0,2,1,4,10
172,Hamed Haddadi,C,24,MEM,36,0,240,24,62,0,3,24,59,14,19,26,49,75,10,1,14,20,57,62
173,Malik Hairston,SG,22,SAS,47,0,317,40,76,2,11,38,65,17,30,13,36,49,16,4,9,11,29,99
174,Marcus Haislip,SF,29,SAS,10,0,44,10,21,3,5,7,16,2,5,4,6,10,0,0,2,3,5,25
175,Richard Hamilton,SG,31,DET,46,46,1552,293,717,41,138,252,579,204,241,30,92,122,202,30,3,115,115,831
176,Tyler Hansbrough,PF,24,IND,29,1,511,81,225,0,4,81,221,84,113,60,78,138,28,17,8,21,70,246
177,James Harden,SG,20,OKC,76,0,1738,233,578,93,248,140,330,194,240,47,197,244,137,80,20,106,200,753
178,Al Harrington,PF,29,NYK,72,15,2195,448,1030,140,409,308,621,240,317,88,317,405,110,62,26,132,209,1276
179,Devin Harris,PG,26,NJN,64,61,2221,356,884,60,217,296,667,308,386,24,179,203,423,79,18,181,178,1080
180,Mike Harris,PF,26,TOT,13,0,96,11,30,0,1,11,29,7,11,10,14,24,3,5,1,9,14,29
181,Jason Hart,PG,31,TOT,5,0,22,1,2,0,0,1,2,0,0,0,2,2,6,2,1,3,4,2
182,Udonis Haslem,PF,29,MIA,78,0,2177,312,632,0,0,312,632,147,193,167,462,629,52,30,23,75,174,771
183,Trenton Hassell,SF,30,NJN,52,31,1106,90,219,0,5,90,214,52,69,56,96,152,50,17,9,47,91,232
184,Spencer Hawes,C,21,SAC,72,59,1904,312,666,26,87,286,579,73,106,145,291,436,158,32,83,131,200,723
185,Chuck Hayes,C,26,HOU,82,82,1773,161,329,0,0,161,329,36,66,151,314,465,139,73,43,74,219,358
186,Jarvis Hayes,SF,28,NJN,45,19,1033,138,328,60,179,78,149,14,18,9,99,108,40,29,9,28,91,350
187,Brendan Haywood,C,30,TOT,77,67,2355,276,491,0,1,276,490,152,245,278,437,715,43,26,158,99,209,704
188,Luther Head,SG,27,IND,47,10,813,136,311,37,105,99,206,48,58,6,74,80,72,18,9,54,53,357
189,Gerald Henderson,SG,22,CHA,43,0,355,37,104,4,19,33,85,35,47,15,40,55,13,10,9,14,25,113
190,Roy Hibbert,C,23,IND,81,69,2035,387,782,3,6,384,776,169,224,177,287,464,158,30,131,145,285,946
191,J.J. Hickson,PF,21,CLE,81,73,1691,289,522,0,1,289,521,111,163,110,290,400,40,36,39,92,132,689
192,Nenê Hilário,C,27,DEN,82,82,2755,421,717,0,2,421,715,293,416,166,461,627,203,115,82,125,281,1135
193,George Hill,PG,23,SAS,78,43,2276,353,738,75,188,278,550,183,237,42,163,205,226,69,26,101,222,964
194,Grant Hill*,SF,37,PHO,81,81,2430,336,703,35,80,301,623,205,251,74,371,445,193,60,36,108,165,912
195,Jordan Hill,PF,22,TOT,47,0,624,99,201,0,2,99,199,46,68,76,99,175,20,14,21,30,92,244
196,Kirk Hinrich,SG,29,CHI,74,53,2481,308,753,104,280,204,473,85,113,24,236,260,330,85,24,113,204,805
197,Jrue Holiday,PG,19,PHI,73,51,1767,230,520,62,159,168,361,65,86,56,135,191,280,79,18,156,153,587
198,Ryan Hollins,C,25,MIN,73,27,1223,169,303,0,1,169,302,109,158,79,128,207,51,19,38,95,199,447
199,Al Horford,C,23,ATL,81,81,2845,467,847,1,1,466,846,213,270,236,563,799,189,59,91,122,225,1148
201,Dwight Howard,C,24,ORL,82,82,2843,510,834,0,7,510,827,483,816,284,798,1082,144,75,228,274,287,1503
202,Josh Howard,SF,29,TOT,35,12,918,157,388,23,86,134,302,109,139,30,95,125,48,26,11,46,91,446
203,Juwan Howard,C,36,POR,73,27,1632,191,375,0,1,191,374,55,70,108,227,335,61,27,10,72,191,437
204,Lester Hudson,PG,25,TOT,25,0,131,21,53,5,16,16,37,11,13,7,11,18,13,8,3,14,12,58
205,Larry Hughes,SG,31,TOT,45,16,1115,137,386,43,139,94,247,94,113,23,119,142,137,52,15,75,70,411
206,Kris Humphries,PF,24,TOT,69,0,1221,180,408,0,1,180,407,127,190,120,258,378,32,36,48,66,145,487
207,Chris Hunter,C,25,GSW,60,9,783,109,217,0,4,109,213,52,69,56,111,167,37,13,35,30,132,270
208,Lindsey Hunter,PG,39,CHI,13,0,122,5,30,1,13,4,17,2,2,1,13,14,9,1,0,4,12,13
209,Othello Hunter,SF,23,ATL,7,0,33,4,12,0,0,4,12,3,4,6,6,12,0,0,1,3,5,11
210,Steven Hunter,C,28,MEM,21,0,158,17,43,0,0,17,43,19,36,18,24,42,0,1,10,9,10,53
211,Serge Ibaka,PF,20,OKC,73,0,1323,201,370,1,2,200,368,58,92,138,259,397,10,25,97,68,194,461
212,Andre Iguodala,SF,26,PHI,82,82,3193,496,1120,94,303,402,817,315,430,82,447,529,472,141,55,218,145,1401
213,Zydrunas Ilgauskas,C,34,CLE,64,6,1339,194,438,11,23,183,415,75,101,114,231,345,48,14,50,63,183,474
214,Didier Ilunga-Mbenga,C,29,LAL,49,2,355,48,103,0,0,48,103,9,19,32,55,87,8,5,29,15,54,105
215,Ersan İlyasova,PF,22,MIL,81,31,1898,323,729,81,241,242,488,113,158,157,360,517,84,53,23,71,251,840
217,Royal Ivey,SG,28,TOT,44,0,326,35,83,14,35,21,48,9,12,6,28,34,27,19,2,11,39,93
218,Jarrett Jack,PG,26,TOR,82,43,2243,323,671,82,199,241,472,203,241,30,192,222,413,60,6,163,151,931
219,Cedric Jackson,PG,23,TOT,12,0,74,6,20,1,6,5,14,7,12,2,6,8,14,3,2,11,7,20
220,Darnell Jackson,PF,24,TOT,28,0,123,9,30,1,4,8,26,4,6,9,13,22,4,2,4,13,21,23
222,LeBron James,SF,25,CLE,76,76,2966,768,1528,129,387,639,1141,593,773,71,483,554,651,125,77,261,119,2258
223,Mike James,PG,34,WAS,4,0,46,6,20,2,6,4,14,4,8,1,2,3,5,3,0,5,3,18
224,Antawn Jamison,PF,33,TOT,66,64,2406,478,1036,85,247,393,789,194,300,136,419,555,84,71,21,91,179,1235
225,Nathan Jawai,C,23,MIN,39,2,412,49,111,0,1,49,110,26,38,49,55,104,24,10,9,27,58,124
226,Othyus Jeffers,SG,24,UTA,14,0,73,12,29,0,0,12,29,13,19,8,11,19,1,4,0,6,10,37
227,Al Jefferson,C,25,MIN,76,76,2463,560,1125,0,4,560,1121,181,266,180,523,703,137,63,98,136,205,1301
228,Richard Jefferson,SF,29,SAS,81,70,2520,362,775,59,187,303,588,211,287,58,298,356,158,45,40,105,178,994
230,Brandon Jennings,PG,20,MIL,82,82,2671,451,1216,145,388,306,828,223,273,49,233,282,470,105,18,200,191,1270
231,Jonas Jerebko,PF,22,DET,80,73,2232,290,603,36,115,254,488,125,176,194,284,478,58,79,29,82,230,741
232,Yi Jianlian,PF,22,NJN,52,51,1655,227,563,15,41,212,522,154,193,115,257,372,47,37,52,77,170,623
233,Amir Johnson,PF,22,TOR,82,5,1453,208,334,0,4,208,330,95,149,154,241,395,48,44,66,63,255,511
234,Anthony Johnson,PG,35,ORL,31,0,406,49,111,13,39,36,72,19,20,8,40,48,63,11,1,26,32,130
235,James Johnson,PF,22,CHI,65,11,757,95,210,15,46,80,164,51,70,34,94,128,48,21,43,62,126,256
236,Joe Johnson,SG,28,ATL,76,76,2886,635,1386,129,350,506,1036,220,269,74,279,353,369,82,5,145,145,1619
237,Dahntay Jones,SF,29,IND,76,26,1892,287,623,4,32,283,591,198,257,48,181,229,150,40,39,129,237,776
238,Dwayne Jones,PF,26,PHO,2,0,7,0,0,0,0,0,0,0,0,0,2,2,0,0,0,0,1,0
239,James Jones,SF,29,MIA,36,6,503,43,119,37,90,6,29,23,28,4,41,45,17,11,4,11,45,146
240,Solomon Jones,C,25,IND,52,2,675,78,176,0,3,78,173,51,71,51,93,144,32,14,37,40,125,207
241,DeAndre Jordan,C,21,LAC,70,12,1137,144,238,0,2,144,236,48,128,122,230,352,21,16,62,75,152,336
242,Chris Kaman,C,27,LAC,76,76,2608,589,1202,0,6,589,1196,230,307,184,520,704,120,37,94,223,213,1408
243,Jason Kapono,SF,28,PHI,57,12,976,126,301,63,171,63,130,9,15,14,52,66,39,21,6,34,80,324
245,Jason Kidd*,PG,36,DAL,80,80,2881,284,671,176,414,108,257,80,99,48,397,445,724,145,35,195,142,824
246,Andrei Kirilenko,SF,28,UTA,58,35,1681,244,482,26,89,218,393,174,234,76,188,264,158,83,71,79,102,688
247,Kyle Korver,SG,28,UTA,52,0,952,138,280,59,110,79,170,39,49,10,101,111,89,26,12,42,76,374
248,Kosta Koufos,C,20,UTA,36,0,172,22,47,0,0,22,47,9,15,16,29,45,6,2,4,15,26,53
249,Nenad Krstić,C,26,OKC,76,76,1741,281,560,1,5,280,555,76,106,134,249,383,52,32,45,58,177,639
250,Oliver Lafayette,SG,25,BOS,1,0,22,3,6,1,2,2,4,0,0,1,3,4,2,0,0,1,0,7
251,Carl Landry,PF,26,TOT,80,29,2469,499,931,1,3,498,928,344,427,188,280,468,66,55,63,136,234,1343
252,Marcus Landry,SF,24,TOT,18,0,111,16,43,9,28,7,15,3,5,5,14,19,0,1,2,6,14,44
253,Acie Law,PG,25,TOT,26,1,234,35,75,5,16,30,59,38,49,3,14,17,26,11,1,17,16,113
254,Ty Lawson,PG,22,DEN,65,8,1318,201,390,34,83,167,307,106,140,42,82,124,203,48,2,82,89,542
255,Courtney Lee,SG,24,NJN,71,66,2375,338,775,76,225,262,550,133,153,60,192,252,121,93,20,76,130,885
256,David Lee,C,26,NYK,81,81,3019,686,1258,0,8,686,1250,268,330,228,721,949,295,85,40,189,257,1640
257,Rashard Lewis,PF,30,ORL,72,72,2369,350,805,168,423,182,382,145,180,62,256,318,107,78,28,108,180,1013
258,Shaun Livingston,PG,24,TOT,36,18,796,104,201,0,6,104,195,42,48,16,62,78,130,17,11,58,61,250
259,Brook Lopez,C,21,NJN,82,82,3027,563,1129,0,2,563,1127,416,509,270,439,709,187,55,139,204,251,1542
260,Robin Lopez,C,21,PHO,51,31,986,171,291,0,0,171,291,88,125,104,144,248,7,10,53,41,117,430
261,Kevin Love,PF,21,MIN,60,22,1714,291,646,35,106,256,540,225,276,227,431,658,136,43,23,117,136,842
262,Kyle Lowry,PG,23,HOU,68,0,1651,184,464,37,136,147,328,215,260,91,156,247,305,60,9,116,173,620
263,Corey Maggette,PF,30,GSW,70,49,2081,457,886,13,50,444,836,460,551,92,281,373,172,51,4,168,231,1387
264,Jamaal Magloire,C,31,MIA,36,0,359,28,56,0,0,28,56,21,59,41,80,121,1,9,11,17,59,77
265,Ian Mahinmi,C,23,SAS,26,0,165,35,55,0,0,35,55,31,47,13,39,52,2,3,8,15,32,101
266,Shawn Marion,SF,31,DAL,75,75,2385,395,778,3,19,392,759,105,139,158,319,477,107,69,61,99,141,898
267,Sean Marks,C,34,NOH,14,0,75,4,8,0,0,4,8,2,5,14,9,23,2,0,3,2,17,10
268,Cartier Martin,SF,25,TOT,18,2,390,50,136,17,49,33,87,24,30,25,43,68,16,11,1,19,48,141
269,Kenyon Martin,PF,32,DEN,58,58,1986,283,620,8,29,275,591,93,167,142,404,546,109,72,61,91,186,667
270,Kevin Martin,SG,26,TOT,46,43,1633,289,693,70,210,219,483,298,340,29,135,164,111,46,6,92,96,946
271,Desmond Mason,SF,32,SAC,5,4,66,5,12,0,0,5,12,3,4,4,9,13,2,1,1,4,5,13
272,Roger Mason,SG,29,SAS,79,5,1515,193,496,88,264,105,232,27,34,11,151,162,137,30,14,59,99,501
273,Wesley Matthews,SG,23,UTA,82,48,2025,273,565,63,165,210,400,160,193,50,141,191,124,64,15,93,152,769
274,Jason Maxiell,C,26,DET,76,29,1550,212,415,0,1,212,414,89,155,161,240,401,39,36,38,68,175,513
275,Sean May,C,25,SAC,37,4,331,51,111,0,4,51,107,21,32,20,50,70,17,12,7,19,46,123
276,Eric Maynor,PG,22,TOT,81,2,1269,154,368,22,71,132,297,52,72,21,108,129,266,40,10,85,115,382
277,O.J. Mayo,SG,22,MEM,82,82,3113,542,1183,136,355,406,828,212,262,61,250,311,242,98,17,176,174,1432
278,Luc Mbah a Moute,PF,23,MIL,73,62,1866,177,369,6,17,171,352,93,133,171,229,400,81,60,39,70,181,453
279,Antonio McDyess,PF,35,SAS,77,50,1617,205,428,0,2,205,426,36,57,149,306,455,83,43,32,79,147,446
280,JaVale McGee,C,22,WAS,60,19,968,156,307,0,1,156,306,74,116,88,155,243,14,16,101,51,122,386
281,Tracy McGrady*,SG,30,TOT,30,24,673,91,235,16,64,75,171,47,63,22,72,94,99,15,14,44,40,245
282,Dominic McGuire,SF,24,TOT,51,2,307,19,52,0,0,19,52,0,7,23,56,79,11,5,4,17,35,38
283,Josh McRoberts,C,22,IND,42,3,524,76,146,8,23,68,123,19,38,40,87,127,44,17,16,19,74,179
284,Jodie Meeks,SG,22,TOT,60,0,719,104,268,42,132,62,136,31,39,9,90,99,39,18,5,25,52,281
285,Pops Mensah-Bonsu,PF,26,TOT,20,0,120,13,33,0,0,13,33,13,24,16,19,35,3,4,9,10,20,39
286,C.J. Miles,SF,22,UTA,63,28,1497,241,562,74,217,167,345,66,95,42,126,168,105,58,17,81,190,622
287,Darko Miličić,C,24,TOT,32,18,685,100,204,0,1,100,203,15,28,47,104,151,47,22,34,35,82,215
288,Andre Miller,PG,33,POR,82,66,2500,404,908,16,80,388,828,322,392,81,185,266,445,93,9,173,169,1146
289,Brad Miller,C,33,CHI,82,37,1950,250,581,37,132,213,449,182,220,83,316,399,154,44,29,107,189,719
290,Mike Miller,SG,29,WAS,54,50,1805,217,433,82,171,135,262,70,85,55,281,336,212,39,12,115,131,586
291,Patty Mills,PG,21,POR,10,0,38,10,24,2,4,8,20,4,7,1,1,2,5,0,0,4,6,26
292,Paul Millsap,PF,24,UTA,82,8,2277,385,716,1,9,384,707,183,264,186,373,559,131,64,99,116,285,954
293,Nazr Mohammed,C,32,CHA,58,29,984,189,342,0,0,189,342,81,125,114,190,304,28,15,43,53,105,459
294,Jamario Moon,SF,29,CLE,61,2,1052,114,247,32,100,82,147,36,45,26,165,191,49,34,30,23,69,296
295,Mikki Moore,C,34,GSW,23,20,406,54,90,0,0,54,90,7,11,26,43,69,36,5,13,21,60,115
296,Randolph Morris,PF,24,ATL,28,0,124,23,41,0,0,23,41,16,27,10,28,38,2,5,3,12,34,62
297,Adam Morrison,SF,25,LAL,31,0,241,32,85,5,21,27,64,5,8,10,22,32,18,3,2,10,17,74
298,Anthony Morrow,SG,24,GSW,69,37,2018,329,703,140,307,189,396,101,114,61,198,259,104,65,16,84,158,899
299,Byron Mullens,PF,20,OKC,13,0,54,7,19,0,0,7,19,0,0,3,7,10,1,2,0,4,13,14
300,Troy Murphy,PF,29,IND,72,69,2344,384,813,128,333,256,480,154,193,129,608,737,150,72,34,100,175,1050
301,Ronald Murray,SG,30,TOT,75,2,1673,268,683,69,221,199,462,141,194,28,155,183,135,46,16,91,126,746
302,Eduardo Nájera,PF,33,TOT,46,5,685,62,146,19,64,43,82,14,24,34,81,115,29,26,14,25,94,157
303,Steve Nash*,PG,35,PHO,81,81,2660,499,985,124,291,375,694,211,225,34,234,268,892,42,12,295,108,1333
304,Jameer Nelson,PG,27,ORL,65,64,1860,317,706,86,226,231,480,98,116,26,168,194,353,48,2,139,147,818
305,Rasho Nesterović,C,33,TOR,42,8,413,81,149,0,0,81,149,1,5,37,52,89,25,10,17,16,54,163
306,Joakim Noah,C,24,CHI,64,54,1925,262,520,0,0,262,520,163,219,220,484,704,132,32,100,117,198,687
307,Andrés Nocioni,SF,30,SAC,75,28,1477,234,587,96,249,138,338,71,99,32,190,222,75,32,26,67,160,635
308,Steve Novak,SF,26,LAC,54,0,362,42,108,22,71,20,37,7,9,1,32,33,6,7,2,2,21,113
309,Dirk Nowitzki,PF,31,DAL,81,80,3039,720,1496,51,121,669,1375,536,586,80,540,620,218,70,79,149,208,2027
310,Patrick O'Bryant,C,23,TOR,11,0,51,8,15,0,1,8,14,3,6,2,9,11,1,2,4,5,12,19
311,Jermaine O'Neal,C,31,MIA,70,70,1991,394,745,0,2,394,743,162,225,124,362,486,92,25,95,125,212,950
312,Shaquille O'Neal*,C,37,CLE,53,53,1240,262,463,0,1,262,462,112,226,93,262,355,80,15,62,105,169,636
313,Fabricio Oberto,C,34,WAS,57,20,650,35,56,0,0,35,56,13,17,34,71,105,51,11,9,36,121,83
314,Greg Oden,C,22,POR,21,21,502,92,152,0,0,92,152,49,64,64,114,178,19,8,48,39,84,233
315,Lamar Odom,PF,30,LAL,82,38,2585,342,739,58,182,284,557,140,202,184,618,802,267,75,59,150,227,882
316,Emeka Okafor,C,27,NOH,82,82,2370,348,656,0,0,348,656,154,274,251,491,742,55,54,127,111,218,850
317,Mehmet Okur,C,30,UTA,73,73,2149,355,775,82,213,273,562,196,239,132,383,515,119,38,81,127,223,988
318,Kevin Ollie,PG,37,OKC,25,0,263,18,45,0,1,18,44,8,8,3,22,25,20,9,0,6,16,44
319,Travis Outlaw,SF,25,TOT,34,6,730,110,281,40,105,70,176,49,59,33,88,121,34,18,17,32,43,309
320,Zaza Pachulia,C,25,ATL,78,1,1089,120,246,0,4,120,242,93,143,117,176,293,42,37,31,58,186,333
321,Jannero Pargo,PG,30,CHI,63,5,829,132,381,38,138,94,243,42,45,9,69,78,89,29,2,50,68,344
322,Anthony Parker,SG,34,CLE,81,81,2289,206,475,108,261,98,214,75,95,30,201,231,157,63,18,71,151,595
323,Tony Parker,PG,27,SAS,56,50,1728,349,716,10,34,339,682,186,246,7,128,135,317,29,8,149,96,894
324,Chris Paul,PG,24,NOH,45,45,1712,314,637,52,127,262,510,161,190,20,171,191,480,96,8,112,118,841
325,Sasha Pavlović,SF,26,MIN,71,0,877,109,300,35,118,74,182,10,26,12,105,117,58,23,6,53,84,263
326,Oleksiy Pecherov,C,24,MIN,44,5,447,77,188,14,52,63,136,29,32,32,92,124,11,9,14,32,55,197
327,Kendrick Perkins,C,25,BOS,78,78,2154,314,522,0,3,314,519,163,280,155,440,595,80,26,132,165,219,791
328,Morris Peterson,SG,32,NOH,46,39,973,116,301,62,171,54,130,33,54,17,109,126,41,25,5,27,81,327
329,Johan Petro,C,24,DEN,36,16,436,54,101,0,1,54,100,14,21,32,97,129,14,10,13,23,80,122
330,Paul Pierce,SF,32,BOS,71,71,2411,409,867,109,263,300,604,369,433,39,271,310,218,84,31,166,196,1296
331,Mickaël Piétrus,SF,27,ORL,75,24,1687,233,539,116,306,117,233,69,109,39,176,215,49,53,31,69,138,651
332,James Posey,SF,33,NOH,77,2,1731,126,345,81,242,45,103,66,80,32,297,329,117,42,19,51,204,399
333,Leon Powe,SF,26,CLE,20,2,236,21,49,0,0,21,49,37,63,19,42,61,0,6,2,11,36,79
334,Josh Powell,PF,27,LAL,63,0,581,71,194,7,16,64,178,20,31,44,72,116,35,9,6,33,71,169
335,A.J. Price,PG,23,IND,56,2,865,145,354,60,174,85,180,60,75,12,76,88,106,35,3,59,53,410
336,Ronnie Price,PG,26,UTA,60,4,806,98,242,18,63,80,179,41,59,28,46,74,123,40,13,56,109,255
337,Tayshaun Prince,SF,29,DET,49,49,1664,282,580,27,73,255,507,70,98,71,177,248,161,34,22,60,77,661
338,Joel Przybilla,C,30,POR,30,9,681,45,86,0,0,45,86,33,51,72,166,238,8,8,43,39,95,123
339,Chris Quinn,PG,26,NJN,25,0,223,20,56,10,32,10,24,6,6,1,15,16,29,9,1,10,15,56
340,Vladimir Radmanović,PF,29,TOT,41,20,891,103,273,30,108,73,165,20,27,51,127,178,45,29,7,44,97,256
341,Anthony Randolph,C,20,GSW,33,8,749,137,309,1,5,136,304,109,136,73,142,215,42,28,51,49,92,384
342,Shavlik Randolph,PF,26,TOT,6,0,53,6,18,0,0,6,18,2,2,7,7,14,1,1,1,3,9,14
343,Zach Randolph,PF,28,MEM,81,81,3051,652,1336,15,52,637,1284,362,465,330,620,950,149,80,34,174,226,1681
344,Theo Ratliff,C,36,TOT,49,29,807,70,152,0,0,70,152,38,50,59,98,157,25,12,61,41,87,178
345,Michael Redd,SG,30,MIL,18,12,492,75,213,18,60,57,153,47,66,11,43,54,39,19,2,15,24,215
346,J.J. Redick,SG,25,ORL,82,9,1808,243,553,111,274,132,279,191,222,17,138,155,158,28,4,63,118,788
347,Chris Richard,PF,25,CHI,18,0,224,15,29,0,0,15,29,7,11,19,40,59,7,8,4,14,50,37
348,Jason Richardson,SG,29,PHO,79,76,2485,473,998,157,400,316,598,136,184,81,323,404,143,66,33,92,169,1239
349,Quentin Richardson,SF,29,MIA,76,75,2082,242,561,142,358,100,203,52,71,64,310,374,93,70,18,62,169,678
350,Luke Ridnour,PG,28,MIL,82,0,1759,328,686,69,181,259,505,127,140,24,119,143,324,54,7,106,182,852
351,Nate Robinson,PG,25,TOT,56,2,1115,215,493,87,223,128,270,50,67,28,82,110,163,49,5,73,116,567
352,Sergio Rodríguez,PG,23,TOT,66,8,1048,167,351,32,91,135,260,68,93,24,65,89,212,50,5,114,84,434
353,Rajon Rondo,PG,23,BOS,81,81,2963,459,904,17,80,442,824,175,282,100,260,360,794,189,11,246,198,1110
354,Derrick Rose,PG,21,CHI,78,78,2871,672,1373,16,60,656,1313,259,338,65,228,293,469,57,27,217,96,1619
356,Brandon Roy,SG,25,POR,65,65,2419,491,1038,73,221,418,817,343,440,73,212,285,305,61,16,129,136,1398
357,Brandon Rush,SG,24,IND,82,64,2491,297,702,124,302,173,400,56,89,41,305,346,112,56,65,93,159,774
358,Kareem Rush,SG,29,LAC,7,0,58,4,11,1,3,3,8,0,0,1,5,6,4,2,3,3,8,9
359,John Salmons,SG,30,TOT,81,56,2824,437,991,118,309,319,682,253,305,35,235,270,223,99,26,123,166,1245
360,Brian Scalabrine,PF,31,BOS,52,3,472,29,85,16,49,13,36,4,6,9,39,48,27,9,4,17,59,78
361,Luis Scola,PF,29,HOU,82,82,2671,560,1090,1,5,559,1085,208,267,175,530,705,169,63,26,163,246,1329
362,Thabo Sefolosha,SG,25,OKC,82,82,2348,194,441,41,131,153,310,60,89,76,311,387,145,97,46,90,154,489
363,Ramon Sessions,PG,23,MIN,82,1,1732,253,555,1,15,252,540,167,233,58,156,214,258,55,5,137,137,674
364,Bobby Simmons,PF,29,NJN,23,2,395,42,117,20,63,22,54,18,20,11,52,63,15,15,3,19,52,122
366,Brian Skinner,PF,33,LAC,16,1,123,10,25,0,0,10,25,6,8,9,18,27,0,3,4,7,20,26
367,Craig Smith,PF,26,LAC,75,2,1232,226,397,1,5,225,392,132,208,97,190,287,84,33,25,88,194,585
368,J.R. Smith,SG,24,DEN,75,0,2082,428,1033,158,467,270,566,142,201,28,206,234,183,99,20,139,174,1156
369,Jason Smith,PF,23,PHI,56,2,658,75,174,10,29,65,145,29,42,54,81,135,33,21,28,35,110,189
370,Joe Smith,PF,34,ATL,64,1,592,77,193,1,7,76,186,39,48,66,91,157,21,6,19,22,95,194
371,Josh Smith,PF,24,ATL,81,81,2871,504,999,0,7,504,992,261,422,223,482,705,342,130,172,198,240,1269
372,Darius Songaila,C,31,NOH,75,1,1410,241,488,1,6,240,482,60,74,59,173,232,70,62,14,81,206,543
373,Marreese Speights,C,22,PHI,62,1,1016,212,444,0,5,212,439,108,145,85,167,252,36,29,34,51,152,532
374,Jerry Stackhouse,SG,35,MIL,42,0,855,129,316,45,130,84,186,55,69,19,81,100,70,21,9,66,56,358
375,DeShawn Stevenson,SG,28,TOT,64,18,883,46,163,19,87,27,76,25,35,11,80,91,56,16,6,30,74,136
376,Peja Stojaković,SF,32,NOH,62,55,1947,278,688,132,352,146,336,96,107,39,188,227,92,48,5,56,83,784
377,Amar'e Stoudemire,PF,27,PHO,82,82,2838,704,1264,1,6,703,1258,487,632,230,502,732,82,52,83,213,281,1896
378,Rodney Stuckey,PG,23,DET,73,67,2499,449,1109,18,79,431,1030,299,359,67,214,281,348,101,12,163,205,1215
379,DaJuan Summers,SF,22,DET,44,0,405,46,130,15,42,31,88,27,38,14,31,45,16,8,7,16,52,134
380,Jermaine Taylor,SG,23,HOU,31,4,303,45,119,5,22,40,97,33,46,21,25,46,16,10,3,19,15,128
381,Jeff Teague,PG,21,ATL,71,3,719,90,227,7,32,83,195,41,49,5,62,67,122,34,11,50,82,228
382,Sebastian Telfair,PG,24,TOT,43,1,659,83,201,13,56,70,145,29,37,5,40,45,126,24,5,50,71,208
383,Garrett Temple,SG,23,TOT,27,4,334,44,101,13,37,31,64,35,50,6,25,31,21,13,6,27,42,136
384,Jason Terry,SG,32,DAL,77,12,2540,456,1041,136,373,320,668,232,268,19,121,140,292,94,17,109,142,1280
385,Hasheem Thabeet,C,22,MEM,68,13,883,77,131,0,0,77,131,54,93,85,158,243,11,15,89,43,162,208
386,Etan Thomas,C,31,OKC,23,1,321,31,68,0,0,31,68,13,22,18,46,64,1,4,16,18,39,75
387,Kenny Thomas,PF,32,SAC,26,2,313,17,35,0,0,17,35,7,12,35,51,86,15,10,10,17,42,41
388,Kurt Thomas,C,37,MIL,70,9,1049,99,208,0,0,99,208,12,15,84,207,291,47,26,46,48,159,210
389,Tim Thomas,SF,32,DAL,18,1,285,49,106,16,43,33,63,21,24,13,28,41,14,10,2,14,31,135
391,Jason Thompson,C,23,SAC,75,58,2357,370,784,1,10,369,774,198,277,224,413,637,124,41,73,139,279,939
392,Al Thornton,SF,26,TOT,75,46,2079,320,676,11,31,309,645,153,211,116,178,294,90,45,35,102,206,804
393,Marcus Thornton,SG,22,NOH,73,17,1872,398,883,117,313,281,570,144,177,72,139,211,114,58,11,76,127,1057
394,Jamaal Tinsley,PG,31,MEM,38,1,589,52,140,7,39,45,101,22,27,11,55,66,108,33,5,63,67,133
395,Anthony Tolliver,PF,24,TOT,46,29,1427,193,449,50,152,143,297,103,134,84,236,320,87,32,33,46,128,539
396,Alando Tucker,SF,25,TOT,15,0,96,17,39,1,7,16,32,16,21,6,4,10,4,0,0,5,6,51
397,Ronny Turiaf,C,27,GSW,42,20,872,85,146,0,1,85,145,37,78,54,137,191,90,23,54,49,98,207
398,Hedo Türkoğlu,SF,30,TOR,74,69,2272,276,674,108,289,168,385,175,226,42,301,343,304,55,32,125,220,835
399,Ime Udoka,SG,32,SAC,69,2,944,91,241,26,91,65,150,42,57,51,140,191,58,34,6,42,83,250
400,Beno Udrih,PG,27,SAC,79,41,2477,415,841,75,199,340,642,118,141,38,181,219,372,89,10,136,166,1023
401,Roko Ukić,PG,25,MIL,13,0,97,14,30,3,12,11,18,9,11,0,3,3,12,1,0,6,6,40
402,Anderson Varejão,PF,27,CLE,76,7,2166,267,467,1,5,266,462,116,175,189,389,578,87,71,67,67,223,651
403,Charlie Villanueva,PF,25,DET,78,16,1848,363,827,99,282,264,545,106,130,85,280,365,53,48,55,74,223,931
404,Sasha Vujačić,SG,25,LAL,67,1,575,66,164,25,81,41,83,28,33,25,54,79,41,20,4,17,67,185
405,Dwyane Wade,SG,28,MIA,77,77,2792,719,1511,73,243,646,1268,534,702,107,266,373,501,142,82,252,181,2045
407,Ben Wallace,C,35,DET,69,67,1975,158,292,0,2,158,290,65,160,245,352,597,105,86,84,64,131,381
408,Gerald Wallace,SF,27,CHA,76,76,3119,456,943,52,140,404,803,422,544,150,612,762,161,117,83,178,194,1386
409,Rasheed Wallace,C,35,BOS,79,13,1780,266,650,82,290,184,360,96,125,42,283,325,80,80,70,63,222,710
410,Luke Walton,SF,29,LAL,29,0,272,30,84,7,17,23,67,2,4,12,26,38,40,10,1,12,19,69
411,Hakim Warrick,PF,27,TOT,76,6,1557,265,550,1,7,264,543,202,274,127,187,314,52,24,18,80,126,733
412,C.J. Watson,PG,25,GSW,65,15,1788,247,528,45,145,202,383,128,166,28,141,169,180,103,8,69,124,667
413,Earl Watson,PG,30,IND,79,52,2322,223,524,53,184,170,340,120,169,54,186,240,399,104,16,175,181,619
414,Kyle Weaver,SG,23,OKC,12,0,144,12,33,7,19,5,14,5,6,1,17,18,11,6,6,4,13,36
415,Martell Webster,SF,23,POR,82,49,2005,259,639,124,332,135,307,126,155,47,221,268,62,45,40,60,153,768
416,Sonny Weems,SG,23,TOR,69,19,1368,236,458,2,15,234,443,44,64,42,150,192,101,39,25,65,126,518
417,David West,PF,29,NOH,81,81,2949,619,1226,7,27,612,1199,296,342,164,441,605,239,76,60,173,233,1541
418,Delonte West,SG,26,CLE,60,3,1500,194,436,25,77,169,359,115,142,29,140,169,196,55,28,90,86,528
419,Mario West,SG,25,ATL,39,1,142,12,21,0,1,12,20,6,10,8,19,27,9,8,0,7,25,30
420,Russell Westbrook,PG,21,OKC,82,82,2813,485,1160,23,104,462,1056,329,422,143,258,401,652,108,34,268,204,1322
421,D.J. White,PF,23,OKC,12,0,102,25,41,0,0,25,41,9,10,10,13,23,4,5,3,3,12,59
422,Chris Wilcox,PF,27,DET,34,10,441,63,120,0,0,63,120,26,52,44,73,117,13,13,12,38,64,152
423,Damien Wilkins,SF,30,MIN,80,31,1585,165,381,18,61,147,320,103,129,72,177,249,135,66,25,76,144,451
424,Mike Wilks,PG,30,OKC,4,0,59,6,12,2,3,4,9,2,4,1,3,4,4,0,0,4,5,16
425,Deron Williams,PG,25,UTA,76,76,2802,494,1053,96,259,398,794,335,418,50,253,303,798,96,16,252,208,1419
426,Jason Williams,PG,34,ORL,82,18,1703,189,426,84,221,105,205,31,41,7,119,126,298,53,3,87,65,493
427,Jawad Williams,PG,26,CLE,54,6,742,81,206,30,93,51,113,32,45,16,67,83,34,12,5,18,73,224
428,Lou Williams,PG,23,PHI,64,38,1912,318,677,70,206,248,471,192,233,25,162,187,268,80,15,106,110,898
429,Marcus Williams,PG,24,MEM,62,1,872,104,271,24,81,80,190,37,55,13,80,93,161,32,1,74,43,269
430,Marvin Williams,SF,23,ATL,81,81,2468,302,664,40,132,262,532,176,215,106,310,416,93,66,46,72,160,820
431,Mo Williams,PG,27,CLE,69,68,2359,378,855,159,371,219,484,177,198,28,178,206,368,70,21,173,170,1092
432,Reggie Williams,SF,23,GSW,24,10,782,140,283,33,92,107,191,52,62,18,92,110,66,23,6,29,49,365
433,Sean Williams,PF,23,NJN,20,0,227,21,49,0,1,21,48,10,19,21,25,46,1,8,19,20,41,52
434,Shelden Williams,PF,26,BOS,54,0,597,63,121,0,1,63,120,75,98,47,99,146,21,13,21,30,85,201
435,Terrence Williams,SF,22,NJN,78,9,1764,261,651,31,100,230,551,103,144,46,302,348,223,43,10,124,126,656
436,Metta World Peace,SF,30,LAL,77,77,2605,306,740,105,296,201,444,128,186,99,232,331,234,106,21,121,165,845
437,Antoine Wright,SF,25,TOR,67,10,1392,162,399,58,173,104,226,53,77,38,152,190,71,30,11,58,134,435
438,Dorell Wright,SF,24,MIA,72,1,1496,194,419,61,157,133,262,61,69,50,185,235,91,52,32,53,94,510
439,Julian Wright,SF,22,NOH,68,14,871,116,232,2,6,114,226,25,41,58,86,144,41,29,18,44,45,259
440,Nick Young,SG,24,WAS,74,23,1421,233,558,69,170,164,388,104,130,20,82,102,48,28,8,56,147,639
441,Sam Young,SF,24,MEM,80,1,1321,224,497,11,56,213,441,136,175,77,124,201,52,34,20,94,106,595
442,Thaddeus Young,PF,21,PHI,67,45,2145,382,813,48,138,334,675,114,165,130,220,350,97,81,15,126,133,926
1,Jeff Adrien,PF,24,GSW,23,0,196,23,54,0,0,23,54,11,19,23,35,58,10,4,5,9,28,57
2,Arron Afflalo,SG,25,DEN,69,69,2324,312,627,105,248,207,379,138,163,45,206,251,168,34,31,71,153,867
3,Maurice Ager,SG,26,MIN,4,0,29,6,11,3,4,3,7,0,0,0,2,2,1,1,0,4,4,15
4,Alexis Ajinça,C,22,TOT,34,2,340,59,133,12,34,47,99,13,18,17,61,78,10,11,19,18,73,143
5,Solomon Alabi,C,22,TOR,12,0,59,3,15,0,0,3,15,0,2,7,7,14,2,2,2,3,5,6
6,Cole Aldrich,C,22,OKC,18,0,142,8,15,0,0,8,15,2,4,13,22,35,4,5,7,8,30,18
7,LaMarcus Aldridge,PF,25,POR,81,81,3211,707,1415,4,23,703,1392,351,444,278,431,709,170,82,94,153,220,1769
8,Malik Allen,PF,32,ORL,18,0,178,11,31,0,0,11,31,1,2,12,20,32,4,1,4,3,30,23
9,Ray Allen*,SG,35,BOS,80,80,2890,480,978,168,378,312,600,193,219,51,223,274,219,77,16,117,147,1321
10,Tony Allen,SG,29,MEM,72,31,1494,251,492,4,23,247,469,137,182,70,123,193,104,129,44,86,161,643
11,Al-Farouq Aminu,SF,20,LAC,81,14,1452,160,406,45,143,115,263,92,119,75,192,267,60,59,25,103,121,457
12,Lou Amundson,PF,28,GSW,46,7,691,83,183,0,0,83,183,34,87,81,104,185,17,14,33,24,87,200
13,Chris Andersen,C,32,DEN,45,0,732,82,137,0,1,82,136,86,135,75,144,219,20,23,58,25,79,250
14,David Andersen,PF,30,TOT,40,0,373,56,121,8,23,48,98,14,22,20,64,84,13,5,9,22,40,134
15,James Anderson,SF,21,SAS,26,2,286,31,81,18,46,13,35,14,18,2,21,23,18,3,6,13,24,94
16,Ryan Anderson,PF,22,ORL,64,14,1424,226,525,134,341,92,184,95,117,129,226,355,52,30,38,49,137,681
17,Carmelo Anthony,SF,26,TOT,77,77,2751,684,1503,95,251,589,1252,507,605,118,445,563,221,68,46,206,224,1970
18,Joel Anthony,C,28,MIA,75,11,1463,53,99,0,0,53,99,47,73,104,162,266,24,10,93,36,194,153
19,Gilbert Arenas,PG,29,TOT,70,16,1796,269,734,97,327,172,407,120,153,22,167,189,274,74,21,177,188,755
20,Trevor Ariza,SF,25,NOH,75,75,2600,303,762,82,271,221,491,138,197,61,347,408,162,120,31,118,180,826
21,Hilton Armstrong,C,26,TOT,53,2,488,37,76,2,4,35,72,16,33,42,89,131,14,18,21,28,84,92
22,Carlos Arroyo,PG,31,TOT,64,43,1185,120,273,31,69,89,204,39,47,20,83,103,125,21,1,60,71,310
23,Darrell Arthur,PF,22,MEM,80,9,1609,310,624,0,6,310,618,109,134,115,227,342,53,52,63,88,228,729
24,Ömer Aşık,C,24,CHI,82,0,989,78,141,0,0,78,141,73,145,112,194,306,32,20,56,64,153,229
25,D.J. Augustin,PG,23,CHA,82,82,2757,399,958,111,333,288,625,269,297,38,187,225,498,54,3,155,152,1178
26,Luke Babbitt,SF,21,POR,24,0,137,15,55,3,16,12,39,3,9,6,24,30,6,2,2,8,15,36
27,Renaldo Balkman,SF,26,TOT,8,0,62,6,13,1,2,5,11,3,4,2,5,7,2,4,2,1,15,16
28,Marcus Banks,PG,29,TOR,3,0,22,0,2,0,0,0,2,6,8,0,1,1,3,1,0,2,4,6
29,Leandro Barbosa,SG,28,TOR,58,0,1395,294,653,72,213,222,440,109,137,14,85,99,119,50,6,84,112,769
30,J.J. Barea,PG,26,DAL,81,2,1669,285,649,66,189,219,460,133,157,29,130,159,317,30,1,136,136,769
31,Andrea Bargnani,C,25,TOR,66,66,2353,525,1173,77,223,448,950,287,350,74,269,343,119,34,46,152,160,1414
32,Matt Barnes,SF,30,LAL,53,0,1020,131,279,34,107,97,172,60,77,73,155,228,71,39,22,58,127,356
33,Earl Barron,C,29,TOT,21,7,305,32,99,0,0,32,99,15,24,32,44,76,11,8,6,16,46,79
34,Brandon Bass,PF,25,ORL,76,51,1980,332,645,0,2,332,643,190,233,134,290,424,57,27,52,97,159,854
35,Tony Battie,C,34,PHI,38,0,377,45,96,2,3,43,93,8,14,17,82,99,12,5,15,12,59,100
36,Shane Battier,SF,32,TOT,82,59,2375,229,509,102,267,127,242,64,93,90,283,373,185,69,81,79,158,624
37,Nicolas Batum,SF,22,POR,80,67,2522,367,807,118,342,249,465,138,164,109,252,361,123,68,49,83,194,990
38,Jerryd Bayless,PG,22,TOT,71,14,1496,218,517,49,146,169,371,166,206,26,139,165,266,38,5,127,149,651
39,Michael Beasley,SF,22,MIN,73,73,2361,561,1246,60,164,501,1082,219,291,118,291,409,158,54,52,195,222,1401
40,Rodrigue Beaubois,PG,22,DAL,28,26,496,94,223,25,83,69,140,23,30,7,45,52,64,20,8,47,76,236
41,Marco Belinelli,SG,24,NOH,80,69,1957,302,691,134,324,168,367,98,125,17,134,151,92,38,6,77,146,836
42,Charlie Bell,SG,31,GSW,19,0,171,12,43,6,21,6,22,2,4,6,12,18,13,6,1,6,13,32
43,Raja Bell,SG,34,UTA,68,63,2097,191,467,68,193,123,274,91,102,31,145,176,118,56,14,63,169,541
44,Mike Bibby,PG,32,TOT,80,68,2285,248,576,153,348,95,228,39,62,17,178,195,265,50,9,101,175,688
45,Andris Biedriņš,C,24,GSW,59,55,1397,142,266,0,0,142,266,10,31,145,281,426,60,52,52,57,198,294
46,Chauncey Billups,PG,34,TOT,72,72,2310,339,794,146,363,193,431,384,419,25,165,190,387,71,14,177,146,1208
47,DeJuan Blair,PF,21,SAS,81,65,1734,292,583,0,2,292,581,90,137,215,350,565,77,95,42,113,213,674
48,Steve Blake,PG,30,LAL,79,0,1581,110,306,73,193,37,113,26,30,19,137,156,170,40,3,73,99,319
49,Andray Blatche,PF,24,WAS,64,63,2172,426,957,4,18,422,939,220,283,183,343,526,144,98,51,172,182,1076
50,Eric Bledsoe,PG,21,LAC,81,25,1841,206,486,32,116,174,370,99,133,68,155,223,289,92,26,194,130,543
51,Keith Bogans,SG,30,CHI,82,82,1461,124,307,90,237,34,70,21,32,19,129,148,101,38,9,41,113,359
52,Andrew Bogut,C,26,MIL,65,65,2297,367,742,0,4,367,738,96,217,199,521,720,131,47,168,125,217,830
53,Matt Bonner,PF,30,SAS,66,1,1432,172,371,105,230,67,141,32,43,60,179,239,60,26,21,27,110,481
54,Trevor Booker,PF,23,WAS,65,14,1063,139,253,0,1,139,252,68,101,98,153,251,35,29,42,38,115,346
55,Carlos Boozer,C,29,CHI,59,59,1882,431,845,0,0,431,845,171,244,130,435,565,145,45,18,149,186,1033
56,Chris Bosh,PF,26,MIA,77,77,2795,524,1056,6,25,518,1031,384,471,141,500,641,144,59,49,138,172,1438
57,Earl Boykins,PG,34,MIL,57,0,862,156,352,27,71,129,281,69,82,15,40,55,141,38,3,52,43,408
58,Craig Brackins,PF,23,PHI,3,0,33,4,16,0,5,4,11,0,0,2,2,4,1,1,0,0,3,8
59,Avery Bradley,PG,20,BOS,31,0,162,23,67,0,5,23,62,6,12,4,13,17,12,9,0,16,20,52
60,Elton Brand,PF,31,PHI,81,81,2809,502,981,0,1,502,980,213,273,237,439,676,120,92,106,101,244,1217
62,Ronnie Brewer,SG,25,CHI,81,1,1781,205,427,6,27,199,400,87,133,55,207,262,140,106,22,55,82,503
63,Jon Brockman,C,23,MIL,63,6,677,48,94,0,0,48,94,40,59,74,110,184,18,14,3,24,119,136
64,Aaron Brooks,PG,26,TOT,59,12,1284,220,587,70,236,150,351,124,140,20,58,78,233,34,3,99,115,634
65,Derrick Brown,SF,23,TOT,49,1,576,74,131,5,10,69,121,32,60,41,58,99,33,20,10,35,59,185
66,Kwame Brown,C,28,CHA,66,50,1714,194,375,0,0,194,375,136,231,147,303,450,43,26,39,69,174,524
67,Shannon Brown,SG,25,LAL,82,0,1568,273,643,74,212,199,431,92,101,35,122,157,96,67,16,75,124,712
68,Kobe Bryant,SG,32,LAL,82,82,2779,740,1639,115,356,625,1283,483,583,83,336,419,388,99,12,243,172,2078
69,Chase Budinger,SF,22,HOU,78,22,1738,279,656,89,274,190,382,118,138,52,229,281,127,41,18,67,114,765
70,Caron Butler,SF,30,DAL,29,29,867,170,378,28,65,142,313,68,88,22,96,118,46,28,8,49,59,436
71,Rasual Butler,SG,31,TOT,47,2,770,79,237,46,136,33,101,18,27,10,67,77,27,8,15,24,37,222
72,Andrew Bynum,C,23,LAL,54,47,1500,237,413,0,0,237,413,138,209,170,338,508,73,19,106,74,140,612
73,Will Bynum,PG,28,DET,61,5,1125,182,406,16,50,166,356,102,122,15,59,74,195,52,4,83,113,482
74,José Calderón,PG,29,TOR,68,55,2102,262,596,57,156,205,440,88,103,30,172,202,605,81,7,148,143,669
75,Marcus Camby,C,36,POR,59,51,1540,117,294,0,1,117,293,43,70,182,424,606,121,40,92,62,140,277
76,Derrick Caracter,C,22,LAL,41,0,215,32,66,0,0,32,66,17,23,19,24,43,7,4,10,19,47,81
77,Brian Cardinal,SF,33,DAL,56,4,618,43,100,42,87,1,13,17,18,10,49,59,40,24,7,17,82,145
78,Rodney Carney,SF,26,TOT,27,1,336,46,110,17,38,29,72,18,27,13,35,48,11,12,5,16,33,127
79,DeMarre Carroll,PF,24,TOT,12,0,50,4,12,0,0,4,12,2,2,2,6,8,4,1,1,0,5,10
80,Matt Carroll,SG,30,CHA,54,1,582,89,199,17,46,72,153,40,52,12,56,68,23,17,6,23,43,235
81,Anthony Carter,PG,35,TOT,33,0,463,45,106,12,40,33,66,8,8,7,44,51,69,27,6,39,49,110
82,Vince Carter,SG,34,TOT,73,63,2051,389,891,116,321,273,570,128,173,54,221,275,146,67,20,90,193,1022
83,Omri Casspi,SF,22,SAC,71,27,1702,225,546,92,247,133,299,68,101,74,233,307,74,54,13,68,115,610
84,Mario Chalmers,PG,24,MIA,70,28,1579,155,388,83,231,72,157,54,62,12,134,146,177,76,7,91,158,447
85,Tyson Chandler,C,28,DAL,74,74,2059,266,407,0,0,266,407,216,295,206,486,692,32,36,80,88,240,748
86,Wilson Chandler,SF,23,TOT,72,49,2401,429,953,112,320,317,633,130,161,75,333,408,120,48,94,104,199,1100
87,Josh Childress,SG,27,PHO,54,3,894,121,214,1,16,120,198,29,59,69,86,155,42,33,23,44,68,272
88,Earl Clark,SF,23,TOT,42,0,464,68,158,0,5,68,153,27,47,37,64,101,9,8,18,28,45,163
89,Jarron Collins,C,32,TOT,28,0,181,6,21,0,0,6,21,7,10,14,10,24,2,4,1,7,29,19
90,Jason Collins,C,32,ATL,49,28,593,34,71,1,1,33,70,27,41,30,72,102,22,9,9,26,97,96
91,Sherron Collins,PG,23,CHA,20,0,66,7,25,2,10,5,15,1,1,0,5,5,8,2,0,4,2,17
92,Darren Collison,PG,23,IND,79,79,2360,398,870,41,124,357,746,202,232,40,185,225,403,87,14,194,109,1039
93,Nick Collison,C,30,OKC,71,2,1524,137,242,0,0,137,242,55,73,119,197,316,69,42,31,55,210,329
94,Mike Conley,PG,23,MEM,81,81,2872,423,953,80,217,343,736,181,247,32,215,247,528,144,18,176,182,1107
95,Brian Cook,PF,30,LAC,40,0,447,72,170,34,79,38,91,15,24,19,77,96,15,12,11,25,75,193
96,Daequan Cook,SG,23,OKC,43,0,598,79,181,65,154,14,27,16,20,8,64,72,20,14,1,17,51,239
97,Marcus Cousin,C,24,UTA,4,0,18,2,3,0,0,2,3,0,0,0,3,3,0,0,1,1,1,4
98,DeMarcus Cousins,C,20,SAC,81,62,2309,432,1004,3,18,429,986,276,402,217,482,699,204,85,68,268,332,1143
99,Jamal Crawford,SG,30,ATL,76,0,2297,368,874,119,349,249,525,222,260,22,108,130,241,57,14,145,97,1077
100,Jordan Crawford,SG,22,TOT,42,18,1027,192,500,33,128,159,372,73,84,31,74,105,117,39,3,83,63,490
101,Dante Cunningham,PF,23,TOT,78,18,1637,218,472,1,13,217,459,45,62,96,181,277,43,54,43,51,177,482
102,Stephen Curry,PG,22,GSW,74,74,2489,505,1053,151,342,354,711,212,227,52,234,286,432,109,20,226,233,1373
103,Samuel Dalembert,C,29,SAC,80,46,1938,268,567,0,2,268,565,108,148,212,445,657,67,36,116,132,225,644
104,Erick Dampier,C,35,MIA,51,22,815,52,89,0,1,52,88,24,44,53,124,177,22,14,47,32,82,128
105,Antonio Daniels,PG,35,PHI,4,0,35,2,5,0,2,2,3,2,2,0,5,5,2,0,0,1,0,6
106,Marquis Daniels,SF,30,BOS,49,0,938,114,232,4,21,110,211,39,57,24,89,113,64,39,22,38,63,271
107,Baron Davis,PG,31,TOT,58,44,1649,289,693,81,239,208,454,101,131,35,121,156,391,78,28,146,143,760
108,Ed Davis,PF,21,TOR,65,17,1602,215,373,0,0,215,373,71,128,168,294,462,40,39,67,48,183,501
109,Glen Davis,C,25,BOS,78,13,2298,359,801,2,15,357,786,195,265,101,324,425,92,78,30,85,231,915
110,Austin Daye,SF,22,DET,72,16,1446,193,471,69,172,124,299,82,108,64,210,274,78,39,39,59,165,537
111,Carlos Delfino,SF,28,MIL,49,40,1590,200,513,105,284,95,229,60,75,24,176,200,112,76,8,57,72,565
112,Luol Deng,SF,25,CHI,82,82,3208,531,1155,115,333,416,822,253,336,116,360,476,230,78,48,156,162,1430
113,DeMar DeRozan,SG,21,TOR,82,82,2851,539,1154,5,52,534,1102,327,402,75,240,315,148,85,31,144,217,1410
114,Boris Diaw,PF,28,CHA,82,82,2778,381,774,78,226,303,548,84,123,105,309,414,337,74,46,166,190,924
115,Ike Diogu,PF,27,LAC,36,0,470,83,148,0,0,83,148,41,62,41,74,115,2,3,3,22,72,207
116,DeSagana Diop,C,29,CHA,16,0,181,8,24,0,0,8,24,4,11,12,28,40,7,4,15,11,26,20
117,Keyon Dooling,PG,30,MIL,80,22,1757,206,519,81,234,125,285,78,94,12,105,117,243,54,4,91,119,571
118,Joey Dorsey,C,27,TOR,43,9,522,52,99,0,0,52,99,31,65,79,111,190,27,24,17,39,78,135
119,Toney Douglas,SG,24,NYK,81,9,1971,314,755,143,383,171,372,85,107,65,179,244,244,89,4,89,177,856
120,Chris Douglas-Roberts,SF,24,MIL,44,12,884,117,273,15,46,102,227,74,89,7,81,88,50,29,13,35,73,323
121,Zabian Dowdell,PG,26,PHO,24,0,292,51,125,3,10,48,115,16,17,5,15,20,51,20,2,29,30,121
122,Goran Dragić,PG,24,TOT,70,5,1234,192,441,56,155,136,286,83,133,36,106,142,204,50,10,117,125,523
123,Jared Dudley,SF,25,PHO,82,15,2140,300,629,105,253,195,376,162,218,111,207,318,108,87,20,77,139,867
124,Chris Duhon,PG,28,ORL,51,5,774,49,129,13,52,36,77,14,25,9,43,52,118,16,2,61,30,125
125,Tim Duncan,C,34,SAS,76,76,2156,419,838,0,4,419,834,184,257,169,509,678,203,50,146,122,119,1022
126,Mike Dunleavy,SG,30,IND,61,44,1683,240,520,102,254,138,266,100,125,28,248,276,105,40,30,69,107,682
127,Ronald Dupree,SF,30,TOR,3,0,13,1,4,0,1,1,3,0,0,0,3,3,1,0,0,0,2,2
128,Kevin Durant,SF,22,OKC,78,78,3038,711,1538,145,414,566,1124,594,675,57,476,533,214,88,76,218,159,2161
129,Devin Ebanks,SG,21,LAL,20,0,118,21,51,2,5,19,46,18,23,15,12,27,2,4,5,6,7,62
130,Wayne Ellington,SG,23,MIN,62,8,1181,160,397,48,121,112,276,42,53,26,82,108,72,28,3,53,85,410
131,Monta Ellis,SG,25,GSW,80,80,3227,726,1611,137,379,589,1232,340,431,44,237,281,450,168,23,252,203,1929
132,Francisco Elson,C,34,UTA,62,1,610,54,113,0,0,54,113,26,31,35,80,115,33,21,14,32,84,134
133,Melvin Ely,C,32,DEN,30,2,366,28,51,0,0,28,51,13,21,27,47,74,14,4,11,14,50,69
134,Semih Erden,C,24,TOT,41,8,595,62,111,0,0,62,111,39,60,37,81,118,20,15,24,34,104,163
135,Jeremy Evans,SF,23,UTA,49,3,463,76,115,0,1,76,114,26,37,36,61,97,24,17,17,19,50,178
136,Maurice Evans,SF,32,TOT,73,24,1549,177,424,55,167,122,257,52,58,52,104,156,45,34,14,33,129,461
137,Reggie Evans,PF,30,TOR,30,18,798,42,103,0,1,42,102,48,88,119,226,345,38,29,6,39,89,132
138,Tyreke Evans,SG,21,SAC,57,53,2107,382,933,43,148,339,785,205,266,46,229,275,319,85,30,184,143,1012
139,Patrick Ewing,SF,26,NOH,7,0,19,0,5,0,2,0,3,3,4,1,1,2,2,0,1,1,1,3
140,Christian Eyenga,SF,21,CLE,44,18,947,130,306,25,91,105,215,18,28,27,96,123,35,34,28,47,78,303
141,Jordan Farmar,PG,24,NJN,73,18,1796,255,651,109,304,146,347,82,100,24,149,173,368,62,6,139,128,701
142,Derrick Favors,PF,19,TOT,78,27,1535,215,416,0,0,215,416,103,173,171,241,412,39,29,68,77,246,533
144,Rudy Fernández,SG,25,POR,78,3,1821,213,575,116,361,97,214,126,146,37,135,172,193,87,14,88,134,668
145,Kyrylo Fesenko,C,24,UTA,53,1,456,44,100,0,1,44,99,18,46,34,74,108,18,4,16,25,90,106
146,Landry Fields,SG,22,NYK,82,81,2541,299,602,86,219,213,383,113,147,105,416,521,155,80,17,107,114,797
147,Derek Fisher,PG,36,LAL,82,82,2297,206,529,63,159,143,370,83,103,14,138,152,224,99,8,70,192,558
148,Jonny Flynn,PG,21,MIN,53,8,983,108,296,31,100,77,196,32,42,12,65,77,182,34,3,113,58,279
149,Gary Forbes,SF,25,DEN,63,11,791,124,273,19,58,105,215,59,87,28,88,116,49,23,6,46,77,326
150,T.J. Ford,PG,27,IND,41,3,773,91,236,6,32,85,204,35,48,17,64,81,141,35,8,63,69,223
151,Jeff Foster,C,34,IND,56,3,940,80,167,0,3,80,164,27,48,160,190,350,46,24,31,26,127,187
152,Randy Foye,SG,27,LAC,63,24,1551,206,531,71,217,135,314,133,149,13,90,103,170,47,21,95,122,616
153,Channing Frye,PF,27,PHO,77,64,2541,358,829,171,439,187,390,89,107,65,448,513,96,46,79,73,272,976
155,Sundiata Gaines,PG,24,TOT,24,0,301,42,105,9,38,33,67,18,36,13,25,38,42,16,1,27,25,111
157,Francisco García,SF,29,SAC,58,34,1386,207,475,81,224,126,251,65,76,24,109,133,71,51,49,45,126,560
158,Kevin Garnett,PF,34,BOS,71,71,2220,434,822,1,5,433,817,187,217,83,548,631,171,95,57,115,148,1056
159,Marc Gasol,C,26,MEM,81,81,2586,364,691,3,7,361,684,220,294,154,415,569,200,74,136,146,265,951
160,Pau Gasol,C,30,LAL,82,82,3037,593,1120,1,3,592,1117,354,430,268,568,836,273,48,130,142,203,1541
161,Rudy Gay,SF,24,MEM,54,54,2152,409,869,57,144,352,725,194,241,82,254,336,153,91,58,135,131,1069
162,Alonzo Gee,SG,23,TOT,56,34,1118,121,264,17,51,104,213,72,92,62,120,182,38,40,18,55,94,331
163,Paul George,SG,20,IND,61,19,1265,179,395,41,138,138,257,77,101,37,187,224,65,62,26,70,127,476
164,Daniel Gibson,SG,24,CLE,67,15,1865,264,660,118,293,146,367,134,163,24,153,177,201,48,21,80,154,780
165,Taj Gibson,PF,25,CHI,80,19,1742,234,502,1,8,233,494,100,148,162,296,458,58,39,106,71,203,569
166,Manu Ginóbili,SG,33,SAS,80,79,2426,441,1018,154,441,287,577,357,410,42,253,295,393,123,28,174,163,1393
167,Ryan Gomes,SF,28,LAC,76,62,2095,207,505,72,211,135,294,61,85,61,193,254,118,62,12,55,159,547
168,Drew Gooden,PF,29,MIL,35,18,860,156,362,3,20,153,342,81,102,73,165,238,47,21,18,46,98,396
169,Ben Gordon,SG,27,DET,82,27,2131,339,770,107,266,232,504,136,160,41,154,195,171,48,16,141,178,921
170,Eric Gordon,SG,22,LAC,56,56,2112,427,949,106,291,321,658,287,348,45,119,164,244,71,18,151,115,1247
171,Marcin Gortat,C,26,TOT,80,14,2032,338,603,1,4,337,599,140,193,148,483,631,70,36,91,81,188,817
172,Joey Graham,SF,28,CLE,39,8,586,82,179,9,30,73,149,29,36,8,76,84,18,6,7,28,73,202
173,Stephen Graham,SG,28,NJN,59,28,959,81,200,5,21,76,179,31,38,17,106,123,40,14,1,38,106,198
174,Danny Granger,SF,27,IND,79,79,2763,535,1260,157,407,378,853,395,466,87,338,425,203,89,62,206,213,1622
175,Aaron Gray,C,26,NOH,41,6,531,56,99,0,0,56,99,17,34,59,112,171,16,11,12,32,96,129
176,Danny Green,SG,23,SAS,8,0,92,17,35,7,19,10,16,0,0,3,12,15,2,2,1,5,7,41
178,Willie Green,SG,29,NOH,77,13,1674,270,609,54,155,216,454,78,100,22,139,161,74,36,13,67,143,672
179,Donté Greene,SF,22,SAC,69,21,1127,156,386,45,154,111,232,43,65,49,98,147,48,36,20,60,88,400
180,Orien Greene,SG,28,NJN,3,0,5,1,2,0,0,1,2,1,2,0,0,0,1,1,0,0,0,3
181,Blake Griffin,PF,21,LAC,82,82,3112,696,1376,7,24,689,1352,446,695,270,719,989,312,63,45,223,252,1845
182,Hamed Haddadi,C,25,MEM,31,0,168,30,58,0,1,30,57,15,23,24,44,68,5,2,13,11,29,75
183,Richard Hamilton,SG,32,DET,55,39,1498,288,671,55,144,233,527,146,172,24,102,126,171,39,4,88,95,777
184,Tyler Hansbrough,PF,25,IND,70,29,1535,285,613,0,2,285,611,197,253,145,221,366,41,37,15,76,160,767
185,Luke Harangody,PF,23,TOT,49,0,640,79,206,16,66,63,140,19,26,40,103,143,30,15,17,16,80,193
186,James Harden,SG,21,OKC,82,5,2189,298,684,113,324,185,360,289,343,42,213,255,176,92,24,106,207,998
187,Al Harrington,PF,30,DEN,73,3,1665,281,675,117,328,164,347,86,117,76,256,332,101,39,10,106,202,765
188,Devin Harris,PG,27,TOT,71,70,2254,343,813,58,180,285,633,335,402,17,152,169,503,70,7,207,163,1079
189,Manny Harris,SG,21,CLE,54,15,933,108,289,34,92,74,197,71,93,36,104,140,85,31,7,63,65,321
190,Mike Harris,PF,27,HOU,4,0,16,3,6,0,0,3,6,2,4,2,3,5,1,0,1,1,2,8
191,Udonis Haslem,PF,30,MIA,13,0,345,44,86,0,0,44,86,16,20,29,77,106,6,7,3,14,39,104
192,Spencer Hawes,C,22,PHI,81,81,1718,264,568,9,37,255,531,47,88,129,336,465,121,29,71,97,201,584
193,Chuck Hayes,C,27,HOU,74,63,2079,244,463,0,2,244,461,94,142,219,380,599,202,79,49,86,200,582
194,Gordon Hayward,SF,20,UTA,72,17,1218,142,293,35,74,107,219,69,97,41,98,139,81,30,19,70,106,388
195,Lazar Hayward,SF,24,MIN,42,0,419,55,154,17,60,38,94,33,42,23,47,70,28,12,7,19,44,160
196,Brendan Haywood,C,31,DAL,72,8,1331,128,223,0,1,128,222,64,177,129,247,376,19,16,74,51,146,320
197,Luther Head,PG,28,SAC,36,14,586,68,164,25,64,43,100,39,50,16,44,60,70,10,9,32,43,200
198,Gerald Henderson,SG,23,CHA,68,30,1661,259,570,7,36,252,534,128,163,49,158,207,101,50,32,64,118,653
199,Xavier Henry,SG,19,MEM,38,16,527,65,160,2,17,63,143,33,52,9,28,37,18,11,3,13,48,165
200,Roy Hibbert,C,24,IND,81,80,2244,410,890,0,4,410,886,205,275,182,428,610,166,33,142,185,256,1025
201,J.J. Hickson,C,22,CLE,80,66,2256,429,936,0,5,429,931,247,367,217,478,695,91,48,54,173,215,1105
202,Nenê Hilário,C,28,DEN,75,75,2291,402,654,1,5,401,649,286,402,145,426,571,149,84,73,134,238,1091
203,George Hill,PG,24,SAS,76,5,2148,287,633,77,204,210,429,233,270,24,175,199,193,66,21,99,153,884
204,Grant Hill*,SF,38,PHO,80,80,2409,399,825,45,114,354,711,213,257,77,261,338,200,64,35,134,184,1056
205,Jordan Hill,C,23,HOU,72,11,1125,173,352,0,2,173,350,60,85,128,178,306,29,14,52,62,157,406
207,Jrue Holiday,PG,20,PHI,82,82,2901,446,999,81,222,365,777,172,209,68,264,332,531,120,29,218,203,1145
208,Ryan Hollins,C,26,CLE,70,16,1182,131,219,0,0,131,219,111,163,70,116,186,26,22,42,67,199,373
209,Al Horford,C,24,ATL,77,77,2704,513,921,2,4,511,917,150,188,182,536,718,266,59,80,119,193,1178
210,Eddie House,SG,32,MIA,56,1,978,128,321,68,175,60,146,38,40,9,83,92,62,32,3,29,68,362
211,Dwight Howard,C,25,ORL,78,78,2935,619,1044,0,7,619,1037,546,916,309,789,1098,107,107,186,279,258,1784
212,Josh Howard,SF,30,WAS,18,10,409,58,162,7,29,51,133,29,47,18,56,74,24,13,5,20,34,152
213,Juwan Howard,PF,37,MIA,57,0,592,55,125,0,0,55,125,29,35,36,86,122,23,10,4,25,61,139
214,Lester Hudson,PG,26,WAS,11,0,73,6,24,4,15,2,9,2,4,1,4,5,17,4,1,7,10,18
215,Kris Humphries,PF,25,NJN,74,44,2061,307,583,0,1,307,582,127,191,225,546,771,84,33,80,103,168,741
216,Serge Ibaka,PF,21,OKC,82,44,2216,335,617,0,1,335,616,138,184,214,408,622,22,31,198,71,267,808
217,Andre Iguodala,SF,27,PHI,67,67,2469,338,759,61,181,277,578,208,300,61,326,387,422,101,38,138,109,945
218,Zydrunas Ilgauskas,C,35,MIA,72,51,1145,162,319,0,1,162,318,36,46,108,179,287,26,23,58,52,185,360
219,Didier Ilunga-Mbenga,C,30,NOH,41,0,330,23,49,0,0,23,49,13,18,35,51,86,6,6,27,21,52,59
220,Ersan İlyasova,PF,23,MIL,60,34,1505,221,507,36,121,185,386,93,104,105,260,365,56,51,24,63,159,571
221,Royal Ivey,SG,29,OKC,25,0,155,16,38,7,16,9,22,2,2,2,14,16,7,6,1,5,17,41
223,Darnell Jackson,PF,25,SAC,59,2,486,77,158,3,11,74,147,30,49,49,45,94,14,12,3,23,61,187
224,Stephen Jackson,SG,32,CHA,67,67,2405,435,1059,121,359,314,700,249,305,53,251,304,241,80,28,209,161,1240
225,Damion James,SF,23,NJN,25,9,403,46,103,0,3,46,100,18,28,17,68,85,20,16,12,25,36,110
226,LeBron James,SF,26,MIA,79,79,3063,758,1485,92,279,666,1206,503,663,80,510,590,554,124,50,284,163,2111
227,Antawn Jamison,PF,34,CLE,56,38,1842,374,876,91,263,283,613,171,234,86,289,375,93,50,30,77,137,1010
228,Othyus Jeffers,SG,25,TOT,17,1,322,31,65,1,4,30,61,30,46,25,42,67,20,17,0,14,32,93
229,Al Jefferson,C,26,UTA,82,82,2940,654,1319,0,0,654,1319,220,289,235,559,794,149,46,153,105,238,1528
230,Richard Jefferson,SF,30,SAS,81,81,2459,304,642,135,307,169,335,148,195,54,256,310,107,38,34,93,164,891
231,Jared Jeffries,PF,29,TOT,42,9,601,30,86,2,9,28,77,12,29,62,54,116,36,31,17,21,75,74
232,Brandon Jennings,PG,21,MIL,63,61,2169,361,926,98,303,263,623,199,246,42,192,234,305,95,21,146,131,1019
233,Eugene Jeter,PG,27,SAC,62,1,858,106,259,6,30,100,229,37,41,9,61,70,162,29,2,51,54,255
234,Yi Jianlian,PF,23,WAS,63,11,1112,145,347,3,13,142,334,62,91,79,169,248,25,27,32,51,115,355
235,Amir Johnson,PF,23,TOR,72,54,1853,281,495,0,1,281,494,126,160,189,272,461,81,53,88,69,263,688
236,Armon Johnson,PG,21,POR,38,0,277,46,101,5,12,41,89,13,22,11,25,36,45,5,1,38,31,110
237,Chris Johnson,C,25,TOT,14,1,138,9,21,0,0,9,21,15,20,12,20,32,3,3,9,10,21,33
238,James Johnson,SF,23,TOT,38,25,822,108,237,8,34,100,203,47,71,37,105,142,89,33,37,64,95,271
239,Joe Johnson,SG,29,ATL,72,72,2554,514,1161,89,300,425,861,195,243,59,232,291,338,47,7,146,131,1312
240,Trey Johnson,SG,26,TOT,8,0,94,12,33,1,3,11,30,9,10,2,5,7,11,1,1,5,12,34
241,Wesley Johnson,SG,23,MIN,79,63,2069,271,682,103,289,168,393,64,92,51,189,240,148,58,54,95,163,709
242,Dahntay Jones,SG,30,IND,45,2,589,100,214,14,39,86,175,69,90,4,61,65,33,20,7,31,70,283
243,Dominique Jones,SG,22,DAL,18,0,135,14,45,0,4,14,41,14,17,6,19,25,19,5,3,10,7,42
244,James Jones,SF,30,MIA,81,8,1549,146,346,123,287,23,59,60,72,23,137,160,43,29,19,21,129,475
245,Solomon Jones,C,26,IND,39,0,528,49,121,0,1,49,120,41,62,45,68,113,30,12,22,35,94,139
246,DeAndre Jordan,C,22,LAC,80,66,2047,234,341,0,1,234,340,98,217,207,368,575,42,41,142,101,255,566
247,Chris Kaman,C,28,LAC,32,15,838,177,376,0,0,177,376,43,57,51,174,225,46,16,48,58,75,397
248,Jason Kapono,SF,29,PHI,24,2,112,7,28,1,8,6,20,1,2,3,8,11,4,2,1,2,4,16
249,Jason Kidd*,PG,37,DAL,80,80,2653,215,596,133,391,82,205,67,77,35,316,351,655,134,29,179,119,630
250,Andrei Kirilenko,SF,29,UTA,64,62,1999,253,542,36,98,217,444,208,270,100,227,327,192,81,74,117,113,750
251,Linas Kleiza,SF,26,TOR,39,23,1032,178,406,39,131,139,275,41,65,37,140,177,40,19,7,65,99,436
252,Kyle Korver,SG,29,CHI,82,0,1649,242,557,120,289,122,268,77,87,12,138,150,124,35,20,60,156,681
253,Kosta Koufos,C,21,TOT,50,2,434,68,150,0,2,68,148,24,43,57,73,130,7,10,25,31,59,160
254,Nenad Krstić,C,27,TOT,71,67,1571,231,452,0,0,231,452,113,146,124,211,335,27,26,25,56,184,575
255,Carl Landry,PF,27,TOT,76,26,2008,345,687,0,4,345,683,213,288,165,182,347,63,40,32,109,196,903
256,Acie Law,PG,26,TOT,51,0,726,81,186,6,36,75,150,47,64,12,51,63,84,32,0,43,61,215
257,Gani Lawal,PF,22,PHO,1,0,2,0,0,0,0,0,0,0,0,0,0,0,0,0,0,0,1,0
258,Ty Lawson,PG,23,DEN,80,31,2103,346,688,69,171,277,517,172,225,67,142,209,377,80,4,137,133,933
259,Courtney Lee,SG,25,HOU,81,1,1723,253,576,71,174,182,402,95,120,51,158,209,100,58,18,68,102,672
260,David Lee,PF,27,GSW,73,73,2634,496,978,1,3,495,975,210,267,217,497,714,233,74,31,170,211,1203
262,Jeremy Lin,PG,22,GSW,29,0,285,28,72,1,5,27,67,19,25,12,22,34,42,33,9,18,31,76
263,Shaun Livingston,PG,25,CHA,73,0,1261,185,397,1,4,184,393,108,125,29,120,149,164,47,29,88,109,479
264,Brook Lopez,C,22,NJN,82,82,2889,644,1309,0,1,644,1308,385,489,197,291,488,129,47,120,176,240,1673
265,Robin Lopez,C,22,PHO,67,56,991,179,357,0,0,179,357,74,100,82,134,216,8,18,45,48,143,432
266,Kevin Love,PF,22,MIN,73,73,2611,482,1026,88,211,394,815,424,499,330,782,1112,184,45,28,155,148,1476
267,Kyle Lowry,PG,24,HOU,75,71,2563,345,809,129,343,216,466,192,251,89,220,309,500,102,23,158,207,1011
268,John Lucas III,PG,28,CHI,2,0,10,1,3,0,1,1,2,0,2,0,0,0,1,0,0,0,0,2
269,Corey Maggette,SF,31,MIL,67,18,1401,253,559,28,78,225,481,271,325,44,197,241,84,21,5,127,175,805
270,Jamaal Magloire,C,32,MIA,18,0,158,13,22,0,0,13,22,9,18,17,44,61,3,4,2,5,26,35
271,Ian Mahinmi,C,24,DAL,56,0,488,55,98,0,2,55,96,63,82,43,77,120,8,14,15,25,105,173
272,Shawn Marion,SF,32,DAL,80,27,2253,434,834,5,33,429,801,126,164,168,383,551,110,68,50,130,144,999
273,Sean Marks,C,35,POR,29,0,208,19,44,2,2,17,42,5,8,16,24,40,4,3,5,11,44,45
274,Cartier Martin,SF,26,WAS,52,1,542,71,182,39,99,32,83,28,40,20,54,74,18,18,6,16,52,209
275,Kenyon Martin,PF,33,DEN,48,48,1233,185,362,2,9,183,353,42,72,67,230,297,109,43,35,59,136,414
276,Kevin Martin,SG,27,HOU,80,80,2603,553,1267,176,459,377,808,594,669,28,230,258,198,80,15,184,155,1876
277,Roger Mason,SG,30,NYK,26,0,319,26,77,16,44,10,33,7,10,5,38,43,20,6,2,6,25,75
278,Wesley Matthews,SG,24,POR,82,69,2758,440,979,154,378,286,601,266,315,48,210,258,164,102,9,138,195,1300
279,Jason Maxiell,PF,27,DET,57,14,930,93,189,0,0,93,189,51,99,66,107,173,17,24,21,44,92,237
280,Eric Maynor,PG,23,OKC,82,0,1200,134,333,37,96,97,237,43,59,25,96,121,238,35,6,77,96,348
281,O.J. Mayo,SG,23,MEM,71,17,1869,304,747,96,264,208,483,99,131,35,135,170,145,73,26,99,127,803
282,Luc Mbah a Moute,PF,24,MIL,79,52,2093,198,428,0,7,198,421,133,188,169,251,420,68,72,28,77,180,529
283,Antonio McDyess,PF,36,SAS,73,16,1387,169,344,0,1,169,343,52,77,122,273,395,84,36,39,72,163,390
284,JaVale McGee,C,23,WAS,79,75,2193,332,604,0,3,332,601,134,230,223,411,634,38,41,193,102,232,798
285,Tracy McGrady*,SG,31,DET,72,39,1686,227,514,30,88,197,426,90,129,49,202,251,252,66,34,102,101,574
286,Dominic McGuire,SF,25,CHA,52,8,760,72,182,0,2,72,180,30,39,63,136,199,43,10,33,25,94,174
287,Josh McRoberts,PF,23,IND,72,51,1597,211,386,23,60,188,326,88,119,109,273,382,150,47,57,93,165,533
288,Jodie Meeks,SG,23,PHI,74,64,2062,242,570,138,348,104,222,152,170,21,150,171,78,63,4,60,97,774
289,Pops Mensah-Bonsu,PF,27,NOH,7,0,35,1,3,0,0,1,3,0,0,3,8,11,2,0,0,2,11,2
290,C.J. Miles,SF,23,UTA,78,19,1969,366,899,109,339,257,560,159,196,54,201,255,135,74,38,93,221,1000
291,Darko Miličić,C,25,MIN,69,69,1686,271,578,0,0,271,578,64,115,133,227,360,104,54,140,151,229,606
292,Andre Miller,PG,34,POR,81,81,2650,388,844,4,37,384,807,249,292,97,205,302,566,114,12,197,171,1029
293,Brad Miller,C,34,HOU,60,5,1015,132,296,40,107,92,189,78,94,44,178,222,145,28,21,54,98,382
294,Mike Miller,SG,30,MIA,41,2,838,81,202,43,118,38,84,23,34,38,146,184,51,20,2,41,88,228
295,Patty Mills,PG,22,POR,64,0,783,135,328,47,133,88,195,36,47,19,32,51,109,27,1,62,63,353
296,Paul Millsap,PF,25,UTA,76,76,2605,525,988,9,23,516,965,256,338,164,415,579,187,103,69,145,272,1315
297,Yao Ming*,C,30,HOU,5,5,91,18,37,0,0,18,37,15,16,7,20,27,4,0,8,7,13,51
298,Nazr Mohammed,C,33,TOT,75,37,1280,234,448,0,1,234,447,67,112,140,228,368,23,30,56,70,184,535
299,Greg Monroe,C,20,DET,80,48,2222,303,550,0,1,303,549,145,233,248,353,601,105,93,45,81,196,751
300,Jamario Moon,SF,30,TOT,59,20,1042,101,248,38,123,63,125,15,17,23,142,165,52,28,33,22,65,255
301,Anthony Morrow,SG,25,NJN,58,47,1856,279,620,110,260,169,360,96,107,37,135,172,68,19,7,54,135,764
302,Timofey Mozgov,C,24,TOT,45,14,524,63,133,0,0,63,133,37,52,46,75,121,15,15,25,35,84,163
303,Byron Mullens,PF,21,OKC,13,0,85,9,28,0,0,9,28,7,14,6,18,24,0,2,3,8,11,25
304,Troy Murphy,PF,30,TOT,35,4,466,42,114,5,33,37,81,20,30,22,91,113,23,15,3,20,47,109
305,Hamady N'Diaye,C,24,WAS,16,0,80,4,5,0,0,4,5,6,12,2,5,7,0,2,5,3,18,14
306,Eduardo Nájera,PF,34,CHA,31,0,372,26,72,11,34,15,38,6,11,14,30,44,20,11,6,13,52,69
307,Steve Nash*,PG,36,PHO,75,75,2497,399,811,81,205,318,606,227,249,40,220,260,855,48,4,265,87,1106
308,Gary Neal,SG,26,SAS,80,1,1685,285,632,129,308,156,324,84,104,21,175,196,96,27,4,78,148,783
309,Jameer Nelson,PG,28,ORL,76,76,2319,374,838,119,297,255,541,130,162,37,189,226,456,75,3,194,209,997
310,Joakim Noah,C,25,CHI,48,48,1576,211,402,0,1,211,401,139,188,182,316,498,107,48,72,90,156,561
311,Andrés Nocioni,SF,31,PHI,54,17,931,118,277,42,118,76,159,49,61,19,150,169,45,14,15,47,100,327
312,Steve Novak,SF,27,TOT,30,0,215,35,67,26,46,9,21,8,8,4,24,28,3,1,5,4,14,104
313,Dirk Nowitzki,PF,32,DAL,73,73,2504,610,1179,66,168,544,1011,395,443,50,463,513,190,38,47,137,172,1681
314,Jermaine O'Neal,C,32,BOS,24,10,431,50,109,0,1,50,108,29,43,25,63,88,12,2,30,27,65,129
315,Shaquille O'Neal*,C,38,BOS,37,36,752,134,201,0,0,134,201,73,131,48,130,178,26,16,42,56,120,341
316,Fabricio Oberto,C,35,POR,5,0,45,3,5,0,0,3,5,1,2,3,4,7,0,0,0,3,10,7
317,Lamar Odom,PF,31,LAL,82,35,2639,473,893,68,178,405,715,166,246,175,535,710,249,47,61,139,200,1180
318,Emeka Okafor,C,28,NOH,72,72,2287,300,524,0,1,300,523,145,258,230,454,684,42,40,127,119,230,745
319,Mehmet Okur,C,31,UTA,13,0,168,22,62,5,16,17,46,15,20,9,21,30,19,4,4,7,18,64
320,Travis Outlaw,SF,26,NJN,82,55,2358,274,731,76,252,198,479,132,171,54,271,325,84,34,36,71,148,756
321,Larry Owens,SF,28,TOT,12,0,143,15,32,6,13,9,19,4,9,1,14,15,8,9,5,5,18,40
322,Zaza Pachulia,C,26,ATL,79,7,1244,107,232,0,0,107,232,135,179,119,214,333,58,34,22,69,184,349
323,Anthony Parker,SF,35,CLE,72,65,2091,220,552,86,227,134,325,74,95,33,185,218,218,67,10,80,109,600
324,Tony Parker,PG,28,SAS,78,78,2528,555,1069,25,70,530,999,233,303,30,208,238,513,90,3,200,135,1368
325,Patrick Patterson,PF,21,HOU,52,6,868,149,267,0,2,149,265,30,42,86,114,200,41,17,37,31,77,328
326,Chris Paul,PG,25,NOH,80,80,2880,430,928,71,183,359,745,337,384,38,289,327,782,188,5,177,196,1268
328,Nikola Peković,C,25,MIN,65,11,887,136,263,0,0,136,263,87,114,90,103,193,27,18,35,91,181,359
329,Kendrick Perkins,C,26,TOT,29,24,742,67,130,0,0,67,130,40,72,62,170,232,26,9,26,56,91,174
330,Morris Peterson,SG,33,OKC,4,0,23,2,5,0,1,2,4,0,0,0,3,3,1,0,0,0,5,4
331,Johan Petro,C,25,NJN,77,1,893,129,290,0,4,129,286,15,28,62,150,212,44,34,34,46,178,273
332,Paul Pierce,SF,33,BOS,80,80,2774,507,1021,111,297,396,724,386,449,34,396,430,260,80,51,171,231,1511
334,Dexter Pittman,C,22,MIA,2,0,11,1,3,0,0,1,3,0,0,1,2,3,0,0,0,2,2,2
335,Quincy Pondexter,SF,22,NOH,66,6,734,73,180,18,50,55,130,24,34,23,65,88,28,17,10,16,63,188
336,James Posey,SF,34,IND,49,0,839,81,241,67,212,14,29,11,15,10,137,147,34,24,6,24,103,240
338,Josh Powell,PF,28,ATL,54,0,653,94,208,0,1,94,207,36,45,49,86,135,22,5,5,53,78,224
339,A.J. Price,PG,24,IND,50,0,795,114,320,41,149,73,171,54,81,16,56,72,111,29,1,53,61,323
340,Ronnie Price,SG,27,UTA,59,0,717,74,210,20,69,54,141,29,39,22,39,61,56,42,5,55,106,197
341,Tayshaun Prince,SF,30,DET,78,78,2562,473,1001,34,98,439,903,118,168,78,251,329,215,30,41,82,90,1098
342,Joel Przybilla,C,31,TOT,36,9,519,25,44,0,0,25,44,14,27,37,108,145,13,5,15,29,79,64
343,Chris Quinn,PG,27,SAS,41,0,292,33,91,11,37,22,54,4,8,3,22,25,42,5,1,12,29,81
344,Vladimir Radmanović,PF,30,GSW,74,6,1169,137,318,70,173,67,145,30,34,64,148,212,79,44,44,57,157,374
346,Zach Randolph,PF,29,MEM,75,74,2724,598,1188,8,43,590,1145,300,396,326,588,914,163,63,25,151,175,1504
347,Theo Ratliff,C,37,LAL,10,0,71,1,6,0,0,1,6,0,2,6,7,13,3,2,5,3,7,2
348,Andy Rautins,SG,24,NYK,5,0,24,3,7,1,4,2,3,1,2,0,1,1,3,1,0,7,0,8
349,Michael Redd,SG,31,MIL,10,0,134,18,45,4,17,14,28,4,4,0,8,8,12,2,1,4,4,44
350,J.J. Redick,SG,26,ORL,59,5,1513,197,447,87,219,110,228,112,128,6,107,113,102,29,3,53,80,593
351,Jason Richardson,SG,30,TOT,80,80,2715,472,1056,189,479,283,577,116,159,67,264,331,147,93,13,95,162,1249
352,Quentin Richardson,SF,30,ORL,57,19,955,87,255,42,146,45,109,33,44,39,139,178,38,25,5,33,74,249
353,Luke Ridnour,PG,29,MIN,71,66,2159,319,681,81,184,238,497,121,137,37,162,199,384,89,10,158,146,840
354,Nate Robinson,PG,26,TOT,59,11,1013,150,376,65,200,85,176,36,44,15,75,90,111,29,4,68,115,401
355,Rajon Rondo,PG,24,BOS,68,68,2527,318,670,10,43,308,627,75,132,87,210,297,760,153,11,234,120,721
356,Derrick Rose,PG,22,CHI,81,81,3026,711,1597,128,385,583,1212,476,555,81,249,330,623,85,51,278,136,2026
357,Quinton Ross,SF,29,NJN,36,4,353,26,59,0,3,26,56,5,14,10,20,30,10,3,6,7,40,57
358,Brandon Roy,SG,26,POR,47,23,1310,209,523,38,114,171,409,117,138,28,93,121,129,37,12,55,76,573
359,Brandon Rush,SG,25,IND,67,21,1754,217,515,93,223,124,292,80,106,33,184,217,62,41,35,69,107,607
360,John Salmons,SG,31,MIL,73,70,2554,373,898,83,219,290,679,195,240,27,239,266,252,72,28,137,157,1024
361,Samardo Samuels,PF,22,CLE,37,10,701,110,241,0,3,110,238,68,110,75,83,158,17,15,18,53,88,288
362,Larry Sanders,C,22,MIL,60,12,872,116,268,0,0,116,268,28,50,59,119,178,16,22,72,38,117,260
363,Brian Scalabrine,PF,32,CHI,18,0,88,10,19,0,5,10,14,0,0,1,7,8,6,3,4,5,18,20
364,Luis Scola,PF,30,HOU,74,74,2412,569,1129,0,3,569,1126,214,290,147,459,606,185,48,44,147,227,1352
365,Thabo Sefolosha,SG,26,OKC,79,79,2049,157,333,28,102,129,231,59,79,65,281,346,111,97,38,55,171,401
366,Kevin Séraphin,PF,21,WAS,58,1,635,66,147,0,0,66,147,22,31,80,72,152,10,17,28,42,126,154
367,Ramon Sessions,PG,24,CLE,81,38,2133,362,776,3,15,359,761,348,423,46,209,255,419,60,8,178,93,1075
368,Mustafa Shakur,PG,26,WAS,22,0,159,21,59,1,10,20,49,8,15,7,15,22,25,5,3,18,15,51
369,Garret Siler,C,24,PHO,21,0,101,17,31,0,0,17,31,11,22,16,12,28,3,1,4,10,20,45
370,Bobby Simmons,SF,30,SAS,2,0,16,0,3,0,3,0,0,0,0,0,0,0,2,0,0,0,2,0
371,Brian Skinner,C,34,MIL,2,0,6,0,0,0,0,0,0,0,0,0,0,0,0,0,0,0,0,0
372,Craig Smith,PF,27,LAC,48,0,586,104,188,0,5,104,183,50,68,43,74,117,31,16,7,33,84,258
373,Ish Smith,PG,22,TOT,43,3,442,43,115,3,10,40,105,12,21,7,40,47,79,18,2,34,37,101
374,J.R. Smith,SF,25,DEN,79,6,1968,341,784,124,318,217,466,163,221,45,277,322,175,92,16,100,173,969
375,Jason Smith,C,24,NOH,77,6,1102,136,307,0,2,136,305,59,70,89,152,241,36,26,32,53,150,331
376,Joe Smith,PF,35,TOT,16,3,69,3,16,0,0,3,16,2,2,3,18,21,4,0,4,5,13,8
377,Josh Smith,PF,25,ATL,77,77,2645,497,1041,51,154,446,887,229,316,134,523,657,255,99,120,197,217,1274
378,Darius Songaila,C,32,PHI,10,0,71,7,15,0,0,7,15,2,4,2,8,10,2,0,0,4,16,16
379,Marreese Speights,C,23,PHI,64,1,734,144,291,1,4,143,287,55,73,64,146,210,30,8,19,40,120,344
380,Tiago Splitter,C,26,SAS,60,6,738,101,191,0,1,101,190,76,140,72,129,201,26,29,17,32,91,278
381,Jerry Stackhouse,SG,36,MIA,7,1,50,3,12,1,4,2,8,5,7,1,6,7,3,0,2,2,3,12
382,Lance Stephenson,SG,20,IND,12,0,115,13,39,0,5,13,34,11,14,1,17,18,21,4,0,16,14,37
383,DeShawn Stevenson,SG,29,DAL,72,54,1158,128,330,94,249,34,81,33,43,20,86,106,77,21,5,44,71,383
384,Peja Stojaković,SF,33,TOT,33,13,617,100,227,57,136,43,91,23,25,14,61,75,29,13,2,17,24,280
385,Amar'e Stoudemire,C,28,NYK,78,78,2870,744,1482,10,23,734,1459,473,597,198,438,636,202,71,150,250,274,1971
386,Rodney Stuckey,PG,24,DET,70,54,2183,363,827,26,90,337,737,330,381,70,146,216,361,76,10,155,177,1082
387,DaJuan Summers,SF,23,DET,22,1,199,28,69,9,21,19,48,9,20,2,10,12,2,3,1,13,21,74
388,Pape Sy,SF,22,ATL,3,0,21,2,6,0,1,2,5,3,3,2,1,3,2,1,0,3,1,7
389,Jermaine Taylor,SG,24,TOT,34,8,483,94,196,14,45,80,151,21,28,26,36,62,32,14,5,46,39,223
390,Jeff Teague,PG,22,ATL,70,7,963,133,304,18,48,115,256,77,97,11,91,102,138,45,25,64,82,361
391,Sebastian Telfair,PG,25,MIN,37,8,711,97,241,28,78,69,163,44,60,17,37,54,111,25,3,64,64,266
393,Jason Terry,SG,33,DAL,82,10,2564,492,1091,127,351,365,740,182,214,24,129,153,334,93,13,167,140,1293
394,Hasheem Thabeet,C,23,TOT,47,0,373,17,40,0,0,17,40,19,35,24,51,75,4,9,16,17,76,53
395,Etan Thomas,C,32,ATL,13,0,82,10,21,0,0,10,21,12,15,6,17,23,2,1,4,5,11,32
396,Kurt Thomas,PF,38,CHI,52,37,1178,95,186,1,1,94,185,20,32,75,226,301,60,32,42,42,164,211
397,Tyrus Thomas,C,24,CHA,41,2,861,156,331,0,3,156,328,107,136,65,159,224,29,30,66,65,113,419
398,Jason Thompson,PF,24,SAC,75,39,1748,271,534,0,3,271,531,121,200,144,310,454,88,28,44,99,212,663
400,Marcus Thornton,SG,23,TOT,73,23,1775,350,807,88,240,262,567,145,184,61,197,258,135,64,9,93,110,933
401,Anthony Tolliver,SF,25,MIN,65,4,1362,141,313,47,115,94,198,105,131,92,203,295,82,28,28,49,145,434
402,Ronny Turiaf,C,28,NYK,64,21,1141,103,163,0,0,103,163,61,98,64,143,207,92,35,73,41,160,267
404,Evan Turner,SG,22,PHI,78,14,1797,225,529,14,44,211,485,101,125,42,264,306,159,49,14,80,138,565
405,Ekpe Udoh,C,23,GSW,58,18,1030,97,222,0,0,97,222,42,64,80,101,181,40,22,86,48,144,236
406,Ime Udoka,SF,33,SAS,20,0,130,5,21,0,8,5,13,4,8,5,14,19,13,8,1,5,14,14
407,Beno Udrih,PG,28,SAC,79,64,2734,412,824,65,182,347,642,197,228,41,224,265,386,94,9,141,181,1086
408,Ben Uzoh,PG,22,NJN,42,0,438,61,144,3,8,58,136,33,56,30,31,61,69,13,8,25,29,158
409,Anderson Varejão,C,28,CLE,31,31,994,114,216,0,2,114,214,54,81,98,203,301,45,27,38,40,87,282
410,Greivis Vásquez,SG,24,MEM,70,1,860,95,233,25,86,70,147,34,44,12,61,73,151,22,4,70,83,249
411,Charlie Villanueva,PF,26,DET,76,11,1666,313,708,125,323,188,385,89,116,50,245,295,48,42,42,66,175,840
412,Sasha Vujačić,SG,26,TOT,67,17,1648,239,595,97,262,142,333,81,96,30,156,186,132,54,5,66,136,656
413,Dwyane Wade,SG,29,MIA,76,76,2823,692,1384,63,206,629,1178,494,652,123,362,485,346,111,87,237,197,1941
414,Von Wafer,SG,25,BOS,58,2,553,67,159,18,67,49,92,32,38,7,42,49,35,18,5,20,39,184
415,Henry Walker,SG,23,NYK,61,1,784,104,236,59,153,45,83,31,44,16,106,122,34,21,6,37,81,298
416,John Wall,PG,20,WAS,69,64,2606,398,972,34,115,364,857,301,393,35,282,317,574,121,35,261,175,1131
417,Ben Wallace,C,36,DET,54,49,1238,67,149,1,2,66,147,19,57,129,221,350,72,54,54,44,81,154
419,Luke Walton,SF,30,LAL,54,0,484,38,116,8,34,30,82,7,10,9,58,67,62,9,4,31,38,91
420,Willie Warren,PG,21,LAC,19,0,134,13,35,5,15,8,20,6,8,1,11,12,27,6,0,8,16,37
421,Hakim Warrick,PF,28,PHO,80,6,1416,228,446,1,11,227,435,212,294,88,208,296,69,32,9,79,100,669
422,C.J. Watson,PG,26,CHI,82,1,1091,146,394,44,112,102,282,69,93,16,78,94,186,55,11,73,82,405
423,Earl Watson,PG,31,UTA,80,13,1567,126,307,36,107,90,200,55,82,52,130,182,278,61,17,116,146,343
424,Kyle Weaver,SG,24,UTA,5,0,69,9,25,3,7,6,18,7,8,2,8,10,7,2,2,7,3,28
425,Martell Webster,SF,24,MIN,46,1,1094,152,340,55,132,97,208,94,122,36,111,147,53,28,9,58,101,453
426,Sonny Weems,SF,24,TOR,59,28,1413,228,513,17,61,211,452,72,94,39,114,153,104,34,2,86,87,545
427,David West,PF,30,NOH,70,70,2451,528,1040,2,9,526,1031,264,327,155,374,529,164,67,62,142,202,1322
428,Delonte West,PG,27,BOS,24,2,453,55,120,12,33,43,87,13,15,6,31,37,64,20,10,30,29,135
429,Mario West,SG,26,NJN,6,3,116,9,21,1,4,8,17,3,5,2,9,11,10,7,0,2,13,22
430,Russell Westbrook,PG,22,OKC,82,82,2847,614,1390,34,103,580,1287,531,631,121,258,379,670,155,30,316,207,1793
432,Hassan Whiteside,C,21,SAC,1,0,2,0,0,0,0,0,0,0,0,0,0,0,0,0,0,0,2,0
433,Chris Wilcox,PF,28,DET,57,29,995,187,322,0,1,187,321,50,89,95,176,271,43,29,17,43,145,424
434,Damien Wilkins,SF,31,ATL,52,0,676,69,137,2,10,67,127,40,56,23,67,90,41,27,9,21,72,180
435,Deron Williams,PG,26,TOT,65,65,2465,428,975,105,317,323,658,348,412,40,220,260,667,79,15,230,190,1309
436,Jason Williams,PG,35,TOT,27,0,295,22,67,10,38,12,29,0,0,3,27,30,52,11,1,18,8,54
437,Jawad Williams,SF,27,CLE,26,1,391,41,126,13,45,28,81,9,12,7,41,48,22,9,3,16,34,104
438,Lou Williams,SG,24,PHI,75,0,1747,323,795,88,253,235,542,293,356,32,117,149,252,47,17,102,128,1027
439,Marvin Williams,SF,24,ATL,65,52,1865,246,537,37,110,209,427,147,174,68,245,313,88,34,23,62,104,676
440,Mo Williams,PG,28,TOT,58,56,1788,291,730,79,244,212,486,151,177,21,132,153,380,53,10,171,150,812
441,Reggie Williams,SF,24,GSW,80,9,1626,268,572,102,241,166,331,100,134,45,171,216,121,28,3,57,124,738
442,Shawne Williams,PF,24,NYK,64,11,1323,164,385,85,212,79,173,41,49,60,179,239,47,39,51,46,164,454
443,Shelden Williams,PF,27,TOT,59,38,911,103,220,0,0,103,220,58,75,93,180,273,32,23,26,43,126,264
444,Terrence Williams,SG,23,TOT,21,0,290,43,115,6,22,37,93,14,21,4,47,51,38,9,0,33,25,106
445,Metta World Peace,SF,31,LAL,82,82,2410,261,658,83,233,178,425,92,136,100,167,267,175,124,36,90,181,697
446,Antoine Wright,SG,26,SAC,7,0,31,1,8,0,4,1,4,0,0,2,1,3,0,1,0,1,3,2
447,Brandan Wright,PF,23,TOT,37,2,379,60,117,0,0,60,117,21,31,31,58,89,12,11,17,14,34,141
448,Dorell Wright,SF,25,GSW,82,82,3147,485,1146,194,516,291,630,180,228,88,343,431,242,124,63,133,171,1344
449,Julian Wright,SF,23,TOR,52,6,766,82,160,2,10,80,150,22,43,47,71,118,58,39,20,43,45,188
450,Nick Young,SG,25,WAS,64,40,2034,412,935,105,271,307,664,186,228,26,148,174,75,45,17,90,144,1115
451,Sam Young,SF,25,MEM,78,46,1577,233,494,17,50,216,444,89,116,40,147,187,71,68,23,61,120,572
452,Thaddeus Young,PF,22,PHI,82,1,2135,458,847,6,22,452,825,123,174,153,281,434,82,90,26,99,170,1045
1,Jeff Adrien,PF,25,HOU,8,0,63,7,16,0,0,7,16,7,12,5,17,22,1,0,2,2,13,21
2,Arron Afflalo,SG,26,DEN,62,62,2086,329,699,88,221,241,478,197,247,40,157,197,149,36,13,85,134,943
3,Blake Ahearn,PG,27,UTA,4,0,30,4,14,2,9,2,5,0,0,0,2,2,1,0,0,5,4,10
4,Solomon Alabi,C,23,TOR,14,0,122,13,36,0,0,13,36,7,8,15,32,47,3,2,9,5,11,33
5,Cole Aldrich,C,23,OKC,26,0,173,22,42,0,0,22,42,13,14,13,35,48,3,8,16,9,22,57
6,LaMarcus Aldridge,PF,26,POR,55,55,1994,483,943,2,11,481,932,223,274,150,292,442,134,51,45,111,153,1191
7,Lavoy Allen,PF,22,PHI,41,15,624,79,167,0,0,79,167,11,14,47,124,171,34,13,18,20,73,169
8,Ray Allen*,SG,36,BOS,46,42,1565,226,493,106,234,120,259,97,106,14,128,142,109,49,8,68,83,655
9,Tony Allen,SG,30,MEM,58,57,1525,210,448,8,26,202,422,140,175,98,135,233,79,104,33,94,142,568
10,Morris Almond,SG,26,WAS,4,0,67,6,17,1,3,5,14,1,3,1,7,8,2,7,0,1,6,14
11,Al-Farouq Aminu,SF,21,NOH,66,21,1477,150,365,13,47,137,318,86,114,95,213,308,66,59,34,91,136,399
12,Lou Amundson,PF,29,IND,60,0,753,89,207,0,0,89,207,35,82,94,128,222,14,27,44,45,125,213
13,Chris Andersen,C,33,DEN,32,1,486,59,108,0,0,59,108,50,82,48,100,148,6,19,46,17,52,168
14,Alan Anderson,SF,29,TOR,17,12,461,55,142,24,61,31,81,29,34,8,26,34,26,5,3,25,35,163
15,James Anderson,SG,22,SAS,51,2,603,66,174,19,68,47,106,39,52,16,63,79,41,8,2,30,35,190
16,Ryan Anderson,PF,23,ORL,61,61,1964,332,757,166,422,166,335,150,171,224,247,471,54,50,26,57,146,980
17,Carmelo Anthony,SF,27,NYK,55,55,1876,441,1025,68,203,373,822,295,367,88,256,344,200,62,24,144,156,1245
18,Joel Anthony,C,29,MIA,64,51,1349,85,152,0,0,85,152,49,71,100,150,250,9,36,84,45,126,219
19,Gilbert Arenas,PG,30,MEM,17,0,211,26,64,13,39,13,25,7,10,2,16,18,18,11,1,12,35,72
20,Trevor Ariza,SF,26,NOH,41,41,1350,168,403,29,87,139,316,79,102,41,174,215,135,69,25,76,73,444
21,Ömer Aşık,C,25,CHI,66,2,971,79,156,0,0,79,156,47,103,127,223,350,32,30,68,68,121,205
22,D.J. Augustin,PG,24,CHA,48,46,1408,183,487,61,179,122,308,105,120,24,85,109,307,36,1,110,65,532
23,Gustavo Ayón,PF,26,NOH,54,24,1088,140,261,0,1,140,260,39,63,86,179,265,74,53,46,46,118,319
24,Jeff Ayres,C,24,IND,20,1,106,15,36,0,0,15,36,4,7,12,21,33,4,3,2,2,16,34
25,Kelenna Azubuike,SG,28,DAL,3,0,18,3,8,1,3,2,5,0,0,0,0,0,0,1,0,4,1,7
26,Luke Babbitt,SF,22,POR,40,4,537,71,173,43,100,28,73,17,20,16,79,95,16,10,4,27,46,202
27,Renaldo Balkman,SF,27,NYK,14,0,115,16,32,2,9,14,23,8,11,6,20,26,5,4,3,6,14,42
28,Leandro Barbosa,SG,29,TOT,64,0,1382,271,637,65,170,206,467,101,124,33,95,128,96,56,7,94,135,708
29,J.J. Barea,PG,27,MIN,41,11,1032,167,418,53,143,114,275,76,98,14,100,114,232,21,0,103,61,463
30,Andrea Bargnani,C,26,TOR,31,31,1032,209,484,34,115,175,369,151,173,24,148,172,61,18,15,69,52,603
31,Matt Barnes,SF,31,LAL,63,16,1440,175,387,46,138,129,249,95,128,97,247,344,126,35,48,73,152,491
32,Earl Barron,C,30,GSW,2,0,9,2,4,0,0,2,4,0,0,1,0,1,0,0,0,0,5,4
33,Brandon Bass,PF,26,BOS,59,39,1868,303,632,0,0,303,632,132,163,95,270,365,55,34,54,65,135,738
34,Tony Battie,C,35,PHI,27,11,295,19,51,0,1,19,50,4,4,8,59,67,16,4,6,4,26,42
35,Shane Battier,SF,33,MIA,65,10,1499,113,292,62,183,51,109,23,37,56,100,156,82,64,33,37,105,311
36,Nicolas Batum,SF,23,POR,59,34,1791,289,641,107,274,182,367,133,159,81,190,271,84,57,60,90,105,818
37,Jerryd Bayless,PG,23,TOR,31,11,705,117,276,44,104,73,172,75,88,8,58,66,118,24,4,53,70,353
38,Michael Beasley,SF,23,MIN,47,7,1087,221,497,38,101,183,396,61,95,39,168,207,45,18,19,80,83,541
39,Rodrigue Beaubois,PG,23,DAL,53,12,1151,188,445,38,132,150,313,58,69,19,132,151,152,56,28,70,98,472
40,Marco Belinelli,SG,25,NOH,66,55,1966,286,686,107,284,179,402,101,129,19,153,172,101,48,5,69,115,780
41,Raja Bell,SG,35,UTA,34,33,796,81,174,34,87,47,87,21,25,6,43,49,38,13,2,21,78,217
42,Keith Benson,C,23,GSW,3,0,9,0,1,0,0,0,1,0,0,2,1,3,0,0,0,0,0,0
43,Mike Bibby,PG,33,NYK,39,4,557,35,124,27,85,8,39,6,8,5,54,59,80,21,3,20,45,103
44,Andris Biedriņš,C,25,GSW,47,35,739,39,64,0,0,39,64,1,9,45,131,176,16,23,45,14,125,79
45,Chauncey Billups,SG,35,LAC,20,20,607,83,228,48,125,35,103,85,95,4,46,50,80,9,3,38,40,299
46,Bismack Biyombo,C,19,CHA,63,41,1455,129,278,0,0,129,278,69,143,113,255,368,27,20,115,71,145,327
47,DeJuan Blair,PF,22,SAS,64,62,1363,269,504,0,1,269,503,73,119,154,197,351,78,59,12,92,168,611
48,Steve Blake,PG,31,LAL,53,5,1237,101,268,53,158,48,110,21,27,9,76,85,175,39,2,72,75,276
49,Andray Blatche,PF,25,WAS,26,13,626,93,245,2,7,91,238,33,49,42,108,150,28,20,17,37,54,221
50,Eric Bledsoe,PG,22,LAC,40,1,464,49,126,6,30,43,96,28,44,22,43,65,66,31,14,47,58,132
51,Keith Bogans,SF,31,NJN,5,1,94,8,21,3,12,5,9,2,5,5,6,11,3,2,0,3,15,21
52,Andrew Bogut,C,27,MIL,12,12,364,61,136,0,1,61,135,14,23,22,78,100,31,12,24,24,36,136
53,Matt Bonner,PF,31,SAS,65,2,1326,154,350,105,250,49,100,16,21,29,185,214,61,15,21,14,68,429
54,Trevor Booker,PF,24,WAS,50,32,1261,181,341,1,2,180,339,56,93,119,206,325,40,48,43,58,138,419
55,Carlos Boozer,PF,30,CHI,66,66,1948,448,842,0,1,448,841,95,137,114,450,564,125,63,24,115,168,991
56,Chris Bosh,PF,27,MIA,57,57,2007,393,807,10,35,383,772,229,279,94,358,452,103,51,45,117,128,1025
57,Earl Boykins,PG,35,HOU,8,0,111,12,36,2,9,10,27,13,15,0,11,11,17,1,0,7,5,39
58,Craig Brackins,PF,24,PHI,14,1,88,9,33,3,9,6,24,1,2,5,10,15,8,0,1,4,6,22
59,Avery Bradley,PG,21,BOS,64,28,1368,200,402,22,54,178,348,62,78,34,81,115,87,43,12,75,109,484
60,Elton Brand,C,32,PHI,60,60,1732,287,581,0,1,287,580,85,116,145,284,429,97,58,97,65,176,659
61,Corey Brewer,SF,25,DEN,59,17,1287,201,463,33,127,168,336,90,130,43,107,150,88,72,17,56,113,525
62,Ronnie Brewer,SG,26,CHI,66,43,1635,190,445,19,69,171,376,56,100,72,159,231,137,72,21,59,64,455
63,Jon Brockman,PF,24,MIL,35,0,239,15,45,0,1,15,44,7,15,33,42,75,9,4,1,10,33,37
64,MarShon Brooks,SG,23,NJN,56,47,1648,274,640,47,150,227,490,113,148,70,130,200,131,52,15,118,116,708
65,Derrick Brown,SF,24,CHA,65,17,1443,212,409,6,24,206,385,94,141,95,141,236,67,48,12,55,96,524
66,Kwame Brown,C,29,GSW,9,3,187,21,40,0,0,21,40,15,34,16,41,57,4,8,0,14,21,57
67,Shannon Brown,SG,26,PHO,59,19,1400,251,598,68,188,183,410,80,99,38,119,157,69,44,15,64,66,650
68,Kobe Bryant,SG,33,LAL,58,58,2232,574,1336,87,287,487,1049,381,451,66,247,313,264,69,18,204,105,1616
69,Chase Budinger,SF,23,HOU,58,9,1298,208,471,88,219,120,252,54,70,38,179,217,74,29,7,55,65,558
70,Alec Burks,SG,20,UTA,59,0,939,153,357,15,45,138,312,104,143,57,75,132,55,27,5,51,84,425
71,Caron Butler,SF,31,LAC,63,63,1871,287,705,92,257,195,448,87,107,44,186,230,78,52,9,77,123,753
72,Jimmy Butler,SG,22,CHI,42,0,359,32,79,2,11,30,68,43,56,23,33,56,14,11,5,14,20,109
73,Rasual Butler,SF,32,TOR,34,14,453,41,133,21,77,20,56,7,12,6,60,66,19,7,5,15,39,110
74,Derrick Byars,PF,27,SAS,2,0,37,3,11,0,6,3,5,4,4,6,5,11,1,2,0,0,2,10
75,Andrew Bynum,C,24,LAL,60,60,2112,444,796,1,5,443,791,234,338,192,517,709,85,27,116,152,104,1123
76,Will Bynum,PG,29,DET,36,0,514,74,194,7,29,67,165,49,64,10,46,56,66,23,3,54,61,204
77,José Calderón,PG,30,TOR,53,53,1799,218,477,59,159,159,318,60,68,19,141,160,468,47,3,104,94,555
78,Marcus Camby,C,37,TOT,59,53,1352,128,287,2,5,126,282,29,64,157,373,530,107,50,85,57,126,287
79,Brian Cardinal,SF,34,DAL,44,0,277,14,55,10,49,4,6,5,6,4,30,34,16,8,2,8,38,43
81,Matt Carroll,SG,31,CHA,53,2,596,52,157,8,43,44,114,30,38,8,50,58,38,16,7,24,52,142
82,Anthony Carter,PG,36,TOR,24,0,209,17,53,5,17,12,36,8,10,5,28,33,34,8,4,17,20,47
83,Vince Carter,SG,35,DAL,61,40,1542,223,542,74,205,149,337,95,115,32,173,205,139,56,25,84,134,615
84,Omri Casspi,SF,23,CLE,65,35,1341,166,412,53,168,113,244,74,108,63,165,228,66,37,21,64,115,459
85,Mario Chalmers,PG,25,MIA,64,64,1825,223,498,101,260,122,238,80,101,16,155,171,222,97,11,142,166,627
86,Tyson Chandler,C,29,NYK,62,62,2061,241,355,0,2,241,353,217,315,212,400,612,56,56,89,102,186,699
87,Wilson Chandler,SF,24,DEN,8,6,215,31,79,3,12,28,67,10,12,6,35,41,17,6,6,18,18,75
88,Josh Childress,SF,28,PHO,34,0,491,48,99,4,24,44,75,0,2,31,64,95,34,14,6,9,38,100
89,Earl Clark,PF,24,ORL,45,1,559,51,139,0,0,51,139,21,29,35,89,124,18,12,32,25,72,123
90,Norris Cole,PG,23,MIA,65,2,1260,177,450,21,76,156,374,66,85,21,70,91,133,44,2,105,124,441
91,Jason Collins,C,33,ATL,30,10,308,16,40,0,0,16,40,7,15,12,36,48,10,4,3,10,34,39
92,Darren Collison,PG,24,IND,60,56,1878,230,523,34,94,196,429,127,153,30,157,187,287,49,14,114,101,621
93,Nick Collison,PF,31,OKC,63,0,1307,120,201,0,1,120,200,44,62,119,155,274,82,33,28,61,153,284
94,Mike Conley,PG,24,MEM,62,61,2174,296,684,60,159,236,525,136,158,22,134,156,404,136,11,125,133,788
95,Brian Cook,PF,31,TOT,32,0,276,31,98,10,50,21,48,9,10,10,53,63,10,6,5,11,48,81
96,Daequan Cook,SG,24,OKC,57,22,989,109,296,79,228,30,68,14,22,12,110,122,15,22,11,16,69,311
97,DeMarcus Cousins,C,21,SAC,64,62,1950,448,999,2,14,446,985,262,373,265,438,703,102,93,75,170,257,1160
98,Jamal Crawford,PG,31,POR,60,6,1613,283,737,80,260,203,477,191,206,16,102,118,191,55,14,111,74,837
99,Jordan Crawford,SG,23,WAS,64,32,1753,349,872,79,273,270,599,161,203,44,124,168,190,59,5,141,111,938
100,Dante Cunningham,PF,24,MEM,64,5,1124,144,279,0,2,144,277,45,69,91,155,246,37,42,34,29,98,333
101,Eddy Curry,C,29,MIA,14,1,83,12,26,0,0,12,26,6,8,4,8,12,1,0,2,10,17,30
102,Stephen Curry,PG,23,GSW,26,23,732,145,296,55,121,90,175,38,47,15,73,88,138,39,8,65,62,383
103,Samuel Dalembert,C,30,HOU,65,45,1446,200,395,0,1,200,394,90,113,158,298,456,33,37,111,82,162,490
104,Erick Dampier,C,36,ATL,15,0,83,1,8,0,0,1,8,0,0,10,15,25,4,1,4,3,9,2
105,Marquis Daniels,SG,31,BOS,38,0,484,52,143,0,10,52,133,17,23,16,50,66,47,21,9,28,36,121
106,Baron Davis,PG,32,NYK,29,14,595,68,184,26,85,42,99,16,24,13,43,56,135,34,3,76,61,178
107,Ed Davis,PF,22,TOR,66,9,1534,172,335,0,1,172,334,71,106,134,304,438,60,40,63,67,156,415
108,Glen Davis,PF,26,ORL,61,13,1427,225,534,2,14,223,520,114,167,107,224,331,47,43,19,75,106,566
109,Josh Davis,PF,31,MEM,15,0,130,10,27,4,13,6,14,4,8,16,11,27,6,7,1,3,19,28
110,Eric Dawson,C,27,SAS,4,0,39,7,12,0,0,7,12,1,2,5,5,10,0,1,2,3,6,15
111,Austin Daye,SF,23,DET,41,4,603,73,227,13,62,60,165,35,43,14,77,91,33,22,21,40,62,194
112,Carlos Delfino,SF,29,MIL,54,53,1537,182,453,86,239,96,214,38,48,20,188,208,123,79,10,66,99,488
113,Luol Deng,SF,26,CHI,54,54,2129,311,755,79,215,232,540,127,165,77,273,350,157,56,36,96,81,828
114,Justin Dentmon,PG,26,TOT,6,0,91,10,28,2,14,8,14,4,6,0,8,8,10,2,0,7,10,26
115,DeMar DeRozan,SG,22,TOR,63,63,2206,381,903,24,92,357,811,268,331,40,171,211,128,48,17,123,162,1054
116,Boris Diaw,PF,29,TOT,57,35,1424,156,351,31,99,125,252,22,35,70,210,280,205,34,25,112,125,365
117,Ike Diogu,PF,28,SAS,2,0,14,0,2,0,0,0,2,2,2,0,1,1,0,0,0,1,1,2
118,DeSagana Diop,C,30,CHA,27,9,325,15,42,0,0,15,42,1,6,33,52,85,23,6,13,19,36,31
119,Keyon Dooling,SG,31,BOS,46,2,662,66,163,27,81,39,82,23,31,3,36,39,51,13,2,34,57,182
120,Toney Douglas,PG,25,NYK,38,9,656,94,290,27,117,67,173,22,26,16,56,72,77,29,1,56,55,237
121,Goran Dragić,PG,25,HOU,66,28,1752,277,600,68,202,209,398,153,190,53,115,168,351,85,10,157,166,775
122,Jared Dudley,SG,26,PHO,65,60,2020,312,643,80,209,232,434,119,164,95,206,301,112,49,19,72,107,823
123,Chris Duhon,PG,29,ORL,63,9,1226,85,203,50,119,35,84,17,21,14,88,102,151,35,9,81,71,237
124,Tim Duncan,C,35,SAS,58,58,1634,361,733,0,4,361,729,173,249,110,410,520,132,38,88,97,98,895
125,Mike Dunleavy,SF,31,MIL,55,3,1445,239,504,83,208,156,296,116,143,29,175,204,117,28,8,58,87,677
126,Kevin Durant,SF,23,OKC,66,66,2546,643,1297,133,344,510,953,431,501,40,487,527,231,88,77,248,133,1850
127,Jerome Dyson,PG,24,NOH,9,1,180,19,48,1,8,18,40,28,36,2,17,19,18,11,2,20,19,67
128,Devin Ebanks,SG,22,LAL,24,12,396,37,89,0,9,37,80,23,35,26,28,54,12,11,6,18,26,97
129,Wayne Ellington,SG,24,MIN,51,4,973,122,302,35,108,87,194,32,40,14,85,99,33,26,10,26,56,311
130,Monta Ellis,SG,26,TOT,58,58,2120,450,1040,62,201,388,839,219,275,20,180,200,346,85,18,177,136,1181
131,Francisco Elson,C,35,PHI,5,0,16,1,3,0,0,1,3,0,0,0,1,1,1,1,1,1,0,2
132,Andre Emmett,SF,29,NJN,6,0,45,4,7,0,1,4,6,5,8,2,4,6,1,2,1,2,2,13
133,Semih Erden,C,25,CLE,28,9,333,39,74,0,0,39,74,21,41,20,52,72,9,10,5,16,60,99
134,Jeremy Evans,SF,24,UTA,29,0,217,27,42,0,1,27,41,8,16,19,31,50,13,6,24,5,23,62
135,Maurice Evans,SF,33,WAS,24,0,343,45,112,17,45,28,67,10,13,8,16,24,9,14,0,10,36,117
136,Reggie Evans,PF,31,LAC,56,0,771,34,72,0,0,34,72,36,71,100,171,271,17,31,6,44,118,104
137,Tyreke Evans,SG,22,SAC,63,61,2162,408,900,20,99,388,801,201,258,64,225,289,283,84,29,171,136,1037
138,Christian Eyenga,SF,22,TOT,7,0,102,6,25,1,3,5,22,4,8,4,10,14,5,3,5,3,7,17
139,Kenneth Faried,PF,22,DEN,46,39,1037,181,309,0,0,181,309,109,164,142,210,352,36,34,47,54,116,471
140,Jordan Farmar,PG,25,NJN,39,5,831,147,315,55,125,92,190,57,63,7,54,61,129,24,2,68,49,406
141,Derrick Favors,PF,20,UTA,65,9,1376,222,445,0,0,222,445,126,194,158,267,425,43,38,65,103,145,570
142,Raymond Felton,PG,27,POR,60,56,1906,261,642,62,203,199,439,100,124,27,122,149,390,78,10,170,122,684
143,Rudy Fernández,SG,26,DEN,31,1,710,99,225,40,122,59,103,30,43,9,56,65,75,31,3,40,37,268
144,Kyrylo Fesenko,C,25,IND,3,0,17,2,5,0,0,2,5,4,6,2,7,9,1,2,0,0,2,8
145,Landry Fields,SG,23,NYK,66,62,1894,236,513,31,121,205,392,77,137,59,219,278,169,79,17,102,99,580
146,Derek Fisher,PG,37,TOT,63,43,1508,129,348,35,109,94,239,57,67,12,109,121,170,51,4,73,117,350
147,Jonny Flynn,PG,22,TOT,29,1,416,46,131,10,34,36,97,29,39,8,31,39,96,6,2,36,23,131
148,Jeff Foote,C,24,NOH,4,0,39,2,6,0,0,2,6,0,0,1,5,6,0,0,1,2,5,4
149,Gary Forbes,SG,26,TOR,48,2,713,112,271,29,83,83,188,66,91,27,75,102,54,24,4,54,56,319
150,T.J. Ford,PG,28,SAS,14,0,191,19,43,2,8,17,35,11,14,3,15,18,45,9,2,23,23,51
151,Courtney Fortson,PG,23,TOT,10,0,95,11,32,3,13,8,19,10,15,6,9,15,10,3,0,10,5,35
152,Jeff Foster,C,35,IND,11,0,141,9,18,1,1,8,17,6,9,18,24,42,4,8,1,7,26,25
153,Randy Foye,SG,28,LAC,65,48,1682,256,644,127,329,129,315,73,85,25,113,138,146,46,24,73,130,712
154,Jimmer Fredette,PG,22,SAC,61,7,1135,172,446,78,216,94,230,40,48,17,56,73,108,30,3,67,73,462
155,Channing Frye,PF,28,PHO,64,59,1669,255,613,91,263,164,350,73,82,71,308,379,88,42,70,63,176,674
156,Dan Gadzuric,C,33,NYK,2,0,13,0,2,0,0,0,2,0,2,1,4,5,0,1,1,1,4,0
157,Sundiata Gaines,SG,25,NJN,57,12,793,102,271,28,82,74,189,59,96,27,81,108,126,55,2,52,58,291
158,Danilo Gallinari,SF,23,DEN,43,40,1351,193,466,60,183,133,283,182,209,28,174,202,116,42,23,68,86,628
159,Francisco García,SF,30,SAC,49,3,798,86,229,38,131,48,98,24,30,11,88,99,31,36,37,22,73,234
160,Kevin Garnett,C,35,BOS,60,60,1864,391,777,3,9,388,768,162,189,66,428,494,175,56,61,107,141,947
161,Marc Gasol,C,27,MEM,65,65,2370,357,740,1,12,356,728,237,317,120,459,579,204,62,121,121,201,952
162,Pau Gasol,PF,31,LAL,65,65,2430,459,917,7,27,452,890,204,261,183,495,678,237,37,88,142,127,1129
163,Rudy Gay,SF,25,MEM,65,65,2422,485,1067,54,173,431,894,208,263,130,287,417,147,95,55,161,138,1232
164,Alonzo Gee,SG,24,CLE,63,31,1827,227,551,44,137,183,414,167,212,101,221,322,113,83,17,114,149,665
165,Paul George,SG,21,IND,66,66,1958,281,639,90,234,191,405,146,182,56,314,370,158,108,38,117,191,798
166,Daniel Gibson,SG,25,CLE,35,7,916,87,248,55,139,32,109,34,43,11,90,101,76,26,16,45,69,263
167,Taj Gibson,PF,26,CHI,63,0,1284,200,404,0,0,200,404,84,135,135,197,332,47,27,81,60,131,484
168,Manu Ginóbili,SG,34,SAS,34,7,792,150,285,52,126,98,159,88,101,18,98,116,151,24,12,64,56,440
169,Mickell Gladness,PF,25,TOT,26,7,252,25,59,0,0,25,59,6,12,14,44,58,5,4,20,7,32,56
170,Ryan Gomes,SF,29,LAC,32,2,425,31,95,4,29,27,66,8,11,14,47,61,12,16,0,15,34,74
171,Drew Gooden,C,30,MIL,56,46,1469,287,657,16,55,271,602,176,208,130,233,363,144,46,34,109,112,766
172,Ben Gordon,SG,28,DET,52,21,1398,234,530,63,147,171,383,117,136,14,107,121,127,34,11,115,114,648
173,Eric Gordon,PG,23,NOH,9,9,310,63,140,10,40,53,100,49,65,2,23,25,31,13,4,24,20,185
174,Marcin Gortat,C,27,PHO,66,66,2114,427,769,0,2,427,767,163,251,185,474,659,59,48,99,90,142,1017
175,Andrew Goudelock,SG,23,LAL,40,0,419,68,174,28,75,40,99,11,12,5,26,31,20,4,0,21,32,175
176,Danny Granger,SF,28,IND,62,62,2062,391,941,123,323,268,618,254,291,79,228,307,109,62,40,110,144,1159
177,Aaron Gray,C,27,TOR,49,40,813,83,161,0,0,83,161,25,47,83,198,281,27,22,17,51,127,191
178,Danny Green,SG,24,SAS,66,38,1522,211,477,102,234,109,243,79,100,54,174,228,86,58,46,67,107,603
179,Gerald Green,SF,26,NJN,31,2,781,154,320,43,110,111,210,49,65,15,93,108,34,28,17,55,80,400
180,Willie Green,SG,30,ATL,53,2,922,153,325,50,113,103,212,48,56,15,65,80,40,23,6,33,74,404
181,Donté Greene,PF,23,SAC,53,7,777,108,266,25,105,83,161,44,55,19,114,133,34,18,29,32,67,285
182,Blake Griffin,PF,22,LAC,66,66,2392,561,1022,2,16,559,1006,244,468,218,499,717,210,54,48,150,216,1368
183,Hamed Haddadi,C,26,MEM,35,0,206,26,48,0,1,26,47,18,26,28,43,71,8,1,26,21,43,70
184,Jordan Hamilton,SF,21,DEN,26,2,258,48,111,17,47,31,64,2,5,11,51,62,20,4,3,16,15,115
185,Richard Hamilton,SG,33,CHI,28,28,697,140,310,17,46,123,264,29,37,20,46,66,84,12,1,49,56,326
186,Tyler Hansbrough,PF,26,IND,66,0,1442,194,479,0,1,194,478,226,278,113,177,290,30,54,9,65,159,614
187,Luke Harangody,PF,24,CLE,21,1,231,23,65,5,21,18,44,9,12,20,33,53,6,6,3,4,17,60
188,James Harden,SG,22,OKC,62,2,1946,309,629,114,292,195,337,312,369,30,222,252,229,62,15,137,150,1044
189,Justin Harper,PF,22,ORL,14,0,84,9,31,2,13,7,18,0,1,3,9,12,2,2,3,6,5,20
190,Josh Harrellson,PF,22,NYK,37,4,540,63,149,20,59,43,90,16,26,47,97,144,11,23,20,20,48,162
191,Al Harrington,PF,31,DEN,64,1,1761,345,773,101,303,244,470,119,176,72,318,390,88,58,12,112,181,910
192,Devin Harris,PG,28,UTA,63,63,1741,241,542,77,213,164,329,156,209,12,100,112,316,64,13,122,136,715
193,Manny Harris,SG,22,CLE,26,5,456,60,150,12,36,48,114,41,59,11,59,70,31,13,6,27,28,173
194,Terrel Harris,SG,24,MIA,22,1,318,29,83,8,39,21,44,14,21,18,33,51,26,9,2,25,34,80
195,Tobias Harris,SF,19,MIL,42,9,479,79,169,6,23,73,146,44,54,30,71,101,22,13,7,31,45,208
196,Udonis Haslem,PF,31,MIA,64,10,1589,151,357,0,0,151,357,83,102,117,353,470,42,35,24,60,142,385
197,Spencer Hawes,C,23,PHI,37,29,920,156,319,3,12,153,307,40,55,78,192,270,98,16,48,55,100,355
198,Chuck Hayes,C,28,SAC,54,9,1039,73,170,0,2,73,168,26,39,72,162,234,77,36,17,50,111,172
199,Gordon Hayward,SF,21,UTA,66,58,2015,267,586,55,159,212,427,193,232,59,171,230,207,53,41,109,106,782
200,Lazar Hayward,SF,25,OKC,26,0,141,13,38,4,14,9,24,7,12,2,14,16,4,3,1,9,18,37
201,Brendan Haywood,C,32,DAL,54,54,1146,118,228,0,0,118,228,45,96,139,185,324,19,24,54,46,121,281
202,Gerald Henderson,SG,24,CHA,55,55,1831,332,723,11,47,321,676,155,204,64,161,225,126,49,20,100,128,830
203,Xavier Henry,SG,20,NOH,45,0,759,90,228,7,17,83,211,52,85,24,82,106,35,26,8,35,59,239
204,Roy Hibbert,C,25,IND,65,65,1937,332,668,0,1,332,667,170,239,213,359,572,108,32,128,128,195,834
205,J.J. Hickson,PF,23,TOT,54,19,1244,183,392,0,2,183,390,86,134,133,202,335,45,30,35,70,85,452
206,Cory Higgins,PG,22,CHA,38,0,423,52,160,4,20,48,140,42,60,7,28,35,36,5,6,39,40,150
207,Nenê Hilário,C,29,TOT,39,33,1110,211,393,0,4,211,389,113,168,63,228,291,80,42,38,96,95,535
208,George Hill,PG,25,IND,50,9,1274,168,380,54,147,114,233,91,117,31,120,151,145,42,17,52,98,481
209,Grant Hill*,SF,39,PHO,49,46,1378,201,451,14,53,187,398,83,109,29,142,171,107,41,29,65,88,499
210,Jordan Hill,C,24,TOT,39,8,551,82,165,0,3,82,162,30,47,61,125,186,16,14,27,31,71,194
211,Kirk Hinrich,SG,31,ATL,48,31,1237,122,295,47,136,75,159,25,32,11,90,101,132,38,11,58,100,316
212,Darington Hobson,SG,24,MIL,5,0,39,2,13,0,6,2,7,0,0,0,3,3,6,0,0,2,1,4
213,Jrue Holiday,PG,21,PHI,65,65,2196,360,834,65,171,295,663,94,120,57,155,212,290,103,18,135,137,879
214,Ryan Hollins,C,27,TOT,39,8,522,46,84,0,0,46,84,39,75,34,48,82,9,5,17,35,78,131
215,Tyler Honeycutt,SF,21,SAC,15,0,88,8,24,1,3,7,21,3,5,3,11,14,7,4,3,2,3,20
216,Al Horford,C,25,ATL,11,11,348,57,103,0,1,57,102,22,30,26,51,77,24,10,14,16,21,136
217,Dennis Horner,PF,23,NJN,8,0,22,1,4,0,1,1,3,3,4,2,3,5,0,0,0,1,1,5
218,Dwight Howard,C,26,ORL,54,54,2070,416,726,0,7,416,719,281,572,200,585,785,104,81,116,175,159,1113
219,Josh Howard,SF,31,UTA,43,18,991,144,361,9,37,135,324,75,97,39,119,158,50,32,10,53,91,372
220,Juwan Howard,PF,38,MIA,28,0,190,17,55,0,0,17,55,8,10,18,29,47,10,4,1,20,18,42
221,Lester Hudson,PG,27,TOT,16,0,334,62,162,16,64,46,98,34,41,7,39,46,36,14,3,32,26,174
222,Larry Hughes,PG,33,ORL,9,0,114,5,22,1,7,4,15,1,2,1,4,5,7,2,0,12,10,12
223,Kris Humphries,PF,26,NJN,62,62,2162,323,671,0,0,323,671,209,278,233,448,681,90,50,74,119,173,855
224,Serge Ibaka,PF,22,OKC,66,66,1792,262,490,1,3,261,487,78,118,193,305,498,28,33,241,79,179,603
225,Andre Iguodala,SF,28,PHI,62,62,2209,287,632,76,193,211,439,121,196,56,325,381,339,107,30,115,92,771
226,Ersan İlyasova,PF,24,MIL,60,41,1655,294,597,51,112,243,485,143,183,196,333,529,71,42,44,76,133,782
227,Kyrie Irving,PG,19,CLE,51,51,1558,350,747,73,183,277,564,171,196,44,147,191,275,54,20,160,110,944
228,Royal Ivey,SG,30,OKC,34,0,354,26,73,18,53,8,20,1,8,1,23,24,10,14,0,9,36,71
229,Jarrett Jack,PG,28,NOH,45,39,1530,266,583,39,112,227,471,129,148,23,153,176,285,31,9,106,93,700
230,Reggie Jackson,PG,21,OKC,45,0,501,51,159,13,62,38,97,25,29,14,39,53,71,25,1,36,31,140
231,Stephen Jackson,SF,33,TOT,47,14,1212,159,425,49,170,110,255,94,114,22,141,163,118,54,13,103,99,461
232,Damion James,SF,24,NJN,7,7,170,13,35,0,1,13,34,8,12,7,26,33,3,7,7,12,17,34
233,LeBron James,SF,27,MIA,62,62,2326,621,1169,54,149,567,1020,387,502,94,398,492,387,115,50,213,96,1683
234,Mike James,PG,36,CHI,11,0,120,20,49,6,10,14,39,7,8,2,8,10,29,4,2,14,20,53
235,Antawn Jamison,PF,35,CLE,65,65,2151,421,1044,91,267,330,777,185,271,123,285,408,131,51,43,90,164,1118
236,Al Jefferson,C,27,UTA,61,61,2075,516,1048,1,4,515,1044,137,177,133,452,585,134,47,101,62,155,1170
237,Richard Jefferson,SF,31,TOT,63,44,1748,203,488,113,269,90,219,59,85,26,193,219,88,37,19,50,121,578
238,Jared Jeffries,PF,30,NYK,39,4,729,59,144,3,16,56,128,49,72,69,83,152,26,29,25,29,89,170
239,Charles Jenkins,PG,22,GSW,51,28,893,130,291,3,20,127,271,34,39,8,60,68,170,33,6,60,85,297
240,Brandon Jennings,PG,22,MIL,66,66,2331,469,1121,129,388,340,733,193,239,49,177,226,365,104,22,146,114,1260
241,Jonas Jerebko,PF,24,DET,64,13,1468,212,453,32,106,180,347,100,124,96,212,308,43,41,21,66,162,556
242,Yi Jianlian,PF,24,DAL,30,0,203,31,82,3,10,28,72,14,21,12,37,49,5,7,8,14,23,79
243,Amir Johnson,PF,24,TOR,64,43,1553,196,340,2,5,194,335,58,84,149,259,408,79,33,69,94,209,452
244,Armon Johnson,PG,22,TOT,9,0,124,20,43,1,3,19,40,6,6,1,12,13,11,5,0,6,9,47
245,Carldell Johnson,PG,29,NOH,15,0,119,11,35,4,15,7,20,1,3,1,8,9,22,8,0,7,11,27
246,Chris Johnson,C,26,TOT,27,0,175,20,41,0,0,20,41,15,19,15,25,40,2,6,9,15,33,55
247,Ivan Johnson,PF,27,ATL,56,0,934,141,275,2,6,139,269,72,100,65,161,226,32,43,18,69,116,356
248,JaJuan Johnson,PF,22,BOS,36,0,298,54,121,0,0,54,121,6,9,20,38,58,6,5,14,14,25,114
249,James Johnson,SF,24,TOR,62,40,1561,233,518,19,60,214,458,81,115,74,218,292,122,71,84,101,177,566
250,Joe Johnson,SG,30,ATL,60,60,2127,423,931,125,322,298,609,158,186,53,168,221,232,48,13,116,75,1129
251,Trey Johnson,SG,27,NOH,11,0,61,8,14,0,0,8,14,5,5,3,9,12,4,1,0,5,10,21
252,Wesley Johnson,SF,24,MIN,65,64,1469,158,397,53,169,105,228,24,34,24,153,177,59,35,48,60,115,393
253,Dahntay Jones,SF,31,IND,65,3,1052,115,281,33,77,82,204,83,99,23,94,117,63,23,11,46,119,346
254,Dominique Jones,SG,23,DAL,33,1,268,29,73,1,8,28,65,29,37,9,35,44,42,10,5,28,28,88
255,James Jones,SG,31,MIA,51,10,666,57,150,46,114,11,36,25,30,6,43,49,19,17,9,10,45,185
257,DeAndre Jordan,C,23,LAC,66,66,1798,206,326,0,1,206,325,74,141,202,344,546,17,30,134,74,189,486
258,Jerome Jordan,C,25,NYK,21,0,108,17,33,0,0,17,33,8,10,14,13,27,4,1,6,2,15,42
259,Cory Joseph,PG,20,SAS,29,1,266,22,70,3,15,19,55,11,17,5,20,25,34,7,3,12,16,58
260,Chris Kaman,C,29,NOH,47,33,1372,266,597,0,0,266,597,84,107,89,275,364,101,25,77,129,106,616
261,Enes Kanter,C,19,UTA,66,0,874,117,236,0,1,117,235,70,105,107,171,278,8,18,23,54,87,304
262,Jason Kapono,SG,30,LAL,27,0,269,21,55,8,27,13,28,4,4,2,12,14,11,3,0,6,21,54
263,D.J. Kennedy,SF,22,CLE,2,0,59,5,12,2,4,3,8,0,2,1,6,7,3,2,0,3,7,12
264,Jason Kidd*,PG,38,DAL,48,48,1379,99,273,79,223,20,50,22,28,15,183,198,264,82,10,91,83,299
265,Linas Kleiza,SF,27,TOR,49,3,1057,165,410,62,179,103,231,81,100,42,157,199,46,23,4,64,119,473
266,Brandon Knight,PG,20,DET,66,60,2129,319,769,105,276,214,493,104,137,33,178,211,251,49,10,171,154,847
267,Kyle Korver,SG,30,CHI,65,7,1469,178,412,118,271,60,141,55,66,26,133,159,112,36,15,53,110,529
268,Kosta Koufos,C,22,DEN,48,24,792,115,192,0,0,115,192,33,55,95,163,258,15,24,41,33,96,263
269,Carl Landry,PF,28,NOH,41,8,999,182,362,0,3,182,359,147,184,78,136,214,38,13,12,64,89,511
270,Ty Lawson,PG,24,DEN,61,61,2124,374,767,73,200,301,567,178,216,54,173,227,401,82,6,149,94,999
271,Courtney Lee,SG,26,HOU,58,26,1757,251,580,87,217,164,363,71,86,26,133,159,88,68,22,64,106,660
272,David Lee,PF,28,GSW,57,57,2121,464,922,0,5,464,917,219,280,171,374,545,162,54,22,149,179,1147
273,Malcolm Lee,SG,21,MIN,19,0,243,23,59,2,10,21,49,14,17,9,17,26,31,8,4,17,22,62
274,Kawhi Leonard,SF,20,SAS,64,39,1534,199,404,41,109,158,295,68,88,104,223,327,70,85,24,44,88,507
275,Travis Leslie,SG,21,LAC,10,0,45,5,14,0,0,5,14,4,9,6,3,9,5,2,2,2,4,14
276,Jon Leuer,PF,22,MIL,46,12,555,97,191,3,9,94,182,21,28,45,75,120,25,14,17,18,67,218
277,Rashard Lewis,SF,32,WAS,28,15,729,85,221,16,67,69,154,31,37,34,75,109,27,23,10,32,49,217
278,DeAndre Liggins,SF,23,ORL,17,0,115,12,25,0,4,12,21,9,19,6,9,15,5,6,0,10,6,33
279,Jeremy Lin,PG,23,NYK,35,25,940,171,383,24,75,147,308,146,183,18,89,107,216,55,9,126,78,512
280,Shaun Livingston,SG,26,MIL,58,27,1092,127,271,2,3,125,268,62,79,39,84,123,122,27,20,66,79,318
281,Brook Lopez,C,23,NJN,5,5,136,38,77,0,0,38,77,20,32,8,10,18,6,1,4,6,8,96
282,Robin Lopez,C,23,PHO,64,0,895,124,269,0,0,124,269,100,140,90,119,209,20,18,60,43,128,348
283,Kevin Love,PF,23,MIN,55,55,2145,474,1059,105,282,369,777,379,460,226,508,734,111,47,28,128,152,1432
284,Kyle Lowry,PG,25,HOU,47,38,1510,210,513,79,211,131,302,171,198,37,176,213,310,73,14,130,133,670
285,John Lucas III,PG,29,CHI,49,2,726,143,358,55,140,88,218,28,32,22,54,76,108,19,1,42,42,369
286,Shelvin Mack,PG,21,WAS,64,0,779,88,220,12,42,76,178,42,59,12,80,92,131,28,2,48,50,230
287,Vernon Macklin,C,25,DET,23,0,135,19,35,0,0,19,35,8,14,14,20,34,5,4,4,3,9,46
288,Corey Maggette,SF,32,CHA,32,28,881,139,373,24,66,115,307,178,208,21,104,125,39,23,1,59,83,480
289,Jamaal Magloire,C,33,TOR,34,1,374,17,45,0,0,17,45,7,27,25,88,113,6,4,10,22,66,41
290,Ian Mahinmi,C,25,DAL,61,12,1139,130,238,0,1,130,237,94,147,108,181,289,12,38,31,50,176,354
291,Shawn Marion,SF,33,DAL,63,63,1919,288,646,20,68,268,578,74,93,145,320,465,132,67,36,98,87,670
292,Cartier Martin,SF,27,WAS,17,2,391,59,134,29,75,30,59,11,19,12,46,58,10,11,2,13,35,158
293,Kenyon Martin,PF,34,LAC,42,0,940,97,220,3,13,94,207,20,54,49,132,181,18,44,43,32,103,217
294,Kevin Martin,SG,28,HOU,40,40,1264,222,537,78,225,144,312,160,179,13,93,106,110,28,3,70,70,682
295,Roger Mason,SG,31,WAS,52,0,697,103,258,59,154,44,104,21,27,7,62,69,47,13,5,32,33,286
296,Wesley Matthews,SG,25,POR,66,53,2228,314,763,129,337,185,426,147,171,56,168,224,113,96,15,73,148,904
297,Jason Maxiell,PF,28,DET,65,42,1466,183,383,0,2,183,381,58,106,126,207,333,41,32,50,71,151,424
298,Eric Maynor,PG,24,OKC,9,0,137,14,39,6,17,8,22,4,4,3,10,13,22,5,0,11,13,38
299,O.J. Mayo,SG,24,MEM,66,0,1771,300,736,100,275,200,461,133,172,30,180,210,169,71,23,124,137,833
300,Luc Mbah a Moute,PF,25,MIL,43,22,1009,133,261,1,4,132,257,66,103,77,150,227,29,40,22,39,93,333
301,JaVale McGee,C,24,TOT,61,45,1535,307,552,0,0,307,552,77,167,163,314,477,31,35,132,87,166,691
302,Tracy McGrady*,SF,32,ATL,52,0,837,101,231,15,33,86,198,56,83,23,131,154,110,16,15,53,35,273
303,Dominic McGuire,PF,26,GSW,64,6,1127,94,210,0,4,94,206,39,53,73,173,246,110,44,36,56,104,227
304,Josh McRoberts,PF,24,LAL,50,6,718,56,118,3,7,53,111,23,36,61,110,171,51,15,18,31,74,138
305,Jodie Meeks,SG,24,PHI,66,50,1644,191,467,97,266,94,201,77,85,17,144,161,54,40,3,29,82,556
306,C.J. Miles,SG,24,UTA,56,14,1145,177,465,46,150,131,315,108,136,27,89,116,69,46,18,53,122,508
307,Darko Miličić,C,26,MIN,29,23,472,59,130,0,0,59,130,16,37,35,62,97,17,9,25,32,59,134
308,Andre Miller,SG,35,DEN,66,7,1809,242,552,18,83,224,469,137,169,53,168,221,441,63,9,177,133,639
309,Brad Miller,C,35,MIN,15,1,146,9,27,7,15,2,12,10,12,4,15,19,24,4,2,12,10,35
310,Mike Miller,SG,31,MIA,39,2,752,91,209,53,117,38,92,2,5,22,106,128,42,14,6,30,58,237
311,Patty Mills,PG,23,SAS,16,3,261,63,130,24,56,39,74,15,15,4,24,28,39,10,1,26,14,165
312,Paul Millsap,PF,26,UTA,64,62,2100,426,861,7,31,419,830,202,255,180,383,563,150,118,52,112,222,1061
313,Nazr Mohammed,C,34,OKC,63,1,692,79,169,0,1,79,168,13,23,59,111,170,14,20,37,26,101,171
314,Greg Monroe,C,21,DET,66,66,2082,407,781,0,1,407,780,201,272,239,398,637,152,83,46,161,180,1015
315,Jamario Moon,SF,31,CHA,8,0,123,7,24,2,10,5,14,2,2,2,20,22,5,1,5,8,5,18
316,E'Twaun Moore,PG,22,BOS,38,0,331,43,113,17,45,26,68,7,7,4,29,33,34,11,3,21,33,110
317,Mikki Moore,C,36,GSW,7,0,118,9,20,0,0,9,20,6,7,7,15,22,5,3,3,7,24,24
318,Darius Morris,PG,21,LAL,19,0,169,18,42,4,9,14,33,6,9,2,14,16,21,2,0,19,16,46
319,Marcus Morris,PF,22,HOU,17,0,126,16,54,2,17,14,37,6,8,5,11,16,3,2,2,4,12,40
320,Markieff Morris,PF,22,PHO,63,7,1227,174,436,43,124,131,312,76,106,69,210,279,65,41,42,70,179,467
321,Anthony Morrow,SG,26,NJN,62,18,1636,272,658,106,286,166,372,97,104,31,96,127,61,46,9,70,86,747
322,Timofey Mozgov,C,25,DEN,44,35,687,100,190,0,0,100,190,39,57,53,126,179,22,15,42,53,86,239
323,Byron Mullens,C,22,CHA,65,25,1465,251,591,12,51,239,540,92,112,96,231,327,57,21,52,74,137,606
324,Troy Murphy,PF,31,LAL,59,0,956,77,171,28,67,49,104,6,9,40,151,191,51,15,16,26,98,188
325,Hamady N'Diaye,C,25,WAS,3,0,3,0,1,0,0,0,1,0,0,0,0,0,0,0,0,0,0,0
326,Eduardo Nájera,PF,35,CHA,22,0,270,24,64,8,29,16,35,2,4,11,39,50,12,19,4,7,40,58
327,Steve Nash*,PG,37,PHO,62,62,1961,295,555,55,141,240,414,127,142,26,160,186,664,38,8,229,53,772
328,Gary Neal,SG,27,SAS,56,7,1206,212,486,83,198,129,288,50,64,12,106,118,117,27,2,60,75,557
329,Jameer Nelson,PG,29,ORL,57,57,1706,259,606,87,231,172,375,71,88,29,152,181,325,38,5,135,130,676
330,Joakim Noah,C,26,CHI,64,64,1945,249,490,0,1,249,489,154,206,242,387,629,160,41,92,92,162,652
331,Andrés Nocioni,SF,32,PHI,11,1,56,5,20,1,6,4,14,6,11,1,13,14,1,1,1,5,4,17
332,Steve Novak,PF,28,NYK,54,0,1020,161,337,133,282,28,55,22,26,9,95,104,12,16,9,21,59,477
333,Dirk Nowitzki,PF,33,DAL,62,62,2079,473,1034,78,212,395,822,318,355,46,372,418,136,42,30,117,129,1342
334,Jermaine O'Neal,C,33,BOS,25,24,570,52,120,0,0,52,120,21,31,37,98,135,10,8,43,21,80,125
335,Lamar Odom,SF,32,DAL,50,4,1027,123,349,28,111,95,238,58,98,36,172,208,83,20,18,52,97,332
336,Emeka Okafor,C,29,NOH,27,27,781,114,214,0,0,114,214,38,74,70,143,213,24,16,26,37,73,266
337,Mehmet Okur,C,32,NJN,17,14,454,52,139,23,72,29,67,3,5,22,59,81,30,9,5,25,45,130
338,Daniel Orton,PF,21,ORL,16,2,187,17,30,0,1,17,29,11,25,19,20,39,5,8,9,7,30,45
339,Travis Outlaw,SF,27,SAC,39,5,500,60,175,16,60,44,115,31,46,19,42,61,16,19,21,20,34,167
340,Larry Owens,SF,29,NJN,7,0,75,4,11,2,5,2,6,3,4,2,11,13,4,0,1,2,10,13
341,Zaza Pachulia,C,27,ATL,58,44,1640,169,339,0,0,169,339,117,158,154,303,457,79,55,29,81,172,455
342,Jannero Pargo,PG,32,ATL,50,0,671,105,253,53,138,52,115,19,20,9,64,73,96,20,2,49,64,282
343,Jeremy Pargo,PG,25,MEM,44,5,424,50,150,10,38,40,112,16,27,12,25,37,55,15,0,46,46,126
344,Anthony Parker,SF,36,CLE,51,51,1280,141,326,50,138,91,188,35,56,10,128,138,120,38,7,50,65,367
345,Tony Parker,PG,29,SAS,60,60,1923,427,890,14,61,413,829,227,284,22,149,171,463,57,5,153,75,1095
346,Chandler Parsons,SF,23,HOU,63,57,1804,248,549,60,178,188,371,43,78,90,210,300,134,73,29,81,142,599
347,Patrick Patterson,PF,22,HOU,64,1,1483,225,511,0,3,225,508,40,57,112,174,286,53,27,36,49,113,490
348,Chris Paul,PG,26,LAC,60,60,2181,425,890,79,213,346,677,260,302,42,171,213,543,152,4,124,138,1189
349,Sasha Pavlović,SF,28,BOS,45,7,527,50,128,17,58,33,70,3,8,4,68,72,18,20,15,20,54,120
350,Nikola Peković,C,26,MIN,47,35,1264,256,454,0,0,256,454,139,187,181,165,346,31,29,31,87,98,651
351,Kendrick Perkins,C,27,OKC,65,65,1744,128,262,0,0,128,262,73,112,120,306,426,78,25,73,118,189,329
352,Johan Petro,C,26,NJN,59,10,920,109,260,1,1,108,259,31,37,68,156,224,45,21,23,38,122,250
353,Paul Pierce,SF,34,BOS,61,61,2075,394,890,100,273,294,617,293,344,37,280,317,274,70,26,173,147,1181
354,Mickaël Piétrus,SG,29,BOS,42,6,921,104,270,61,182,43,88,20,31,18,112,130,25,21,10,33,81,289
355,Dexter Pittman,C,23,MIA,35,6,301,44,94,0,0,44,94,18,28,27,44,71,9,8,8,17,73,106
356,Quincy Pondexter,SF,23,MEM,64,8,1002,108,239,22,73,86,166,33,53,55,71,126,27,27,5,30,90,271
357,A.J. Price,PG,25,IND,44,1,568,59,174,26,88,33,86,28,35,13,48,61,86,20,2,32,30,172
358,Ronnie Price,PG,28,PHO,36,8,517,49,130,13,44,36,86,20,25,18,38,56,67,34,3,46,72,131
359,Tayshaun Prince,SF,31,DET,63,63,2087,336,798,37,104,299,694,89,115,72,209,281,153,27,32,74,77,798
360,Joel Przybilla,C,32,POR,27,19,449,22,48,0,0,22,48,11,18,29,109,138,6,4,16,22,66,55
361,Vladimir Radmanović,SF,31,ATL,49,3,755,74,197,50,135,24,62,22,29,34,109,143,54,21,15,35,62,220
362,Anthony Randolph,PF,22,MIN,34,5,517,94,200,0,1,94,199,64,84,42,81,123,19,13,35,40,56,252
363,Zach Randolph,PF,30,MEM,28,8,735,132,285,2,8,130,277,58,88,78,147,225,48,21,4,40,57,324
364,Michael Redd,SG,32,PHO,51,2,770,144,360,42,132,102,228,88,111,14,63,77,33,13,0,37,29,418
365,J.J. Redick,SG,27,ORL,65,22,1765,248,584,112,268,136,316,143,157,18,132,150,164,27,6,68,92,751
366,Ryan Reid,PF,25,OKC,5,0,17,4,5,0,0,4,5,0,0,1,1,2,0,0,0,1,1,8
367,Jason Richardson,SG,31,ORL,54,54,1591,243,596,102,277,141,319,41,69,36,158,194,107,53,22,60,91,629
368,Quentin Richardson,SF,31,ORL,48,3,866,74,197,42,121,32,76,25,30,15,108,123,38,28,6,29,74,215
369,Luke Ridnour,SG,30,MIN,53,53,1750,242,550,49,152,193,398,106,119,19,122,141,252,56,16,96,136,639
370,Nate Robinson,PG,27,GSW,51,9,1192,205,484,66,181,139,303,94,113,15,85,100,231,59,2,75,118,570
371,Rajon Rondo,PG,25,BOS,53,53,1957,256,572,10,42,246,530,108,181,62,195,257,620,95,3,193,99,630
372,Derrick Rose,PG,23,CHI,39,39,1375,302,695,54,173,248,522,194,239,26,105,131,307,35,28,119,52,852
373,Ricky Rubio,PG,21,MIN,41,31,1404,139,389,32,94,107,295,126,157,21,150,171,336,91,8,131,97,436
374,Brandon Rush,SF,26,GSW,65,1,1717,235,469,99,219,136,250,65,82,33,218,251,88,35,58,68,64,634
375,Walker Russell,PG,29,DET,28,0,357,33,95,4,13,29,82,14,22,7,19,26,58,18,1,33,29,84
376,John Salmons,SF,32,SAC,46,32,1250,141,345,33,112,108,233,29,45,20,114,134,93,37,7,45,77,344
377,Samardo Samuels,C,23,CLE,54,0,825,105,231,0,0,105,231,82,117,63,117,180,20,20,20,56,113,292
378,Larry Sanders,PF,23,MIL,52,0,643,84,184,0,2,84,182,18,38,62,98,160,33,32,76,43,133,186
379,Brian Scalabrine,PF,33,CHI,28,0,122,14,30,1,7,13,23,3,6,8,13,21,15,5,6,9,9,32
380,Luis Scola,PF,31,HOU,66,66,2067,436,888,0,3,436,885,153,198,122,306,428,140,35,24,153,214,1025
381,Thabo Sefolosha,SG,27,OKC,42,42,914,67,155,31,71,36,84,38,43,21,107,128,47,37,17,40,78,203
382,Josh Selby,PG,20,MEM,28,0,237,25,72,2,15,23,57,11,14,2,13,15,30,7,0,29,17,63
383,Kevin Séraphin,C,22,WAS,57,21,1176,203,382,0,1,203,381,47,70,103,177,280,33,19,76,66,133,453
384,Ramon Sessions,PG,25,TOT,64,23,1707,242,565,43,97,199,468,194,248,33,181,214,354,44,3,141,100,721
385,Iman Shumpert,PG,21,NYK,59,35,1705,214,534,48,157,166,377,87,109,42,144,186,164,101,8,111,173,563
386,Xavier Silas,SG,24,PHI,2,0,39,4,15,1,6,3,9,2,3,2,2,4,3,0,0,3,5,11
387,Bobby Simmons,SF,31,LAC,28,0,418,28,90,20,60,8,30,4,7,17,38,55,11,15,3,10,41,80
388,Chris Singleton,SF,22,WAS,66,51,1431,116,312,44,127,72,185,30,44,43,190,233,49,70,30,38,176,306
389,James Singleton,PF,30,WAS,12,0,262,41,75,2,9,39,66,14,15,25,56,81,15,9,8,10,27,98
390,Brian Skinner,C,35,MEM,1,0,4,0,1,0,0,0,1,0,0,0,0,0,0,0,0,0,1,0
391,Donald Sloan,PG,24,TOT,33,11,669,79,198,2,25,77,173,23,30,18,49,67,105,13,3,49,37,183
392,Craig Smith,PF,28,POR,47,0,464,59,117,0,1,59,116,38,53,33,77,110,19,16,5,24,55,156
393,Greg Smith,C,21,HOU,8,0,69,7,11,0,0,7,11,0,0,5,15,20,1,2,5,1,17,14
394,Ish Smith,PG,23,TOT,26,1,234,31,81,3,9,28,72,7,10,7,28,35,41,15,2,13,15,72
395,J.R. Smith,SG,26,NYK,35,1,967,165,405,67,193,98,212,39,55,29,107,136,84,54,6,46,87,436
396,Jason Smith,PF,25,NOH,40,29,947,181,348,1,9,180,339,33,47,72,124,196,34,21,41,40,102,396
397,Jerry Smith,PG,24,NJN,5,0,46,3,14,1,6,2,8,0,0,2,5,7,4,5,0,0,5,7
398,Josh Smith,PF,26,ATL,66,66,2329,504,1101,28,109,476,992,203,322,136,496,632,257,93,115,164,172,1239
399,Nolan Smith,PG,23,POR,44,4,541,67,180,13,45,54,135,20,28,17,39,56,62,18,3,42,55,167
400,Marreese Speights,PF,24,MEM,60,54,1345,221,488,0,3,221,485,84,109,133,241,374,48,21,29,74,147,526
401,Tiago Splitter,C,27,SAS,59,2,1121,212,343,0,0,212,343,125,181,93,213,306,65,21,47,87,134,549
402,Jerry Stackhouse,SF,37,ATL,30,0,273,37,100,13,38,24,62,21,23,6,17,23,14,10,3,13,12,108
403,Lance Stephenson,SG,21,IND,42,1,442,47,125,4,30,43,95,8,17,12,41,53,46,21,5,36,30,106
404,DeShawn Stevenson,SF,30,NJN,51,30,960,49,172,41,145,8,27,9,16,7,94,101,41,19,4,19,59,148
405,Greg Stiemsma,C,26,BOS,55,3,766,66,121,0,0,66,121,29,41,48,129,177,28,37,85,33,144,161
406,Julyan Stone,SG,23,DEN,22,2,179,13,31,2,11,11,20,8,11,5,20,25,37,8,6,11,18,36
407,Amar'e Stoudemire,PF,29,NYK,47,47,1543,316,654,5,21,311,633,186,243,106,261,367,52,38,45,112,138,823
408,Rodney Stuckey,SG,25,DET,55,48,1644,256,597,33,104,223,493,267,320,38,104,142,210,44,10,106,124,812
409,DaJuan Summers,SF,24,NOH,15,6,209,28,65,5,16,23,49,7,9,8,15,23,10,7,0,8,31,68
410,Jeff Teague,PG,23,ATL,66,66,2183,320,672,51,149,269,523,140,185,21,138,159,321,106,37,134,145,831
411,Sebastian Telfair,PG,26,PHO,60,1,895,141,342,33,105,108,237,53,67,20,71,91,138,41,12,68,120,368
412,Jason Terry,SG,34,DAL,63,1,2000,357,830,138,365,219,465,98,111,16,133,149,226,73,11,127,69,950
413,Hasheem Thabeet,C,24,TOT,20,3,139,11,21,0,0,11,21,13,20,16,26,42,0,1,10,8,20,35
414,Isaiah Thomas,PG,22,SAC,65,37,1656,256,571,83,219,173,352,154,185,48,120,168,266,53,8,105,121,749
415,Kurt Thomas,C,39,POR,53,3,803,73,157,0,0,73,157,14,20,39,149,188,46,24,31,31,123,160
416,Lance Thomas,PF,23,NOH,42,10,630,57,126,0,1,57,125,52,62,49,77,126,12,10,7,24,78,166
417,Malcolm Thomas,PF,23,SAS,3,0,15,0,3,0,0,0,3,1,2,1,2,3,1,1,1,0,0,1
418,Tyrus Thomas,PF,25,CHA,54,30,1013,120,327,1,3,119,324,63,83,49,151,200,35,36,60,53,144,304
419,Trey Thompkins,C,21,LAC,24,0,119,24,61,4,13,20,48,5,7,4,20,24,3,3,3,6,10,57
420,Jason Thompson,PF,25,SAC,64,47,1657,237,443,0,2,237,441,109,181,166,277,443,79,43,44,68,149,583
421,Klay Thompson,SG,21,GSW,66,29,1608,318,718,111,268,207,450,79,91,24,137,161,133,49,20,103,155,826
422,Mychel Thompson,SG,23,CLE,5,3,95,7,24,4,11,3,13,0,0,0,5,5,7,2,1,5,8,18
423,Tristan Thompson,PF,20,CLE,60,25,1424,194,442,0,2,194,440,106,192,187,202,389,27,27,62,81,134,494
424,Marcus Thornton,SG,24,SAC,51,51,1780,352,803,107,310,245,493,141,163,84,104,188,98,71,12,84,111,952
425,Jamaal Tinsley,PG,33,UTA,37,1,507,57,141,10,37,47,104,13,17,6,39,45,123,17,8,52,47,137
426,Anthony Tolliver,SF,26,MIN,51,0,882,71,182,25,101,46,81,41,55,50,103,153,22,18,19,35,86,208
427,Ronny Turiaf,C,29,TOT,17,5,279,19,33,0,1,19,32,13,22,20,50,70,10,14,17,14,39,51
428,Hedo Türkoğlu,SF,32,ORL,53,53,1653,209,504,91,258,118,246,67,95,24,175,199,233,45,17,142,139,576
429,Evan Turner,SF,23,PHI,65,20,1713,263,590,11,49,252,541,73,108,27,349,376,180,40,20,105,117,610
430,Jeremy Tyler,C,20,GSW,42,23,568,88,209,0,1,88,208,29,52,54,86,140,16,16,20,36,84,205
431,Edwin Ubiles,SF,25,WAS,4,0,52,5,18,1,5,4,13,3,3,2,8,10,1,1,1,1,1,14
432,Ekpe Udoh,C,24,TOT,61,11,1290,127,295,0,2,127,293,86,114,100,154,254,57,40,102,53,174,340
433,Beno Udrih,SG,29,MIL,59,0,1080,146,332,17,59,129,273,39,55,26,76,102,227,37,1,77,69,348
434,Ben Uzoh,PG,23,TOT,18,8,370,35,99,0,1,35,98,11,19,19,48,67,61,17,3,19,31,81
435,Anderson Varejão,C,29,CLE,25,25,785,114,222,0,4,114,218,43,64,109,178,287,43,35,17,45,62,271
436,Greivis Vásquez,SG,25,NOH,66,26,1706,225,523,43,135,182,388,96,117,23,150,173,359,60,8,148,126,589
437,Jan Veselý,PF,21,WAS,57,20,1078,117,218,0,1,117,217,33,62,101,148,249,47,39,32,60,156,267
438,Charlie Villanueva,PF,27,DET,13,0,180,35,91,15,45,20,46,6,7,9,39,48,6,7,5,7,25,91
439,Nikola Vučević,C,21,PHI,51,15,812,131,291,3,8,128,283,18,34,88,158,246,31,20,34,33,111,283
440,Dwyane Wade,SG,30,MIA,49,49,1625,416,837,15,56,401,781,235,297,73,164,237,225,82,63,129,110,1082
441,Von Wafer,SG,26,ORL,33,1,469,71,157,14,39,57,118,38,54,6,39,45,29,10,3,35,26,194
442,Henry Walker,SG,24,NYK,32,8,620,68,171,36,113,32,58,17,20,9,71,80,37,19,7,35,84,189
443,Kemba Walker,PG,21,CHA,66,25,1792,281,767,69,226,212,541,168,213,30,204,234,289,60,20,119,79,799
444,John Wall,PG,21,WAS,66,66,2386,378,894,3,42,375,852,317,402,48,252,300,530,95,57,255,137,1076
445,Ben Wallace,C,37,DET,62,11,980,34,86,1,4,33,82,16,47,81,188,269,43,47,51,34,60,85
446,Gerald Wallace,SF,29,TOT,58,58,2076,287,632,46,150,241,482,180,225,87,299,386,164,85,36,111,145,800
448,Hakim Warrick,PF,29,PHO,35,0,503,74,180,1,10,73,170,76,99,31,61,92,30,8,3,36,35,225
449,Darryl Watkins,C,27,NOH,5,0,98,7,14,0,0,7,14,9,18,8,19,27,3,5,4,8,14,23
450,C.J. Watson,PG,27,CHI,49,25,1159,161,437,68,173,93,264,84,104,21,84,105,200,45,8,97,103,474
451,Earl Watson,PG,32,UTA,50,2,1033,54,160,10,52,44,108,31,46,30,91,121,217,54,22,85,105,149
452,Martell Webster,SF,25,MIN,47,26,1140,115,272,37,109,78,163,57,72,42,126,168,40,31,17,46,86,324
453,David West,PF,31,IND,66,66,1925,349,716,2,9,347,707,142,176,118,315,433,140,52,46,93,160,842
454,Delonte West,PG,28,DAL,44,33,1060,166,360,27,76,139,284,62,70,13,88,101,139,58,11,76,67,421
455,Russell Westbrook,PG,23,OKC,66,66,2331,578,1266,62,196,516,1070,340,413,96,205,301,362,112,21,239,147,1558
456,D.J. White,PF,25,CHA,58,11,1098,174,353,1,1,173,352,43,61,50,159,209,47,17,23,43,94,392
457,Hassan Whiteside,C,22,SAC,18,0,109,12,27,0,0,12,27,5,12,16,23,39,0,3,15,5,12,29
458,Chris Wilcox,C,29,BOS,28,4,481,64,107,0,0,64,107,24,39,38,84,122,12,11,9,30,64,152
459,Damien Wilkins,SF,32,DET,60,2,922,76,193,7,23,69,170,34,54,22,78,100,44,29,13,30,85,193
460,Deron Williams,PG,27,NJN,55,55,1999,391,961,115,342,276,619,257,305,23,160,183,481,67,20,219,121,1154
461,Derrick Williams,PF,20,MIN,66,15,1418,205,498,37,138,168,360,136,195,77,234,311,38,30,31,77,95,583
462,Elliot Williams,SG,22,POR,24,0,149,37,74,8,27,29,47,6,18,7,12,19,6,6,3,5,18,88
463,Jordan Williams,C,21,NJN,43,5,635,77,152,0,0,77,152,43,66,66,90,156,11,21,15,23,61,197
464,Lou Williams,PG,25,PHI,64,0,1682,318,782,83,229,235,553,237,292,30,125,155,221,53,18,71,90,956
465,Marvin Williams,SF,25,ATL,57,37,1500,203,470,58,149,145,321,115,146,76,218,294,71,47,18,39,84,579
466,Mo Williams,SG,29,LAC,52,1,1472,260,611,93,239,167,372,72,80,23,76,99,160,51,7,86,103,685
467,Reggie Williams,SF,25,CHA,33,13,747,106,255,33,107,73,148,29,40,27,66,93,60,20,3,33,34,274
468,Sean Williams,C,25,TOT,11,0,107,14,22,0,0,14,22,12,13,13,12,25,5,4,8,10,18,40
469,Shawne Williams,SF,25,NJN,25,6,514,42,147,21,87,21,60,8,11,20,48,68,16,10,11,13,44,113
470,Shelden Williams,C,28,NJN,58,35,1276,96,201,0,0,96,201,76,104,141,209,350,35,47,39,66,149,268
471,Terrence Williams,SG,24,TOT,30,0,550,85,198,16,46,69,152,27,46,13,89,102,65,20,7,43,35,213
472,Metta World Peace,SF,32,LAL,64,45,1720,183,465,56,189,127,276,71,115,71,147,218,140,69,27,69,137,493
473,Brandan Wright,C,24,DAL,49,0,791,144,233,0,1,144,232,52,82,62,112,174,13,22,63,21,61,340
474,Chris Wright,SF,23,GSW,24,1,186,23,45,0,0,23,45,24,31,19,26,45,4,7,13,8,22,70
475,Dorell Wright,SF,26,GSW,61,61,1650,222,526,105,292,117,234,80,98,60,218,278,94,58,26,51,97,629
476,Nick Young,SG,26,TOT,62,35,1729,316,784,103,282,213,502,144,169,31,102,133,56,44,17,83,141,879
477,Sam Young,SF,26,TOT,35,2,375,45,127,5,17,40,110,19,26,20,42,62,15,17,6,16,23,114
478,Thaddeus Young,PF,23,PHI,63,1,1755,348,687,1,4,347,683,111,144,137,188,325,74,64,41,55,127,808
1,Quincy Acy,PF,22,TOR,29,0,342,42,75,1,2,41,73,31,38,30,47,77,11,13,15,17,53,116
2,Jeff Adrien,PF,26,CHA,52,5,713,72,168,0,2,72,166,65,100,68,128,196,36,18,27,32,80,209
3,Arron Afflalo,SF,27,ORL,64,64,2307,397,905,72,240,325,665,191,223,29,210,239,206,40,11,138,137,1057
4,Josh Akognon,PG,26,DAL,3,0,9,2,4,1,2,1,2,0,0,0,1,1,1,0,0,0,3,5
5,Cole Aldrich,C,24,TOT,45,0,388,44,80,0,0,44,80,12,20,30,90,120,9,5,23,23,60,100
6,LaMarcus Aldridge,PF,27,POR,74,74,2790,638,1318,2,14,636,1304,282,348,175,495,670,192,62,91,143,187,1560
7,Lavoy Allen,C,23,PHI,79,37,1669,206,454,0,1,206,453,43,60,159,236,395,73,24,55,55,180,455
8,Ray Allen*,SG,37,MIA,79,0,2035,292,651,139,332,153,319,140,158,40,177,217,135,67,15,103,129,863
9,Tony Allen,SG,31,MEM,79,79,2109,284,638,3,24,281,614,134,187,121,242,363,98,119,44,94,211,705
10,Al-Farouq Aminu,SF,22,NOH,76,71,2066,225,474,4,19,221,455,101,137,139,446,585,103,92,51,116,153,555
11,Lou Amundson,PF,30,TOT,39,0,372,32,81,0,0,32,81,12,36,48,58,106,11,16,12,19,53,76
12,Chris Andersen,C,34,MIA,42,0,624,71,123,2,3,69,120,63,93,57,115,172,17,16,44,24,89,207
13,Alan Anderson,SF,30,TOR,65,2,1495,236,616,95,285,141,331,126,147,34,114,148,103,48,7,80,131,693
15,Ryan Anderson,PF,24,NOH,81,22,2503,472,1115,213,557,259,558,152,180,191,328,519,97,42,31,97,179,1309
16,Carmelo Anthony,PF,28,NYK,67,67,2482,669,1489,157,414,512,1075,425,512,134,326,460,171,52,32,175,205,1920
17,Joel Anthony,C,30,MIA,62,3,566,35,68,0,0,35,68,17,28,45,70,115,13,13,42,22,49,87
18,Trevor Ariza,SF,27,WAS,56,15,1471,188,451,76,209,112,242,78,95,44,222,266,113,72,20,84,72,530
19,Darrell Arthur,PF,24,MEM,59,3,970,162,359,5,18,157,341,33,46,68,101,169,33,24,33,43,126,362
20,Ömer Aşık,C,26,HOU,82,82,2464,332,614,0,1,332,613,168,299,275,681,956,75,46,87,173,223,832
21,D.J. Augustin,PG,25,IND,76,5,1226,103,294,67,190,36,104,83,99,20,71,91,170,34,3,68,64,356
22,Gustavo Ayón,C,27,TOT,55,3,734,92,167,0,0,92,167,20,50,60,139,199,71,22,17,47,107,204
23,Jeff Ayres,PF,25,IND,37,0,369,61,126,2,4,59,122,21,23,29,75,104,15,6,12,23,44,145
24,Luke Babbitt,PF,23,POR,62,0,730,86,234,62,178,24,56,10,13,15,122,137,29,14,5,22,82,244
25,Leandro Barbosa,PG,30,BOS,41,2,513,83,193,18,47,65,146,31,41,8,38,46,58,17,6,21,51,215
26,J.J. Barea,PG,28,MIN,74,2,1713,316,758,97,280,219,478,105,134,34,173,207,294,32,0,145,131,834
27,Andrea Bargnani,PF,27,TOR,35,25,1003,170,426,38,123,132,303,65,77,26,102,128,38,21,23,54,64,443
28,Harrison Barnes,SF,20,GSW,81,81,2058,276,628,52,145,224,483,144,190,53,280,333,98,52,14,101,140,748
29,Matt Barnes,SF,32,LAC,80,4,2058,312,675,111,325,201,350,87,117,111,255,366,123,82,63,90,233,822
30,Earl Barron,C,31,TOT,12,2,159,18,51,0,0,18,51,3,7,22,39,61,5,5,6,11,24,39
31,Will Barton,SG,22,POR,73,5,894,118,309,9,65,109,244,50,65,36,109,145,58,34,9,60,56,295
32,Brandon Bass,PF,27,BOS,81,69,2239,286,589,0,2,286,587,129,150,129,296,425,84,44,64,80,188,701
33,Shane Battier,SF,34,MIA,72,20,1786,152,362,136,316,16,46,32,38,37,128,165,72,41,55,34,149,472
34,Nicolas Batum,SF,24,POR,73,73,2807,352,833,165,444,187,389,178,210,97,315,412,360,91,83,190,139,1047
35,Jerryd Bayless,PG,24,MEM,80,4,1765,260,621,71,201,189,420,102,122,22,154,176,264,59,17,120,168,693
36,Aron Baynes,C,26,SAS,16,0,141,18,36,0,1,18,35,7,12,12,20,32,5,1,6,11,23,43
37,Kent Bazemore,SG,23,GSW,61,0,267,43,116,10,34,33,82,27,44,5,17,22,22,17,4,18,27,123
38,Bradley Beal,SG,19,WAS,56,46,1745,282,687,91,236,191,451,125,159,43,168,211,137,50,29,90,113,780
39,Michael Beasley,SF,24,PHO,75,20,1554,310,766,45,144,265,622,94,126,52,230,282,111,31,34,144,107,759
40,Rodrigue Beaubois,PG,24,DAL,45,0,549,65,176,21,72,44,104,30,38,9,48,57,84,19,4,33,54,181
41,Marco Belinelli,SG,26,CHI,73,27,1882,241,610,79,221,162,389,141,168,13,127,140,148,44,6,82,140,702
42,Patrick Beverley,PG,24,HOU,41,0,713,79,189,36,96,43,93,34,41,45,64,109,117,37,21,44,83,228
43,Andris Biedriņš,C,26,GSW,53,9,495,10,21,0,0,10,21,4,13,34,119,153,14,15,42,14,101,24
44,Chauncey Billups,SG,36,LAC,22,22,418,53,132,33,90,20,42,45,48,2,30,32,49,12,1,26,25,184
45,Bismack Biyombo,C,20,CHA,80,65,2186,156,346,0,0,156,346,74,142,194,388,582,35,28,143,82,195,386
46,DeJuan Blair,PF,23,SAS,61,16,851,142,271,0,1,142,270,44,70,66,164,230,45,37,10,49,112,328
47,Steve Blake,PG,32,LAL,45,13,1175,114,270,72,171,42,99,27,35,21,111,132,173,34,6,62,83,327
48,Andray Blatche,C,26,BRK,82,8,1555,346,676,3,22,343,654,148,216,161,256,417,85,86,54,123,163,843
49,Eric Bledsoe,PG,23,LAC,76,12,1553,253,568,31,78,222,490,106,134,78,147,225,233,109,55,137,112,643
50,Keith Bogans,SG,32,BRK,74,23,1408,108,284,84,245,24,39,11,17,16,104,120,76,28,4,49,108,311
51,Andrew Bogut,C,28,GSW,32,32,786,83,184,1,1,82,183,19,38,68,177,245,67,20,55,35,85,186
52,Matt Bonner,PF,32,SAS,68,4,909,112,230,53,120,59,110,11,15,25,104,129,36,17,19,16,86,288
53,Trevor Booker,PF,25,WAS,48,14,887,108,220,0,5,108,215,40,72,98,141,239,40,32,16,31,95,256
54,Carlos Boozer,PF,31,CHI,79,79,2546,544,1140,0,2,544,1138,193,264,175,596,771,179,66,28,176,239,1281
55,Chris Bosh,C,28,MIA,74,74,2454,485,907,21,74,464,833,241,302,131,370,501,123,66,101,128,168,1232
56,Avery Bradley,PG,22,BOS,50,50,1435,192,478,40,126,152,352,37,49,30,81,111,104,64,19,72,129,461
57,Elton Brand,C,33,DAL,72,18,1527,226,478,0,1,226,477,66,93,130,300,430,70,50,90,57,192,518
58,Corey Brewer,SF,26,DEN,82,2,2003,375,883,91,307,284,576,149,216,55,180,235,124,118,23,102,154,990
59,Ronnie Brewer,SF,27,TOT,60,34,853,70,198,23,76,47,122,16,39,42,98,140,50,43,6,18,33,179
60,Aaron Brooks,PG,28,TOT,53,20,997,143,316,50,134,93,182,40,52,13,67,80,114,30,10,67,94,376
61,MarShon Brooks,SG,24,BRK,73,2,912,155,335,15,55,140,280,69,94,32,72,104,76,34,16,69,93,394
62,Kwame Brown,C,30,PHI,22,11,269,17,37,0,0,17,37,7,19,23,51,74,9,6,10,8,37,41
63,Shannon Brown,SG,27,PHO,59,22,1402,240,571,39,141,201,430,98,125,44,105,149,108,59,15,74,92,617
64,Kobe Bryant,SG,34,LAL,78,78,3013,738,1595,132,407,606,1188,525,626,66,367,433,469,106,25,287,173,2133
65,Chase Budinger,SF,24,MIN,23,1,508,79,191,26,81,53,110,32,42,15,56,71,25,14,7,23,29,216
66,Alec Burks,SG,21,UTA,64,0,1137,163,388,33,92,130,296,92,129,37,108,145,92,35,13,74,114,451
67,Caron Butler,SF,32,LAC,78,78,1879,305,720,128,330,177,390,75,90,41,182,223,78,51,11,72,139,813
68,Jimmy Butler,SF,23,CHI,82,20,2134,239,512,40,105,199,407,187,233,136,192,328,115,78,31,62,97,705
69,Will Bynum,PG,30,DET,65,0,1219,253,540,24,76,229,464,106,131,28,69,97,231,45,5,125,128,636
70,José Calderón,PG,31,TOT,73,58,2160,312,635,130,282,182,353,72,80,20,156,176,518,58,8,126,99,826
71,Marcus Camby,PF,38,NYK,24,4,250,17,53,0,0,17,53,8,19,24,56,80,14,7,14,15,28,42
72,DeMarre Carroll,SF,26,UTA,66,12,1111,149,324,20,70,129,254,75,98,87,101,188,61,58,24,34,119,393
73,Matt Carroll,SG,32,CHA,1,0,6,0,0,0,0,0,0,0,0,0,0,0,1,0,0,0,1,0
74,Vince Carter,SF,36,DAL,81,3,2093,372,855,162,399,210,456,182,223,58,276,334,194,74,44,106,226,1088
75,Omri Casspi,SF,24,CLE,43,1,503,63,160,25,76,38,84,22,41,20,94,114,28,25,12,22,45,173
76,Mario Chalmers,PG,26,MIA,77,77,2068,227,529,123,301,104,228,89,112,19,152,171,273,118,12,119,196,666
77,Tyson Chandler,C,30,NYK,66,66,2164,255,400,0,0,255,400,179,258,269,434,703,62,42,75,87,188,689
78,Wilson Chandler,PF,25,DEN,43,8,1079,210,455,52,126,158,329,88,111,45,173,218,58,45,12,60,119,560
79,Josh Childress,SF,29,BRK,14,0,100,6,21,1,3,5,18,1,2,6,9,15,5,2,2,0,3,14
80,Earl Clark,PF,25,LAL,59,36,1363,170,386,35,104,135,282,53,76,82,243,325,65,36,44,62,102,428
81,Victor Claver,SF,24,POR,49,16,812,74,189,25,87,49,102,14,30,31,88,119,43,26,12,43,75,187
82,Norris Cole,PG,24,MIA,80,4,1590,179,425,35,98,144,327,52,80,18,112,130,164,57,7,104,155,445
83,Jason Collins,C,34,TOT,38,9,384,9,29,0,0,9,29,23,32,22,38,60,8,12,10,18,85,41
84,Darren Collison,PG,25,DAL,81,47,2372,341,724,48,136,293,588,242,275,31,188,219,415,100,8,173,139,972
85,Nick Collison,C,32,OKC,81,2,1583,176,296,0,4,176,292,60,78,123,210,333,121,51,30,69,197,412
86,Mike Conley,PG,25,MEM,80,80,2757,414,940,106,293,308,647,234,282,43,182,225,487,174,24,189,171,1168
87,Will Conroy,PG,30,MIN,4,0,20,0,9,0,3,0,6,1,2,1,0,1,0,0,0,0,1,1
88,Daequan Cook,SG,25,TOT,49,1,441,51,167,26,91,25,76,9,12,7,54,61,19,8,7,15,26,137
89,Chris Copeland,PF,28,NYK,56,13,862,182,380,59,140,123,240,63,83,34,85,119,27,16,12,50,104,486
90,DeMarcus Cousins,C,22,SAC,75,74,2289,482,1036,4,22,478,1014,312,423,222,524,746,199,108,55,225,269,1280
91,Jamal Crawford,SG,32,LAC,76,0,2230,445,1016,149,396,296,620,216,248,22,106,128,193,79,13,146,71,1255
92,Jordan Crawford,SG,24,TOT,70,14,1709,301,725,83,246,218,479,129,159,44,165,209,225,39,7,141,106,814
93,Jae Crowder,SF,22,DAL,78,16,1353,141,367,63,192,78,175,47,73,35,152,187,94,63,17,49,128,392
94,Dante Cunningham,PF,25,MIN,80,9,2010,314,671,0,6,314,665,67,103,142,266,408,67,84,38,56,153,695
95,Jared Cunningham,SG,21,DAL,8,0,26,6,14,2,3,4,11,2,2,1,2,3,1,1,0,2,3,16
96,Eddy Curry,C,30,DAL,2,0,25,4,8,0,0,4,8,1,4,2,2,4,0,0,0,3,7,9
97,Stephen Curry,PG,24,GSW,78,78,2983,626,1388,272,600,354,788,262,291,59,255,314,539,126,12,240,198,1786
98,Samuel Dalembert,C,31,MIL,47,23,765,137,253,1,1,136,252,38,55,105,171,276,21,17,53,51,90,313
99,Marquis Daniels,SF,32,MIL,59,33,1085,132,351,20,72,112,279,40,54,48,102,150,65,51,10,45,77,324
100,Anthony Davis,PF,19,NOH,64,60,1846,349,676,0,6,349,670,169,225,165,357,522,63,75,112,89,158,867
102,Glen Davis,PF,27,ORL,34,33,1064,214,478,0,2,214,476,84,117,55,191,246,70,32,21,64,88,512
103,Austin Daye,SF,24,TOT,55,0,676,90,208,41,98,49,110,26,34,16,107,123,42,14,22,29,82,247
104,Nando De Colo,SG,25,SAS,72,6,920,105,241,31,82,74,159,35,44,23,115,138,138,41,6,81,87,276
105,Carlos Delfino,SF,30,HOU,67,5,1689,251,620,158,421,93,199,48,56,18,202,220,135,68,9,72,114,708
106,Luol Deng,SF,27,CHI,75,75,2903,466,1093,75,233,391,860,230,282,162,314,476,222,81,32,144,105,1237
107,Justin Dentmon,PG,27,DAL,2,0,4,0,2,0,0,0,2,0,0,0,0,0,0,0,0,0,0,0
108,DeMar DeRozan,SG,23,TOR,82,82,3013,548,1231,34,120,514,1111,355,427,48,272,320,204,76,24,151,173,1485
109,Boris Diaw,PF,30,SAS,75,20,1709,179,332,30,78,149,254,47,65,66,188,254,180,52,27,84,143,435
110,DeSagana Diop,C,31,CHA,22,1,226,8,27,0,1,8,26,0,1,10,41,51,13,5,16,8,19,16
111,Keyon Dooling,PG,32,MEM,7,0,82,10,21,5,12,5,9,6,7,0,1,1,8,1,0,5,8,31
112,Toney Douglas,PG,26,TOT,71,0,1289,188,466,82,216,106,250,76,84,34,104,138,151,71,3,81,145,534
113,Chris Douglas-Roberts,SG,26,DAL,6,0,63,5,14,0,4,5,10,7,10,0,5,5,4,2,0,1,4,17
114,Goran Dragić,PG,26,PHO,77,77,2581,401,906,88,276,313,630,244,326,60,178,238,569,124,26,212,214,1134
115,Andre Drummond,C,19,DET,60,10,1243,208,342,1,2,207,340,59,159,169,288,457,30,59,95,57,144,476
116,Jared Dudley,SF,27,PHO,79,50,2170,313,669,106,271,207,398,129,162,79,166,245,203,75,8,101,128,861
117,Chris Duhon,PG,30,LAL,46,9,820,47,123,33,91,14,32,6,13,11,57,68,133,20,1,40,56,133
118,Tim Duncan,C,36,SAS,69,69,2078,490,976,2,7,488,969,245,300,124,562,686,184,50,183,147,117,1227
119,Mike Dunleavy,SF,32,MIL,75,3,1943,276,624,128,299,148,325,105,128,31,260,291,145,39,35,90,135,785
120,Kevin Durant,SF,24,OKC,81,81,3119,731,1433,139,334,592,1099,679,750,46,594,640,374,116,105,280,143,2280
121,Devin Ebanks,SF,23,LAL,19,3,197,24,73,6,22,18,51,11,14,10,31,41,10,3,1,11,23,65
122,Wayne Ellington,SG,25,TOT,78,21,1661,226,529,94,240,132,289,68,75,25,141,166,104,45,3,57,81,614
123,Monta Ellis,SG,27,MIL,82,82,3076,597,1436,94,328,503,1108,289,374,45,271,316,496,169,36,254,164,1577
124,Kim English,SG,24,DET,41,0,407,42,112,14,50,28,62,21,29,8,29,37,26,16,3,19,46,119
125,Jeremy Evans,PF,25,UTA,37,0,215,27,44,0,1,27,43,21,33,26,32,58,11,8,13,8,30,75
126,Reggie Evans,PF,32,BRK,80,56,1967,125,261,0,0,125,261,113,222,260,628,888,43,74,13,111,199,363
127,Tyreke Evans,SG,23,SAC,65,61,2016,366,765,45,133,321,632,210,271,56,231,287,229,90,27,128,133,987
128,Festus Ezeli,C,23,GSW,78,41,1120,74,169,0,0,74,169,43,81,141,172,313,22,23,74,63,157,191
129,Kenneth Faried,PF,23,DEN,80,80,2248,380,689,0,0,380,689,163,266,260,474,734,77,81,83,113,234,923
130,Derrick Favors,PF,21,UTA,77,8,1787,274,568,0,5,274,563,179,260,184,362,546,75,67,130,129,247,727
131,Raymond Felton,PG,28,NYK,68,68,2313,377,882,93,258,284,624,101,128,51,143,194,372,94,14,155,130,948
132,Landry Fields,SF,24,TOR,51,22,1037,102,223,2,14,100,209,34,53,59,149,208,60,32,8,42,63,240
134,Evan Fournier,SG,20,DEN,38,4,428,75,152,22,54,53,98,30,39,6,29,35,44,19,1,32,65,202
135,Randy Foye,SG,29,UTA,82,72,2249,293,738,178,434,115,304,118,144,17,110,127,167,66,27,92,190,882
136,Jimmer Fredette,SG,23,SAC,69,0,967,172,409,65,156,107,253,85,99,19,52,71,92,31,3,68,64,494
137,Joel Freeland,PF,25,POR,51,1,477,58,142,0,0,58,142,18,27,40,79,119,13,13,11,19,67,134
138,Danilo Gallinari,SF,24,DEN,71,71,2309,364,871,135,362,229,509,286,348,65,302,367,176,64,36,111,130,1149
140,Kevin Garnett,C,36,BOS,68,68,2022,422,850,2,16,420,834,158,201,75,455,530,159,78,62,110,154,1004
141,Diante Garrett,PG,24,PHO,19,0,149,16,49,3,15,13,34,5,10,5,10,15,31,10,0,16,5,40
142,Marc Gasol,C,28,MEM,80,80,2796,429,869,1,14,428,855,268,316,184,438,622,318,80,139,157,255,1127
143,Pau Gasol,PF,32,LAL,49,42,1655,270,579,8,28,262,551,125,178,111,310,421,200,24,61,104,93,673
144,Rudy Gay,SF,26,TOT,75,74,2687,521,1253,84,260,437,993,240,295,99,362,461,202,113,53,198,182,1366
145,Alonzo Gee,SF,25,CLE,82,82,2541,305,744,69,219,236,525,163,205,75,245,320,133,107,29,132,199,842
146,Mickaël Gelabale,SF,29,MIN,36,13,644,72,139,16,52,56,87,21,24,32,67,99,26,16,4,16,47,181
147,Paul George,SF,22,IND,79,79,2972,493,1176,170,469,323,707,221,274,88,515,603,327,143,51,233,227,1377
148,Daniel Gibson,PG,26,CLE,46,3,919,84,247,56,163,28,84,26,37,5,55,60,82,30,4,31,89,250
149,Taj Gibson,PF,27,CHI,65,5,1459,214,441,0,4,214,437,89,131,125,220,345,61,27,90,76,166,517
150,Manu Ginóbili,SG,35,SAS,60,0,1393,229,539,83,235,146,304,164,206,30,171,201,274,80,13,132,114,705
151,Drew Gooden,C,31,MIL,16,0,151,20,61,1,5,19,56,11,16,13,18,31,6,5,6,9,21,52
152,Ben Gordon,SG,29,CHA,75,0,1560,310,760,113,292,197,468,107,127,18,112,130,141,35,16,136,134,840
153,Eric Gordon,SG,24,NOH,42,40,1264,235,584,56,173,179,411,187,222,10,67,77,137,45,8,117,75,713
154,Marcin Gortat,C,28,PHO,61,61,1876,295,566,0,3,295,563,90,138,128,388,516,75,40,98,99,127,680
155,Andrew Goudelock,SG,24,LAL,1,0,6,0,2,0,0,0,2,0,0,1,0,1,0,0,0,0,0,0
156,Danny Granger,SF,29,IND,5,0,74,10,35,2,10,8,25,5,8,3,6,9,3,2,1,4,6,27
157,Aaron Gray,C,28,TOR,42,16,513,48,90,0,0,48,90,23,44,48,85,133,33,7,5,36,85,119
158,Danny Green,SG,25,SAS,80,80,2201,297,663,177,413,120,250,67,79,36,208,244,141,92,54,94,124,838
159,Draymond Green,SF,22,GSW,79,1,1061,84,257,14,67,70,190,45,55,58,202,260,53,42,25,51,159,227
160,Gerald Green,SF,27,IND,60,7,1080,155,424,59,188,96,236,52,65,31,110,141,50,19,23,53,64,421
161,Jeff Green,PF,26,BOS,81,17,2252,376,806,70,182,306,624,214,265,55,263,318,128,56,68,132,175,1036
162,Willie Green,SG,31,LAC,72,60,1188,178,386,71,166,107,220,23,32,17,80,97,55,29,12,31,96,450
163,Blake Griffin,PF,23,LAC,80,80,2598,577,1072,5,28,572,1044,281,426,186,476,662,299,97,50,185,231,1440
164,Hamed Haddadi,C,27,TOT,30,0,322,35,82,0,0,35,82,14,27,43,68,111,12,6,27,31,60,84
165,Jordan Hamilton,SF,22,DEN,40,1,397,84,201,27,73,57,128,13,26,32,63,95,23,15,8,19,24,208
166,Richard Hamilton,SG,34,CHI,50,45,1088,204,475,16,52,188,423,66,77,16,67,83,119,24,5,84,93,490
167,Ben Hansbrough,PG,25,IND,28,0,200,15,45,6,23,9,22,21,27,2,16,18,21,7,2,18,23,57
168,Tyler Hansbrough,PF,27,IND,81,8,1366,176,407,0,3,176,404,216,300,161,212,373,36,29,18,78,152,568
169,James Harden,SG,23,HOU,78,78,2985,585,1337,179,486,406,851,674,792,62,317,379,455,142,38,295,178,2023
170,Maurice Harkless,SF,19,ORL,76,59,1974,260,564,32,117,228,447,73,128,122,213,335,50,88,62,69,144,625
171,Josh Harrellson,C,23,MIA,6,0,31,4,9,1,5,3,4,1,2,3,4,7,0,1,1,3,4,10
172,Al Harrington,C,32,ORL,10,0,119,20,57,8,30,12,27,3,4,6,21,27,10,4,1,7,18,51
173,Devin Harris,SG,29,ATL,58,34,1421,194,443,77,230,117,213,112,154,6,110,116,197,64,13,88,103,577
174,Terrel Harris,SG,25,TOT,20,0,137,4,27,0,8,4,19,7,10,4,22,26,9,2,3,17,17,15
176,Udonis Haslem,PF,32,MIA,75,59,1414,129,251,0,0,129,251,32,45,97,307,404,38,30,15,45,173,290
177,Spencer Hawes,C,24,PHI,82,40,2233,376,811,31,87,345,724,122,157,173,417,590,183,24,113,131,233,905
178,Chuck Hayes,C,29,SAC,74,1,1209,84,190,0,1,84,189,30,48,113,186,299,112,31,18,44,114,198
179,Gordon Hayward,SF,22,UTA,72,27,2104,336,773,102,246,234,527,243,294,51,174,225,213,58,38,120,125,1017
180,Lazar Hayward,SF,26,MIN,4,0,31,2,10,0,4,2,6,6,6,0,4,4,3,2,0,0,3,10
181,Brendan Haywood,C,33,CHA,61,17,1162,93,216,0,1,93,215,30,66,125,165,290,29,16,49,50,125,216
182,Gerald Henderson,SG,25,CHA,68,58,2133,382,855,33,100,349,755,258,313,55,195,250,177,68,34,108,149,1055
183,Xavier Henry,SF,21,NOH,50,2,625,66,161,4,11,62,150,58,92,21,69,90,13,16,5,31,72,194
184,John Henson,PF,22,MIL,63,9,827,162,336,0,3,162,333,56,105,116,181,297,31,19,42,47,83,380
185,Roy Hibbert,C,26,IND,79,79,2269,385,859,1,4,384,855,166,224,296,360,656,113,39,206,162,279,937
186,J.J. Hickson,C,24,POR,80,80,2323,418,744,0,2,418,742,182,268,266,562,828,88,48,51,145,160,1018
187,Cory Higgins,SG,23,CHA,6,0,32,6,19,1,5,5,14,1,2,1,2,3,5,3,0,0,5,14
188,Nenê Hilário,PF,30,WAS,61,49,1659,285,594,0,1,285,593,196,269,101,306,407,177,55,37,139,171,766
189,George Hill,PG,26,IND,76,76,2620,386,871,130,353,256,518,174,213,47,237,284,355,81,26,116,134,1076
190,Grant Hill*,SF,40,LAC,29,0,437,38,98,3,11,35,87,14,24,6,43,49,26,11,7,25,39,93
191,Jordan Hill,PF,25,LAL,29,1,458,77,155,0,2,77,153,40,61,82,84,166,13,8,19,26,55,194
192,Kirk Hinrich,PG,32,CHI,60,60,1764,159,422,71,182,88,240,70,98,16,142,158,314,63,25,99,192,459
193,Jrue Holiday,PG,22,PHI,78,78,2926,555,1288,91,247,464,1041,182,242,89,240,329,625,123,32,292,170,1383
194,Justin Holiday,SG,23,PHI,9,0,142,16,48,4,16,12,32,6,8,0,14,14,15,3,6,9,7,42
195,Ryan Hollins,C,28,LAC,60,0,663,70,114,0,0,70,114,66,88,50,89,139,11,6,34,44,133,206
196,Tyler Honeycutt,SF,22,SAC,9,0,32,3,11,0,2,3,9,2,2,3,7,10,2,0,1,5,2,8
197,Al Horford,C,26,ATL,74,74,2756,576,1060,3,6,573,1054,134,208,195,562,757,240,78,78,147,163,1289
198,Dwight Howard,C,27,LAL,76,76,2722,470,813,1,6,469,807,355,721,251,694,945,108,84,186,225,291,1296
199,Josh Howard,SF,32,MIN,11,4,207,31,77,5,16,26,61,7,12,9,27,36,4,10,3,10,18,74
200,Juwan Howard,PF,39,MIA,7,2,51,10,19,0,0,10,19,1,1,0,8,8,6,0,0,4,9,21
201,Kris Humphries,PF,27,BRK,65,21,1191,139,310,0,2,139,308,97,123,126,239,365,32,16,33,57,127,375
202,Serge Ibaka,PF,23,OKC,80,80,2486,446,778,20,57,426,721,143,191,222,395,617,43,28,242,125,213,1055
203,Andre Iguodala,SG,29,DEN,80,80,2779,396,879,91,287,305,592,155,270,82,341,423,433,139,52,206,127,1038
204,Ersan İlyasova,PF,25,MIL,73,54,2012,371,803,95,214,276,589,125,157,154,366,520,117,68,36,75,185,962
205,Kyrie Irving,PG,20,CLE,59,59,2048,484,1070,109,279,375,791,248,290,34,182,216,350,89,21,191,146,1325
206,Royal Ivey,SG,31,PHI,53,5,698,62,144,37,88,25,56,9,16,16,41,57,32,23,3,20,73,170
207,Jarrett Jack,SG,29,GSW,79,4,2349,387,857,82,203,305,654,167,198,21,222,243,439,60,11,157,134,1023
208,Reggie Jackson,PG,22,OKC,70,0,993,149,325,24,104,125,221,52,62,21,145,166,122,29,13,53,84,374
209,Stephen Jackson,SF,34,SAS,55,6,1075,123,330,46,170,77,160,49,70,22,133,155,80,37,14,77,89,341
210,Bernard James,C,27,DAL,46,11,457,53,103,0,2,53,101,25,41,52,79,131,6,12,38,18,64,131
211,Damion James,SF,25,BRK,2,0,0,0,0,0,0,0,0,0,0,0,1,1,0,0,0,0,0,0
212,LeBron James,PF,28,MIA,76,76,2877,765,1354,103,254,662,1100,403,535,97,513,610,551,129,67,226,110,2036
213,Mike James,PG,37,DAL,45,23,862,101,271,48,125,53,146,23,29,9,63,72,139,26,3,55,95,273
214,Antawn Jamison,PF,36,LAL,76,6,1636,267,575,84,233,183,342,94,136,109,253,362,50,30,22,53,124,712
215,Al Jefferson,C,28,UTA,78,78,2578,611,1236,2,17,609,1219,167,217,156,564,720,164,80,89,105,170,1391
216,Richard Jefferson,SF,32,GSW,56,1,568,62,136,14,45,48,91,38,53,5,79,84,31,14,7,23,45,176
217,Jared Jeffries,PF,31,POR,38,0,350,16,54,0,2,16,52,12,23,26,34,60,14,6,6,17,58,44
219,John Jenkins,SG,21,ATL,61,2,902,131,294,53,138,78,156,59,70,17,77,94,56,12,10,40,37,374
220,Brandon Jennings,PG,23,MIL,80,80,2897,497,1247,173,461,324,786,230,281,59,187,246,521,125,10,203,155,1397
221,Jonas Jerebko,PF,25,DET,49,2,892,142,316,25,83,117,233,68,88,68,117,185,43,38,8,42,90,377
222,Amir Johnson,PF,25,TOR,81,38,2325,336,606,5,13,331,593,136,187,227,384,611,122,81,110,117,301,813
223,Chris Johnson,C,27,MIN,30,0,284,48,75,0,0,48,75,21,34,20,40,60,8,7,28,13,49,117
225,Ivan Johnson,PF,28,ATL,69,5,1035,185,356,1,13,184,343,81,131,76,190,266,46,56,14,71,131,452
226,James Johnson,SF,25,SAC,54,11,878,117,283,2,21,115,262,40,67,49,96,145,58,41,50,68,99,276
227,Joe Johnson,SG,31,BRK,72,72,2642,445,1052,148,395,297,657,132,161,53,165,218,253,49,14,123,99,1170
228,Orlando Johnson,SG,23,IND,51,0,619,72,180,36,94,36,86,23,32,20,90,110,47,11,9,29,51,203
229,Wesley Johnson,SF,25,PHO,50,21,953,161,396,50,155,111,241,27,35,21,102,123,34,22,18,48,56,399
230,Darius Johnson-Odom,SG,23,LAL,4,0,6,0,4,0,1,0,3,0,0,1,3,4,1,0,0,0,0,0
231,Dahntay Jones,SF,32,TOT,78,19,1016,82,222,11,49,71,173,87,113,24,77,101,48,22,6,38,119,262
232,DeQuan Jones,SF,22,ORL,63,17,803,95,218,9,35,86,183,34,51,17,88,105,16,19,22,30,55,233
233,Dominique Jones,PG,24,DAL,29,3,338,40,109,1,9,39,100,35,53,18,27,45,83,14,2,38,29,116
234,James Jones,SF,32,MIA,38,0,221,21,61,16,53,5,8,2,4,0,22,22,13,2,6,3,16,60
235,Kevin Jones,PF,23,CLE,32,0,334,43,107,0,0,43,107,9,15,38,40,78,10,9,5,8,25,95
236,Perry Jones,SF,21,OKC,38,1,280,39,99,0,2,39,97,10,15,12,50,62,10,5,6,15,23,88
237,Solomon Jones,PF,28,NYK,2,1,26,0,1,0,0,0,1,0,0,1,2,3,0,0,1,3,3,0
238,Terrence Jones,PF,21,HOU,19,0,276,43,94,5,19,38,75,13,17,28,37,65,15,12,19,13,21,104
239,DeAndre Jordan,C,24,LAC,82,82,2010,314,488,0,0,314,488,96,249,210,384,594,28,48,112,100,192,724
240,Cory Joseph,PG,21,SAS,28,9,388,51,110,6,21,45,89,18,21,12,40,52,53,15,4,21,25,126
241,Kris Joseph,SF,24,TOT,10,0,54,2,14,0,3,2,11,5,8,1,6,7,1,3,0,2,3,9
242,Chris Kaman,C,30,DAL,66,52,1363,313,617,0,1,313,616,67,85,97,275,372,51,29,52,103,141,693
243,Enes Kanter,C,20,UTA,70,2,1078,206,379,1,1,205,378,93,117,135,169,304,31,28,32,101,116,506
244,Jason Kidd*,SG,39,NYK,76,48,2043,152,409,114,325,38,84,40,48,50,273,323,249,125,25,76,125,458
245,Michael Kidd-Gilchrist,SF,19,CHA,78,77,2025,281,613,2,9,279,604,140,187,131,324,455,117,54,70,101,164,704
246,Andrei Kirilenko,SF,31,MIN,64,64,2034,284,560,35,120,249,440,188,250,102,260,362,177,96,62,119,82,791
247,Linas Kleiza,SF,28,TOR,20,3,376,48,144,20,66,28,78,32,38,10,42,52,16,4,2,14,45,148
248,Brandon Knight,PG,21,DET,75,75,2365,357,878,120,327,237,551,165,225,54,193,247,303,58,8,205,157,999
249,Kyle Korver,SF,31,ATL,74,60,2259,277,601,189,414,88,187,67,78,23,270,293,146,70,37,70,170,810
250,Kosta Koufos,C,23,DEN,81,81,1817,295,508,0,1,295,507,58,104,211,351,562,32,44,103,53,246,648
251,Viacheslav Kravtsov,C,25,DET,25,0,224,33,46,0,0,33,46,11,37,24,21,45,9,5,9,14,32,77
252,Doron Lamb,SG,21,TOT,47,0,577,60,163,14,37,46,126,20,34,8,38,46,32,13,0,26,52,154
253,Jeremy Lamb,SF,20,OKC,23,0,147,24,68,9,30,15,38,14,14,5,13,18,5,2,2,6,13,71
254,Carl Landry,PF,29,GSW,81,2,1876,325,602,1,3,324,599,223,273,180,303,483,65,35,31,115,190,874
255,Ty Lawson,PG,25,DEN,73,71,2513,448,971,85,232,363,739,235,311,36,162,198,501,107,8,182,135,1216
256,Courtney Lee,SG,27,BOS,78,39,1941,246,530,58,156,188,374,62,72,31,159,190,143,89,21,84,139,612
257,David Lee,PF,29,GSW,79,79,2907,602,1160,0,4,602,1156,255,320,218,668,886,279,67,22,207,246,1459
258,Malcolm Lee,SG,22,MIN,16,12,289,29,76,8,24,21,52,12,20,15,24,39,20,12,6,10,30,78
259,Kawhi Leonard,SF,21,SAS,58,57,1810,260,526,65,174,195,352,104,126,63,283,346,93,97,32,62,99,689
260,Meyers Leonard,C,20,POR,69,9,1206,151,277,3,7,148,270,72,89,80,175,255,33,11,38,49,168,377
262,Rashard Lewis,PF,33,MIA,55,9,792,103,249,51,131,52,118,28,45,19,102,121,30,21,14,33,67,285
263,DeAndre Liggins,SG,24,OKC,39,1,290,21,47,7,19,14,28,9,18,13,40,53,15,18,3,14,33,58
264,Damian Lillard,PG,22,POR,82,82,3167,553,1288,185,503,368,785,271,321,42,215,257,531,74,19,243,172,1562
265,Jeremy Lin,PG,24,HOU,82,82,2640,396,897,87,257,309,640,216,275,32,215,247,497,134,29,236,205,1095
266,Shaun Livingston,PG,27,TOT,66,16,1455,166,346,0,4,166,342,85,98,31,127,158,215,48,31,76,127,417
267,Brook Lopez,C,24,BRK,74,74,2253,570,1094,0,1,570,1093,297,392,208,304,512,70,33,154,131,152,1437
268,Robin Lopez,C,24,NOH,82,82,2136,384,719,0,0,384,719,161,207,226,236,462,64,32,128,110,167,929
269,Kevin Love,PF,24,MIN,18,18,618,105,298,20,92,85,206,100,142,64,188,252,42,13,9,39,34,330
270,Kyle Lowry,PG,26,TOR,68,52,2020,250,623,101,279,149,344,190,239,56,265,321,435,94,24,157,218,791
271,John Lucas III,PG,30,TOR,63,0,827,129,334,57,151,72,183,18,25,8,57,65,105,23,1,26,50,333
272,Scott Machado,PG,22,HOU,6,0,21,3,6,0,1,3,5,2,2,0,1,1,6,2,0,8,0,8
274,Corey Maggette,SF,33,DET,18,0,257,27,76,5,21,22,55,36,48,5,20,25,19,6,2,17,42,95
275,Ian Mahinmi,C,26,IND,80,2,1322,149,329,0,2,149,327,104,171,115,196,311,27,39,66,92,201,402
276,Shawn Marion,PF,34,DAL,67,67,2010,355,690,23,73,332,617,79,101,146,379,525,163,75,47,103,111,812
277,Kendall Marshall,PG,21,PHO,48,3,702,56,151,23,73,33,78,8,14,4,38,42,143,22,4,57,48,143
278,Cartier Martin,SF,28,WAS,41,3,694,96,252,58,146,38,106,20,28,11,89,100,20,19,6,32,58,270
279,Kenyon Martin,C,35,NYK,18,11,431,56,93,0,0,56,93,17,40,34,61,95,8,16,17,16,64,129
280,Kevin Martin,SG,29,OKC,77,0,2136,350,778,158,371,192,407,219,246,31,147,178,106,72,8,101,138,1077
281,Roger Mason,SG,32,NOH,69,13,1219,132,305,66,159,66,146,39,43,11,121,132,74,26,11,51,104,369
282,Wesley Matthews,SG,26,POR,69,69,2403,352,808,169,425,183,383,149,187,35,156,191,174,90,18,109,172,1022
283,Jason Maxiell,PF,29,DET,72,71,1789,204,457,0,0,204,457,90,145,135,274,409,54,32,95,81,172,498
285,O.J. Mayo,SG,25,DAL,82,82,2913,461,1026,142,349,319,677,191,233,36,255,291,361,93,23,210,195,1255
286,Luc Mbah a Moute,SF,26,MIL,58,45,1326,151,377,13,37,138,340,72,126,89,167,256,55,42,14,70,82,387
287,JaVale McGee,C,25,DEN,79,0,1433,303,527,1,1,302,526,110,186,158,223,381,24,30,157,90,184,717
288,Dominic McGuire,SF,27,TOT,26,10,387,24,56,0,0,24,56,3,10,19,59,78,20,13,11,12,39,51
289,Josh McRoberts,PF,25,TOT,67,22,1487,156,343,24,84,132,259,65,85,93,232,325,141,32,27,66,131,401
290,Jodie Meeks,SG,25,LAL,78,10,1663,205,530,122,342,83,188,86,96,37,134,171,69,58,5,52,103,618
291,Fab Melo,C,22,BOS,6,0,36,3,6,0,0,3,6,1,4,0,3,3,0,2,2,1,7,7
292,Khris Middleton,SG,21,DET,27,0,475,62,141,14,45,48,96,27,32,4,46,50,28,15,4,11,53,165
293,C.J. Miles,SF,25,CLE,65,13,1364,255,614,126,328,129,286,93,107,24,150,174,63,49,17,69,138,729
294,Darko Miličić,C,27,BOS,1,0,5,0,1,0,0,0,1,0,0,0,1,1,0,0,0,2,1,0
295,Andre Miller,PG,36,DEN,82,11,2151,303,632,17,64,286,568,163,194,60,178,238,484,73,11,172,159,786
296,Darius Miller,SF,22,NOH,52,2,694,44,108,22,56,22,52,8,8,8,70,78,44,17,12,23,89,118
297,Mike Miller,SF,32,MIA,59,17,900,100,231,73,175,27,56,8,11,18,139,157,99,21,4,35,63,281
298,Quincy Miller,PF,20,DEN,7,0,26,4,12,0,1,4,11,1,2,1,1,2,3,1,0,1,3,9
299,Patty Mills,PG,24,SAS,58,2,656,113,241,52,130,61,111,16,19,9,41,50,62,26,4,39,55,294
300,Paul Millsap,PF,27,UTA,78,78,2375,429,875,13,39,416,836,264,356,177,377,554,201,102,80,138,232,1135
301,Nazr Mohammed,C,35,CHI,63,12,693,66,180,0,2,66,178,34,47,73,122,195,26,21,32,24,97,166
302,Greg Monroe,C,22,DET,81,81,2687,514,1058,0,4,514,1054,270,392,236,541,777,281,105,55,234,190,1298
303,E'Twaun Moore,SG,23,ORL,75,21,1682,237,598,67,197,170,401,47,59,48,119,167,206,51,23,105,122,588
304,Darius Morris,PG,22,LAL,48,17,683,73,188,24,66,49,122,24,37,24,33,57,76,21,2,45,58,194
306,Markieff Morris,PF,23,PHO,82,32,1837,266,653,45,134,221,519,93,127,131,265,396,108,77,64,104,209,670
307,Anthony Morrow,SG,27,TOT,41,1,383,64,145,16,43,48,102,20,22,11,19,30,13,13,1,8,43,164
308,Donatas Motiejūnas,PF,22,HOU,44,14,538,97,213,24,83,73,130,32,51,36,57,93,31,7,10,37,73,250
309,Arnett Moultrie,PF,22,PHI,47,0,542,78,134,0,0,78,134,18,28,76,69,145,10,17,10,19,43,174
310,Timofey Mozgov,C,26,DEN,41,1,366,44,87,0,2,44,85,20,26,50,57,107,9,6,18,25,57,108
311,Byron Mullens,PF,23,CHA,53,41,1428,217,563,66,208,151,355,64,99,71,266,337,81,34,32,74,110,564
312,Kevin Murphy,SG,22,UTA,17,0,52,7,28,1,5,6,23,0,0,0,4,4,2,1,0,3,4,15
313,Troy Murphy,PF,32,DAL,14,1,256,22,61,11,35,11,26,10,11,7,42,49,7,10,6,7,29,65
314,Steve Nash*,PG,38,LAL,50,50,1627,236,475,57,130,179,345,107,116,26,116,142,333,30,5,126,70,636
315,Gary Neal,SG,28,SAS,68,17,1484,246,597,89,251,157,346,64,74,13,130,143,129,30,2,69,93,645
316,Jameer Nelson,PG,30,ORL,56,56,1977,306,780,121,355,185,425,89,102,23,186,209,413,71,6,154,161,822
317,Andrew Nicholson,PF,23,ORL,75,28,1249,256,486,0,0,256,486,75,94,69,189,258,44,24,32,79,133,587
318,Joakim Noah,C,27,CHI,66,64,2426,303,630,0,5,303,625,178,237,260,473,733,262,78,141,176,185,784
319,Steve Novak,SF,29,NYK,81,1,1641,178,430,149,351,29,79,30,33,17,135,152,35,28,8,12,97,535
320,Dirk Nowitzki,PF,34,DAL,53,47,1661,343,728,65,157,278,571,166,193,37,326,363,132,38,37,70,93,917
321,Jermaine O'Neal,C,34,PHO,55,4,1029,179,371,0,0,179,371,96,115,82,211,293,42,19,78,73,126,454
322,Kyle O'Quinn,C,22,ORL,57,5,638,101,197,0,1,101,196,30,45,65,144,209,52,11,26,37,107,232
323,Lamar Odom,PF,33,LAC,82,2,1616,146,366,18,90,128,276,20,42,117,363,480,142,69,58,86,214,330
324,Tim Ohlbrecht,C,24,HOU,3,0,12,1,3,0,0,1,3,1,1,0,1,1,1,1,0,4,1,3
325,Emeka Okafor,C,30,WAS,79,77,2052,328,687,0,0,328,687,109,191,199,493,692,93,45,77,107,145,765
326,Daniel Orton,C,22,OKC,13,0,104,12,26,0,0,12,26,9,17,13,13,26,4,4,3,4,13,33
327,Travis Outlaw,SF,28,SAC,38,2,444,74,177,14,50,60,127,38,52,17,44,61,21,11,8,19,35,200
328,Zaza Pachulia,C,28,ATL,52,15,1134,114,241,0,3,114,238,78,103,132,204,336,79,35,12,70,128,306
329,Jannero Pargo,PG,33,TOT,32,0,507,78,212,39,116,39,96,12,13,10,25,35,67,18,3,41,42,207
331,Tony Parker,PG,30,SAS,66,66,2174,519,995,24,68,495,927,279,330,18,180,198,499,54,6,170,92,1341
332,Chandler Parsons,SF,24,HOU,76,76,2758,456,939,152,395,304,544,113,155,79,325,404,269,75,32,147,148,1177
333,Patrick Patterson,PF,23,TOT,71,41,1775,319,623,51,132,268,491,48,63,113,224,337,81,31,40,61,138,737
334,Chris Paul,PG,27,LAC,70,70,2335,412,856,76,232,336,624,286,323,53,209,262,678,169,10,159,143,1186
335,Sasha Pavlović,SG,29,POR,39,1,528,42,119,18,60,24,59,1,6,7,49,56,32,24,5,14,59,103
336,Nikola Peković,C,27,MIN,62,62,1959,385,741,0,0,385,741,241,324,230,315,545,53,43,50,101,143,1011
337,Kendrick Perkins,C,28,OKC,78,78,1954,143,313,0,1,143,312,44,72,110,356,466,111,43,83,109,227,330
338,Johan Petro,C,27,ATL,31,8,352,48,110,1,4,47,106,11,12,33,79,112,16,10,9,24,48,108
339,Paul Pierce,SF,35,BOS,77,77,2575,476,1092,145,382,331,710,333,423,45,442,487,370,84,30,214,210,1430
340,Mickaël Piétrus,SF,30,TOR,19,16,386,34,98,20,64,14,34,12,18,5,31,36,9,12,6,16,33,100
341,Dexter Pittman,C,24,TOT,11,0,32,4,11,0,0,4,11,0,3,7,5,12,0,0,0,3,8,8
342,Miles Plumlee,C,24,IND,14,0,55,5,21,0,0,5,21,3,4,12,10,22,2,0,3,3,5,13
343,Quincy Pondexter,SF,24,MEM,59,1,1243,128,299,60,152,68,147,59,75,43,89,132,61,35,6,42,95,375
344,A.J. Price,PG,26,WAS,57,22,1278,161,413,70,200,91,213,49,62,20,94,114,205,33,3,64,73,441
345,Ronnie Price,PG,29,POR,39,0,510,39,120,10,39,29,81,17,24,13,31,44,73,26,3,34,61,105
346,Pablo Prigioni,PG,35,NYK,78,18,1263,100,220,53,134,47,86,22,25,41,102,143,236,69,2,86,127,275
347,Tayshaun Prince,SF,32,TOT,82,81,2631,359,820,38,94,321,726,96,130,72,292,364,196,48,25,89,86,852
348,Joel Przybilla,C,33,MIL,12,1,68,1,4,0,0,1,4,0,2,5,16,21,4,1,2,4,10,2
349,Chris Quinn,SG,29,CLE,7,0,78,4,16,0,5,4,11,2,2,1,1,2,9,3,0,6,4,10
350,Vladimir Radmanović,PF,32,CHI,25,0,144,13,43,5,27,8,16,2,3,10,18,28,8,8,4,7,29,33
351,Anthony Randolph,PF,23,DEN,39,0,329,56,114,0,8,56,106,31,45,29,66,95,12,19,21,37,41,143
352,Shavlik Randolph,PF,29,BOS,16,0,198,28,48,0,0,28,48,11,27,28,42,70,4,8,7,10,38,67
353,Zach Randolph,PF,31,MEM,76,75,2607,471,1024,2,23,469,1001,225,300,310,544,854,108,61,31,150,180,1169
354,J.J. Redick,SG,28,TOT,78,13,2379,382,880,165,451,217,429,171,190,17,154,171,296,38,9,138,117,1100
355,Jason Richardson,SG,32,PHI,33,33,936,135,336,57,167,78,169,20,33,19,108,127,51,40,15,26,57,347
356,Quentin Richardson,SF,32,NYK,1,0,29,1,11,1,4,0,7,2,2,5,5,10,1,0,0,2,1,5
357,Luke Ridnour,SG,31,MIN,82,82,2474,367,811,66,212,301,599,139,164,41,165,206,311,82,15,130,187,939
358,Austin Rivers,SG,20,NOH,61,26,1418,145,390,28,86,117,304,59,108,16,93,109,127,26,9,74,122,377
359,Brian Roberts,PG,27,NOH,78,5,1324,213,511,59,153,154,358,70,77,17,80,97,219,37,3,71,108,555
360,Nate Robinson,PG,28,CHI,82,23,2086,399,921,141,348,258,573,135,169,29,155,184,358,85,10,144,207,1074
361,Thomas Robinson,PF,21,TOT,70,0,1056,138,321,0,1,138,320,57,109,122,193,315,46,41,26,88,124,333
362,Rajon Rondo,PG,26,BOS,38,38,1423,225,465,12,50,213,415,60,93,43,169,212,420,70,9,148,96,522
363,Terrence Ross,SG,21,TOR,73,2,1239,186,457,65,196,121,261,30,42,35,109,144,53,43,14,48,122,467
364,Brandon Roy,SG,28,MIN,5,5,122,11,35,0,9,11,26,7,10,3,11,14,23,3,0,7,5,29
365,Ricky Rubio,PG,22,MIN,57,47,1691,185,514,27,92,158,422,211,264,44,185,229,418,137,5,172,143,608
366,Brandon Rush,SF,27,GSW,2,0,25,6,9,0,2,6,7,2,3,0,1,1,2,0,0,3,5,14
367,Robert Sacre,C,23,LAL,32,3,203,18,48,0,0,18,48,7,11,9,25,34,6,0,10,10,38,43
368,John Salmons,SF,33,SAC,76,72,2278,244,612,99,267,145,345,85,110,33,174,207,226,51,25,85,143,672
369,Samardo Samuels,C,24,CLE,18,1,196,22,60,0,1,22,59,14,24,10,18,28,8,3,3,6,30,58
370,Larry Sanders,C,24,MIL,71,55,1937,306,605,0,2,306,603,84,136,224,448,672,83,53,201,87,233,696
371,Luis Scola,PF,32,PHO,82,67,2184,432,915,3,16,429,899,181,230,158,383,541,182,67,35,126,257,1048
372,Mike Scott,PF,24,ATL,40,1,376,70,147,0,1,70,146,43,56,39,71,110,12,4,2,21,32,183
373,Thabo Sefolosha,SG,28,OKC,81,81,2229,224,466,108,258,116,208,57,69,58,259,317,125,103,44,64,177,613
374,Josh Selby,PG,21,MEM,10,0,59,6,22,1,6,5,16,7,11,0,5,5,4,2,0,7,7,20
375,Kevin Séraphin,C,23,WAS,79,8,1721,330,716,0,0,330,716,61,88,107,239,346,57,24,59,130,211,721
376,Ramon Sessions,SG,26,CHA,61,0,1652,276,676,33,107,243,569,291,347,27,142,169,230,48,7,104,91,876
377,Tornike Shengelia,SF,21,BRK,19,0,93,10,23,1,2,9,21,9,16,9,14,23,3,3,1,11,11,30
378,Iman Shumpert,SG,22,NYK,45,45,996,109,275,51,127,58,148,36,47,31,105,136,75,43,7,37,99,305
379,Alexey Shved,SG,24,MIN,77,16,1840,236,635,85,288,151,347,108,150,41,134,175,286,54,27,147,117,665
380,Henry Sims,C,22,NOH,2,0,5,2,3,0,0,2,3,0,0,2,0,2,0,0,0,1,1,4
381,Kyle Singler,SF,24,DET,82,74,2293,275,642,70,200,205,442,100,124,109,221,330,77,57,37,98,217,720
382,Chris Singleton,PF,23,WAS,57,11,924,92,241,7,36,85,205,40,70,51,133,184,37,38,24,45,124,231
384,Greg Smith,C,22,HOU,70,10,1110,170,274,0,1,170,273,81,130,111,210,321,25,18,40,41,175,421
385,Ish Smith,PG,24,TOT,52,3,516,56,159,8,27,48,132,3,7,12,49,61,87,21,9,37,26,123
386,J.R. Smith,SG,27,NYK,80,0,2678,527,1249,155,436,372,813,237,311,64,361,425,218,100,24,134,226,1446
387,Jason Smith,C,26,NOH,51,0,876,167,341,0,4,167,337,86,102,64,122,186,34,15,45,55,123,420
388,Josh Smith,PF,27,ATL,76,76,2683,550,1182,61,201,489,981,166,321,133,506,639,321,94,136,226,175,1327
389,Nolan Smith,PG,24,POR,40,0,288,42,114,6,28,36,86,20,28,7,20,27,35,7,1,29,26,110
390,Marreese Speights,C,25,TOT,79,3,1300,260,584,3,10,257,574,135,175,146,240,386,47,24,53,80,175,658
391,Tiago Splitter,PF,28,SAS,81,58,1997,315,563,0,2,315,561,208,285,144,371,515,130,63,64,100,161,838
392,Jerry Stackhouse,SF,38,BRK,37,0,544,66,172,30,89,36,83,20,23,5,28,33,35,7,4,24,31,182
393,Lance Stephenson,SG,22,IND,78,72,2278,275,598,62,188,213,410,75,115,47,257,304,223,81,16,109,162,687
394,DeShawn Stevenson,SG,31,ATL,56,31,1158,98,262,76,209,22,53,12,23,18,104,122,52,29,6,23,69,284
395,Greg Stiemsma,C,27,MIN,76,19,1209,127,278,0,0,127,278,53,69,61,200,261,30,44,90,59,184,307
396,Julyan Stone,PG,24,DEN,4,0,28,2,2,0,0,2,2,3,4,2,1,3,2,1,0,2,4,7
397,Amar'e Stoudemire,PF,30,NYK,29,0,682,154,267,0,0,154,267,105,130,60,85,145,13,10,21,50,89,413
398,Rodney Stuckey,SG,26,DET,76,24,2171,304,748,55,182,249,566,213,272,43,169,212,270,51,17,134,127,876
399,Jared Sullinger,PF,20,BOS,45,5,892,111,225,1,5,110,220,47,63,92,172,264,35,22,22,29,154,270
400,DaJuan Summers,PF,25,LAC,2,0,7,1,4,0,0,1,4,0,0,0,2,2,1,0,0,0,0,2
401,Jeffery Taylor,SF,23,CHA,77,29,1507,172,399,53,154,119,245,75,103,51,99,150,63,47,15,48,136,472
402,Tyshawn Taylor,PG,22,BRK,38,0,221,32,87,6,13,26,74,15,27,2,16,18,21,13,0,25,25,85
403,Jeff Teague,PG,24,ATL,80,78,2628,439,974,89,248,350,726,199,226,25,155,180,579,117,28,230,181,1166
404,Marquis Teague,PG,19,CHI,48,0,392,43,113,4,23,39,90,9,16,3,41,44,63,9,7,35,47,99
405,Mirza Teletović,PF,27,BRK,53,0,499,71,185,37,108,34,77,9,11,33,62,95,23,13,8,20,53,188
406,Sebastian Telfair,PG,27,TOT,59,2,980,112,309,53,150,59,159,54,69,13,71,84,153,37,11,64,104,331
407,Garrett Temple,SG,26,WAS,51,36,1156,105,258,26,80,79,178,26,37,29,94,123,115,50,17,61,94,262
408,Jason Terry,SG,35,BOS,79,24,2124,281,648,123,331,158,317,114,131,19,140,159,198,66,11,102,110,799
409,Hasheem Thabeet,C,25,OKC,66,4,770,64,106,0,0,64,106,32,53,69,126,195,11,30,60,41,148,160
410,Isaiah Thomas,PG,23,SAC,79,62,2122,366,832,115,321,251,511,253,287,29,132,161,316,67,3,140,167,1100
411,Kurt Thomas,PF,40,NYK,39,17,392,45,83,1,1,44,82,6,13,24,65,89,21,10,16,8,52,97
412,Lance Thomas,SF,24,NOH,59,9,646,53,106,0,0,53,106,43,59,44,71,115,17,11,7,14,78,149
413,Malcolm Thomas,PF,24,TOT,12,0,57,5,10,0,0,5,10,5,8,5,11,16,4,2,2,3,8,15
414,Tyrus Thomas,PF,26,CHA,26,2,360,48,136,3,8,45,128,26,31,16,44,60,19,14,15,17,51,125
415,Jason Thompson,PF,26,SAC,82,81,2285,374,745,0,3,374,742,143,206,172,377,549,84,48,61,101,227,891
416,Klay Thompson,SG,22,GSW,82,82,2936,508,1205,211,526,297,679,132,157,32,274,306,183,86,45,157,237,1359
417,Tristan Thompson,PF,21,CLE,82,82,2564,390,799,0,3,390,796,177,291,306,467,773,108,60,71,123,234,957
418,Marcus Thornton,SG,25,SAC,72,8,1726,332,774,141,379,191,395,111,126,50,131,181,91,61,4,68,105,916
419,Jamaal Tinsley,PG,34,UTA,66,32,1221,86,234,39,127,47,107,18,26,17,98,115,290,64,14,106,106,229
420,Anthony Tolliver,SF,27,ATL,62,11,963,82,216,45,133,37,83,44,51,31,124,155,32,15,12,36,66,253
421,P.J. Tucker,SG,27,PHO,79,45,1910,210,444,22,70,188,374,64,86,132,218,350,109,62,19,67,145,506
422,Ronny Turiaf,C,30,LAC,65,0,701,49,97,0,0,49,97,23,63,45,107,152,35,19,35,29,80,121
423,Hedo Türkoğlu,SF,33,ORL,11,1,189,14,53,1,24,13,29,3,6,4,22,26,23,7,1,12,11,32
424,Evan Turner,SF,24,PHI,82,82,2892,441,1053,58,159,383,894,154,208,56,461,517,354,71,17,187,197,1094
425,Jeremy Tyler,C,21,TOT,21,0,68,9,24,0,0,9,24,4,6,6,14,20,1,1,2,6,10,22
426,Ekpe Udoh,C,25,MIL,76,9,1312,117,269,0,1,117,268,89,119,113,138,251,43,39,85,43,139,323
428,Jonas Valančiūnas,C,20,TOR,62,57,1482,204,366,0,0,204,366,146,185,121,251,372,45,17,78,94,188,554
429,Anderson Varejão,C,30,CLE,25,25,901,138,289,0,5,138,284,77,102,138,223,361,84,37,14,44,68,353
430,Jarvis Varnado,PF,24,TOT,13,0,58,3,7,0,0,3,7,2,4,2,7,9,3,1,2,6,10,8
431,Greivis Vásquez,PG,26,NOH,78,78,2685,438,1012,83,243,355,769,124,154,43,294,337,704,66,6,247,190,1083
432,Jan Veselý,PF,22,WAS,51,4,601,57,114,0,1,57,113,12,39,43,79,122,28,15,17,27,107,126
433,Charlie Villanueva,PF,28,DET,69,0,1092,175,464,90,259,85,205,27,49,49,192,241,54,31,39,39,96,467
434,Nikola Vučević,C,22,ORL,77,77,2559,461,889,0,3,461,886,86,126,273,644,917,143,61,79,141,218,1008
435,Dwyane Wade,SG,31,MIA,69,69,2391,569,1093,17,66,552,1027,308,425,86,258,344,352,128,56,194,140,1463
436,Dion Waiters,SG,21,CLE,61,48,1756,336,815,63,203,273,612,159,213,22,127,149,183,59,16,121,113,894
437,Kemba Walker,PG,22,CHA,82,82,2859,526,1244,107,332,419,912,296,371,60,223,283,471,160,31,200,153,1455
438,John Wall,PG,22,WAS,49,42,1602,324,735,12,45,312,690,246,306,35,161,196,373,65,37,157,117,906
439,Gerald Wallace,SF,30,BRK,69,68,2076,182,458,46,163,136,295,121,190,69,250,319,181,97,46,110,118,531
440,Rasheed Wallace,C,38,NYK,21,0,296,55,142,22,69,33,73,14,20,11,72,83,6,13,15,10,40,146
441,Luke Walton,PF,32,CLE,50,0,857,71,181,20,67,51,114,10,20,38,107,145,166,42,13,60,98,172
442,Hakim Warrick,PF,30,TOT,28,14,489,67,165,0,3,67,162,60,88,21,68,89,25,13,6,29,37,194
443,C.J. Watson,PG,28,BRK,80,8,1521,192,459,88,214,104,245,71,91,38,107,145,161,66,12,69,123,543
444,Earl Watson,PG,33,UTA,48,4,829,37,120,5,28,32,92,17,25,23,64,87,190,40,8,69,94,96
445,Maalik Wayns,PG,21,TOT,27,1,202,26,88,7,31,19,57,17,19,1,6,7,27,6,0,15,26,76
446,Martell Webster,SF,26,WAS,76,62,2200,281,636,139,329,142,307,168,198,53,241,294,143,49,17,90,166,869
447,David West,PF,32,IND,73,73,2435,502,1009,4,19,498,990,242,315,145,418,563,213,74,69,157,149,1250
448,Russell Westbrook,PG,24,OKC,82,82,2861,673,1535,97,300,576,1235,460,575,111,317,428,607,145,24,273,189,1903
449,D.J. White,PF,26,BOS,12,0,86,12,23,0,0,12,23,5,9,4,9,13,4,1,6,2,5,29
450,James White,SF,30,NYK,57,16,435,50,116,14,41,36,75,11,19,5,43,48,29,13,4,17,44,125
451,Chris Wilcox,C,30,BOS,61,7,830,110,153,0,1,110,152,39,58,55,125,180,22,32,28,34,125,259
452,Damien Wilkins,SG,33,PHI,61,21,1095,145,316,17,51,128,265,81,109,32,73,105,91,37,18,49,98,388
453,Deron Williams,PG,28,BRK,78,78,2842,495,1124,169,447,326,677,317,369,29,203,232,604,75,30,218,194,1476
454,Derrick Williams,PF,21,MIN,78,56,1916,338,786,65,196,273,590,192,272,96,334,430,46,44,37,101,127,933
455,Lou Williams,SG,26,ATL,39,9,1119,187,443,72,196,115,247,105,121,8,72,80,139,44,10,74,55,551
456,Marvin Williams,SF,26,UTA,73,51,1727,199,470,54,166,145,304,77,99,55,208,263,77,37,38,60,98,529
457,Mo Williams,PG,30,UTA,46,46,1418,229,533,59,154,170,379,75,85,24,86,110,285,46,9,125,105,592
458,Reggie Williams,SF,26,CHA,40,0,380,57,132,22,72,35,60,10,21,8,43,51,39,12,1,19,19,146
459,Terrence Williams,SF,25,BOS,24,0,318,48,97,5,15,43,82,9,21,4,40,44,38,11,2,22,13,110
460,Metta World Peace,SF,33,LAL,75,66,2530,332,824,141,412,191,412,124,169,101,271,372,112,122,42,98,198,929
461,Brandan Wright,C,25,DAL,64,16,1149,241,404,0,3,241,401,59,96,85,175,260,38,26,76,34,78,541
462,Chris Wright,SG,23,DAL,3,0,4,1,2,0,0,1,2,0,0,0,0,0,0,0,0,1,0,2
463,Dorell Wright,SF,27,PHI,79,8,1783,237,599,135,361,102,238,120,141,42,260,302,150,62,35,64,98,729
464,Tony Wroten,SG,19,MEM,35,0,272,33,86,4,16,29,70,21,29,13,15,28,43,8,4,29,34,91
465,Nick Young,SG,27,PHI,59,17,1411,224,542,75,210,149,332,105,128,24,106,130,84,36,14,50,84,628
466,Sam Young,SG,27,IND,56,3,693,58,148,16,52,42,96,23,43,26,97,123,42,15,8,33,62,155
467,Thaddeus Young,PF,24,PHI,76,76,2629,509,958,1,8,508,950,108,188,182,389,571,125,133,55,90,191,1127
468,Luke Zeller,C,25,PHO,16,0,58,9,26,1,5,8,21,0,0,1,9,10,3,0,0,0,5,19
469,Tyler Zeller,C,23,CLE,77,55,2033,245,559,0,4,245,555,120,157,159,279,438,96,35,70,95,251,610
1,Quincy Acy,SF,23,TOT,63,0,847,66,141,4,15,62,126,35,53,72,144,216,28,23,26,30,122,171
2,Steven Adams,C,20,OKC,81,20,1197,93,185,0,0,93,185,79,136,142,190,332,43,40,57,71,203,265
3,Jeff Adrien,PF,27,TOT,53,12,961,143,275,0,0,143,275,76,119,102,204,306,38,24,36,39,108,362
4,Arron Afflalo,SG,28,ORL,73,73,2552,464,1011,128,300,336,711,274,336,32,230,262,248,35,3,146,136,1330
5,Alexis Ajinça,C,25,NOP,56,30,951,136,249,0,1,136,248,56,67,94,183,277,40,23,46,63,187,328
6,Cole Aldrich,C,25,NYK,46,2,330,33,61,0,0,33,61,26,30,37,92,129,14,8,30,18,40,92
7,LaMarcus Aldridge,PF,28,POR,69,69,2498,652,1423,3,15,649,1408,296,360,166,599,765,178,63,68,123,147,1603
8,Lavoy Allen,PF,24,TOT,65,2,1072,134,300,2,13,132,287,33,50,119,192,311,71,24,33,44,126,303
9,Ray Allen*,SG,38,MIA,73,9,1936,240,543,116,309,124,234,105,116,23,182,205,143,54,8,84,115,701
10,Tony Allen,SG,32,MEM,55,28,1278,204,413,11,47,193,366,76,121,79,129,208,94,90,19,90,121,495
11,Al-Farouq Aminu,SF,23,NOP,80,65,2045,234,494,13,48,221,446,91,137,129,367,496,114,82,38,88,147,572
12,Lou Amundson,PF,31,TOT,19,0,185,16,32,0,0,16,32,6,24,28,27,55,6,9,11,14,49,38
13,Chris Andersen,C,35,MIA,72,0,1396,177,275,3,12,174,263,120,169,129,250,379,19,32,97,53,162,477
14,Alan Anderson,SF,31,BRK,78,26,1773,194,485,84,248,110,237,92,118,40,135,175,81,48,11,62,147,564
15,James Anderson,SG,24,PHI,80,62,2309,309,717,115,351,194,366,77,106,59,241,300,149,74,28,106,154,810
16,Ryan Anderson,PF,25,NOP,22,14,795,155,354,67,164,88,190,59,62,66,76,142,17,10,7,20,47,436
17,Giannis Antetokounmpo,SF,19,MIL,77,23,1897,173,418,41,118,132,300,138,202,78,261,339,150,60,61,122,173,525
18,Carmelo Anthony,PF,29,NYK,77,77,2982,743,1643,167,415,576,1228,459,541,145,477,622,242,95,51,198,224,2112
19,Joel Anthony,C,31,TOT,33,0,186,12,32,0,0,12,32,4,8,15,23,38,2,3,12,3,17,28
20,Pero Antić,C,31,ATL,50,26,925,123,294,56,171,67,123,50,66,57,152,209,58,19,12,55,126,352
21,Trevor Ariza,SF,28,WAS,77,77,2723,389,853,180,442,209,411,149,193,99,376,475,191,126,20,132,179,1107
22,Hilton Armstrong,C,29,GSW,15,1,97,9,19,0,0,9,19,7,16,19,28,47,5,4,4,6,11,25
23,Darrell Arthur,SF,25,DEN,68,1,1161,162,410,24,64,138,346,53,62,52,158,210,61,39,47,58,185,401
24,Ömer Aşık,C,27,HOU,48,19,968,101,190,0,0,101,190,78,126,101,277,378,25,14,37,59,92,280
25,D.J. Augustin,PG,26,TOT,71,9,1939,298,718,133,332,165,386,201,227,15,115,130,313,53,3,125,147,930
26,Gustavo Ayón,C,28,ATL,26,14,429,52,102,0,0,52,102,8,20,42,83,125,28,25,10,29,47,112
27,Jeff Ayres,PF,26,SAS,73,10,952,101,174,0,0,101,174,38,55,89,169,258,60,13,25,63,146,240
28,Chris Babb,SG,23,BOS,14,0,132,8,30,6,27,2,3,0,0,4,13,17,3,6,0,3,13,22
29,Luke Babbitt,PF,24,NOP,27,2,473,60,154,36,95,24,59,14,18,18,70,88,29,7,11,15,52,170
30,Leandro Barbosa,PG,31,PHO,20,0,368,56,131,7,25,49,106,31,39,5,32,37,32,7,4,19,30,150
31,J.J. Barea,PG,29,MIN,79,1,1471,254,656,73,231,181,425,79,100,16,138,154,303,26,0,125,129,660
32,Andrea Bargnani,C,28,NYK,42,39,1257,222,502,30,108,192,394,84,102,69,153,222,45,14,52,58,100,558
33,Harrison Barnes,SF,21,GSW,78,24,2204,271,679,66,190,205,489,130,181,66,245,311,116,65,20,84,158,738
34,Matt Barnes,SF,33,LAC,63,40,1735,231,527,97,283,134,244,66,90,60,232,292,125,56,28,85,185,625
35,Will Barton,SG,23,POR,41,0,387,65,156,10,33,55,123,26,32,16,58,74,33,9,7,18,31,166
36,Brandon Bass,PF,28,BOS,82,73,2266,352,725,2,6,350,719,205,239,161,309,470,87,36,71,102,190,911
37,Shane Battier,SF,35,MIA,73,56,1468,105,275,73,210,32,65,15,23,34,104,138,63,50,39,21,124,298
38,Nicolas Batum,SF,25,POR,82,82,2956,381,819,145,402,236,417,163,203,116,495,611,420,75,57,208,156,1070
39,Jerryd Bayless,PG,25,TOT,72,19,1686,248,617,76,212,172,405,94,118,22,123,145,194,60,9,82,161,666
40,Aron Baynes,C,27,SAS,53,4,491,71,163,0,0,71,163,19,21,57,88,145,34,2,5,36,77,161
41,Kent Bazemore,SG,24,TOT,67,15,911,147,343,43,128,104,215,66,109,10,107,117,91,43,13,79,102,403
42,Bradley Beal,SG,20,WAS,73,73,2530,481,1149,138,343,343,806,149,189,54,219,273,243,71,18,128,153,1249
43,Michael Beasley,SF,25,MIA,55,2,831,177,355,21,54,156,301,61,79,31,141,172,42,23,21,57,93,436
44,Marco Belinelli,SF,27,SAS,80,25,2016,337,695,126,293,211,402,111,131,18,208,226,179,50,7,95,130,911
45,Anthony Bennett,PF,20,CLE,52,0,663,80,225,13,53,67,172,44,69,49,106,155,17,21,8,47,93,217
46,Patrick Beverley,PG,25,HOU,56,55,1751,199,481,92,255,107,226,83,102,72,124,196,151,77,23,66,174,573
47,Andris Biedriņš,C,27,UTA,6,0,45,1,1,0,0,1,1,1,6,2,15,17,0,0,0,2,6,3
48,Chauncey Billups,SG,37,DET,19,7,309,24,79,14,48,10,31,10,12,4,24,28,42,8,1,25,25,72
49,Bismack Biyombo,C,21,CHA,77,9,1072,88,144,0,0,88,144,46,89,105,261,366,8,7,86,40,124,222
50,DeJuan Blair,PF,24,DAL,78,13,1214,210,393,0,2,210,391,77,121,139,229,368,70,60,21,77,192,497
51,Steve Blake,PG,33,TOT,55,28,1498,133,353,79,210,54,143,33,43,13,146,159,307,54,8,102,85,378
52,Andray Blatche,PF,27,BRK,73,7,1618,321,674,15,54,306,620,164,221,120,270,390,112,75,38,110,166,821
53,Eric Bledsoe,PG,24,PHO,43,40,1416,265,556,50,140,215,416,183,237,27,175,202,235,69,14,143,99,763
54,Vander Blue,SG,21,BOS,3,0,15,2,4,0,1,2,3,1,5,0,3,3,1,0,0,2,1,5
55,Keith Bogans,SG,33,BOS,6,0,55,3,6,3,6,0,0,3,3,0,3,3,3,1,0,1,2,12
56,Andrew Bogut,C,29,GSW,67,67,1769,235,375,0,0,235,375,22,64,182,489,671,112,47,121,97,210,492
57,Matt Bonner,PF,33,SAS,61,0,690,73,164,42,98,31,66,9,12,16,114,130,31,15,11,16,49,197
58,Trevor Booker,PF,26,WAS,72,45,1553,222,403,0,2,222,401,47,76,149,230,379,64,41,45,58,131,491
59,Carlos Boozer,PF,32,CHI,76,76,2141,447,980,0,2,447,978,148,193,137,495,632,118,53,22,154,216,1042
60,Chris Bosh,C,29,MIA,79,79,2531,492,953,74,218,418,735,223,272,98,424,522,87,80,78,125,192,1281
61,Avery Bradley,SG,23,BOS,60,58,1855,361,825,79,200,282,625,90,112,48,178,226,85,63,11,96,145,891
62,Elton Brand,C,34,ATL,73,15,1414,179,332,0,2,179,330,61,94,97,264,361,74,40,88,60,192,419
63,Corey Brewer,SF,27,MIN,81,81,2609,388,807,59,211,329,596,163,227,63,144,207,135,151,30,105,210,998
64,Ronnie Brewer,SF,28,TOT,24,3,160,3,15,1,8,2,7,0,2,2,12,14,10,6,1,2,4,7
65,Aaron Brooks,PG,29,TOT,72,12,1557,233,581,96,248,137,333,83,95,43,97,140,233,52,13,117,146,645
66,MarShon Brooks,SG,25,TOT,35,0,316,57,125,13,25,44,100,32,44,10,44,54,25,14,4,24,21,159
67,Lorenzo Brown,PG,23,PHI,26,0,224,26,86,3,30,23,56,9,13,8,20,28,41,13,3,16,19,64
68,Shannon Brown,SG,28,TOT,29,1,251,24,66,0,2,24,64,15,21,7,21,28,9,13,0,18,24,63
69,Kobe Bryant,SG,35,LAL,6,6,177,31,73,3,16,28,57,18,21,2,24,26,38,7,1,34,9,83
70,Chase Budinger,SF,25,MIN,41,8,751,100,254,42,120,58,134,32,39,19,84,103,31,19,2,24,58,274
71,Reggie Bullock,SF,22,LAC,43,0,395,43,121,22,73,21,48,7,9,11,43,54,12,9,1,13,26,115
72,Trey Burke,PG,21,UTA,70,68,2262,341,897,111,336,230,561,102,113,37,171,208,396,42,6,131,145,895
73,Alec Burks,SG,22,UTA,78,12,2193,380,831,50,143,330,688,279,373,59,198,257,212,69,14,149,190,1089
74,Caron Butler,SF,33,TOT,56,13,1419,213,540,98,249,115,291,63,75,21,208,229,82,47,17,60,120,587
75,Jimmy Butler,SG,24,CHI,67,67,2591,275,693,68,240,207,453,260,338,87,243,330,175,127,36,102,106,878
76,Rasual Butler,SG,34,IND,50,2,378,51,110,26,62,25,48,8,14,6,35,41,17,7,9,11,30,136
77,Dwight Buycks,PG,24,TOR,14,0,146,15,48,5,17,10,31,8,9,4,19,23,10,8,0,10,11,43
78,Andrew Bynum,C,26,TOT,26,19,516,94,225,0,0,94,225,37,49,53,92,145,29,6,29,34,31,225
79,Will Bynum,PG,31,DET,56,3,1054,184,430,20,62,164,368,97,121,24,75,99,216,39,7,103,121,485
80,Nick Calathes,SG,24,MEM,71,7,1173,142,311,19,61,123,250,44,72,23,114,137,207,66,8,101,117,347
81,José Calderón,PG,32,DAL,81,81,2468,341,748,191,425,150,323,52,63,29,163,192,377,69,11,103,136,925
82,Kentavious Caldwell-Pope,SG,20,DET,80,41,1583,182,460,59,185,123,275,47,61,38,118,156,55,75,12,28,145,470
83,Isaiah Canaan,PG,22,HOU,22,0,252,31,87,18,55,13,32,21,29,7,17,24,22,8,4,21,25,101
84,DeMarre Carroll,SF,27,ATL,73,73,2341,302,642,97,268,205,374,109,141,107,296,403,134,108,21,79,188,810
85,Vince Carter,SG,37,DAL,81,0,1973,330,811,146,371,184,440,161,196,67,217,284,212,61,35,108,209,967
86,Michael Carter-Williams,PG,22,PHI,70,70,2414,427,1054,55,208,372,846,258,367,101,336,437,441,130,43,247,213,1167
87,Omri Casspi,PF,25,HOU,71,2,1283,173,410,61,176,112,234,83,122,55,205,260,88,44,14,72,100,490
88,Mario Chalmers,PG,27,MIA,73,73,2178,254,560,87,226,167,334,121,163,41,173,214,357,119,16,162,210,716
89,Tyson Chandler,C,31,NYK,55,55,1662,191,322,0,1,191,321,98,155,159,370,529,59,36,63,71,145,480
90,Wilson Chandler,SF,26,DEN,62,55,1927,307,738,122,351,185,387,110,152,58,236,294,114,46,31,79,193,846
91,Josh Childress,SF,30,NOP,4,0,24,0,0,0,0,0,0,0,0,0,3,3,2,1,0,1,1,0
92,Dionte Christmas,SF,27,PHO,31,0,198,22,62,9,31,13,31,18,24,13,25,38,8,2,3,6,19,71
93,Earl Clark,PF,26,TOT,54,17,768,97,261,41,122,56,139,22,34,22,121,143,18,17,25,31,67,257
94,Ian Clark,SG,22,UTA,23,0,172,26,67,11,31,15,36,5,7,3,16,19,15,8,2,14,24,68
95,Victor Claver,SF,25,POR,21,0,184,17,42,3,18,14,24,10,11,9,30,39,12,3,3,11,16,47
96,Norris Cole,PG,25,MIA,82,6,2014,207,500,60,174,147,326,53,68,17,143,160,248,77,5,127,156,527
97,Jason Collins,C,35,BRK,22,1,172,11,24,0,3,11,21,3,4,7,12,19,4,8,1,7,30,25
98,Darren Collison,PG,26,LAC,80,35,2069,324,694,71,189,253,505,192,224,47,141,188,297,93,15,132,150,911
99,Nick Collison,PF,33,OKC,81,0,1353,134,241,4,17,130,224,66,93,116,177,293,104,30,28,71,187,338
100,Mike Conley,PG,26,MEM,73,73,2446,463,1030,105,291,358,739,225,276,41,172,213,441,110,13,150,141,1256
101,Chris Copeland,SF,29,IND,41,0,265,55,117,33,79,22,38,10,14,7,25,32,18,3,7,14,38,153
102,DeMarcus Cousins,C,23,SAC,71,71,2298,591,1191,0,7,591,1184,432,595,218,613,831,207,109,91,251,270,1614
103,Robert Covington,SF,23,HOU,7,0,34,6,14,4,11,2,3,0,0,2,3,5,0,2,0,1,3,16
104,Allen Crabbe,SG,21,POR,15,0,100,12,33,6,14,6,19,3,4,1,8,9,6,2,1,3,10,33
105,Jamal Crawford,SG,33,LAC,69,24,2094,421,1011,161,446,260,565,279,322,34,124,158,223,59,12,135,120,1282
107,Jae Crowder,SF,23,DAL,78,8,1254,130,296,50,151,80,145,46,61,46,148,194,60,59,21,41,100,356
108,Dante Cunningham,PF,26,MIN,81,7,1635,236,509,0,5,236,504,38,67,112,218,330,83,62,58,42,146,510
109,Jared Cunningham,SG,22,TOT,13,0,80,6,21,1,7,5,14,13,16,1,5,6,8,3,0,2,16,26
110,Seth Curry,PG,23,TOT,2,0,13,1,3,1,1,0,2,0,0,0,1,1,0,2,0,0,0,3
111,Stephen Curry,PG,25,GSW,78,78,2846,652,1383,261,615,391,768,308,348,46,288,334,666,128,14,294,194,1873
112,Samuel Dalembert,C,32,DAL,80,68,1614,214,377,0,1,214,376,101,137,200,341,541,38,41,94,90,210,529
113,Troy Daniels,SG,22,HOU,5,1,75,15,31,12,25,3,6,0,0,0,4,4,5,0,0,3,6,42
114,Luigi Datome,SF,26,DET,34,0,238,34,97,7,39,27,58,8,10,14,32,46,11,6,1,11,20,83
115,Brandon Davies,PF,22,PHI,51,0,575,54,128,2,10,52,118,34,53,38,71,109,28,24,8,35,92,144
116,Anthony Davis,PF,20,NOP,67,66,2358,522,1005,2,9,520,996,348,440,207,466,673,105,89,189,109,200,1394
117,Ed Davis,PF,24,MEM,63,4,956,155,290,0,0,155,290,47,89,92,168,260,27,17,43,40,114,357
118,Glen Davis,PF,28,TOT,68,44,1662,271,593,4,11,267,582,95,137,108,243,351,77,58,29,76,159,641
119,Austin Daye,SF,25,TOT,22,1,148,24,68,12,37,12,31,6,10,5,22,27,8,4,4,5,18,66
120,Nando De Colo,SF,26,TOT,47,3,494,64,153,18,53,46,100,31,35,14,59,73,65,22,6,35,48,177
121,Dewayne Dedmon,C,24,TOT,31,6,390,38,83,0,0,38,83,21,32,38,89,127,5,7,22,18,66,97
122,Matthew Dellavedova,SG,23,CLE,72,4,1271,122,296,57,155,65,141,38,48,29,94,123,187,33,5,60,121,339
123,Luol Deng,SF,28,TOT,63,63,2213,371,860,57,189,314,671,212,268,99,262,361,183,62,9,114,111,1011
124,DeMar DeRozan,SG,24,TOR,79,79,3017,604,1407,64,210,540,1197,519,630,51,292,343,313,86,28,176,197,1791
125,Boris Diaw,PF,31,SAS,79,24,1974,302,580,45,112,257,468,68,92,74,252,326,222,44,32,121,140,717
126,Gorgui Dieng,C,24,MIN,60,15,818,113,227,1,1,112,226,59,93,103,197,300,39,30,50,54,108,286
127,Toney Douglas,PG,27,TOT,51,17,675,73,190,31,102,42,88,25,34,18,69,87,68,19,5,34,81,202
128,Chris Douglas-Roberts,SF,27,CHA,49,8,1016,111,252,51,132,60,120,66,82,16,103,119,51,29,16,36,61,339
129,Goran Dragić,SG,27,PHO,76,75,2668,552,1093,122,299,430,794,316,416,69,176,245,447,104,22,213,206,1542
130,Andre Drummond,C,20,DET,81,81,2619,479,769,0,2,479,767,137,328,440,631,1071,35,101,131,110,273,1095
131,Jared Dudley,SF,28,LAC,74,43,1729,196,447,81,225,115,222,38,58,36,124,160,104,41,10,56,146,511
132,Tim Duncan,C,37,SAS,74,74,2158,444,906,0,5,444,901,231,316,158,563,721,220,43,139,159,134,1119
133,Mike Dunleavy,SF,33,CHI,82,61,2584,333,774,123,324,210,450,140,164,46,299,345,186,64,46,108,163,929
134,Kevin Durant,SF,25,OKC,81,81,3122,849,1688,192,491,657,1197,703,805,58,540,598,445,103,59,285,174,2593
135,Shane Edwards,SF,26,CLE,2,0,12,1,3,0,0,1,3,0,0,1,1,2,0,0,0,1,1,2
136,Wayne Ellington,SG,26,DAL,45,1,393,55,126,25,59,30,67,10,11,8,35,43,19,16,2,11,33,145
137,Monta Ellis,SG,28,DAL,82,82,3023,576,1278,69,209,507,1069,339,430,38,257,295,471,141,23,264,197,1560
138,Melvin Ely,C,35,NOP,2,0,27,3,6,0,0,3,6,0,0,0,1,1,0,0,1,0,5,6
139,Jeremy Evans,SF,26,UTA,66,4,1209,175,332,0,2,175,330,51,75,120,190,310,44,42,46,40,139,401
140,Reggie Evans,PF,33,TOT,54,20,899,71,150,0,0,71,150,72,130,115,219,334,21,37,3,58,119,214
141,Tyreke Evans,SF,24,NOP,72,22,2028,391,897,21,95,370,802,239,310,76,265,341,363,84,21,175,155,1042
142,Kenneth Faried,PF,24,DEN,80,77,2178,447,820,0,3,447,817,202,311,238,446,684,96,70,69,135,193,1096
143,Jordan Farmar,PG,27,LAL,41,5,912,151,364,70,160,81,204,44,59,20,84,104,199,38,8,95,65,416
144,Vítor Faverani,C,25,BOS,37,8,488,64,147,12,40,52,107,24,37,42,86,128,16,14,27,41,74,164
145,Derrick Favors,PF,22,UTA,73,73,2201,390,747,0,1,390,746,190,284,199,438,637,91,75,108,129,236,970
146,Carrick Felix,SG,23,CLE,7,0,38,7,14,2,5,5,9,3,4,1,5,6,4,0,0,4,4,19
147,Raymond Felton,PG,29,NYK,65,65,2017,240,608,62,195,178,413,88,122,54,143,197,365,78,27,129,157,630
148,Landry Fields,SF,25,TOR,30,2,322,27,67,0,5,27,62,14,22,15,44,59,20,10,3,11,25,68
149,Derek Fisher,SG,39,OKC,81,0,1428,141,361,88,229,53,132,55,71,12,110,122,117,70,3,49,157,425
150,Evan Fournier,SG,21,DEN,76,4,1503,228,544,89,237,139,307,93,123,34,168,202,112,34,7,100,179,638
151,Randy Foye,SG,30,DEN,81,78,2485,361,875,189,498,172,377,157,185,36,196,232,287,67,39,145,205,1068
152,Jamaal Franklin,SG,22,MEM,21,0,161,16,39,5,11,11,28,2,2,4,19,23,6,4,2,11,23,39
153,Jimmer Fredette,SG,24,TOT,49,0,519,107,227,40,84,67,143,19,21,8,44,52,64,14,3,48,35,273
154,Joel Freeland,C,26,POR,52,0,727,77,162,0,2,77,160,20,29,88,120,208,36,10,22,32,95,174
155,Channing Frye,PF,30,PHO,82,82,2312,336,778,160,432,176,346,78,95,73,343,416,98,60,63,89,245,910
156,Francisco García,SF,32,HOU,55,4,1083,118,294,69,193,49,101,10,19,21,101,122,63,27,33,30,120,315
157,Kevin Garnett,C,37,BRK,54,54,1109,157,356,0,3,157,353,38,47,60,298,358,82,43,40,69,123,352
158,Diante Garrett,PG,25,UTA,71,0,1048,101,265,36,96,65,169,10,12,11,86,97,120,41,5,75,75,248
159,Marc Gasol,C,29,MEM,59,59,1970,336,711,2,11,334,700,185,241,84,340,424,215,59,76,111,150,859
160,Pau Gasol,C,33,LAL,60,60,1884,425,885,4,14,421,871,187,254,124,456,580,201,27,92,141,124,1041
161,Rudy Gay,SF,27,TOT,73,73,2531,537,1179,65,197,472,982,318,387,113,324,437,209,95,56,224,171,1457
162,Alonzo Gee,SF,26,CLE,65,24,1020,98,236,19,58,79,178,43,61,35,114,149,47,39,15,44,96,258
163,Paul George,SF,23,IND,80,80,2898,577,1362,182,500,395,862,401,464,64,478,542,283,151,22,224,198,1737
164,Taj Gibson,PF,28,CHI,82,8,2351,429,896,0,7,429,889,211,281,200,358,558,91,41,112,150,207,1069
165,Manu Ginóbili,SG,36,SAS,68,3,1550,294,627,90,258,204,369,160,188,30,172,202,293,70,17,139,128,838
166,Rudy Gobert,C,21,UTA,45,0,434,36,74,0,0,36,74,32,65,51,104,155,7,8,41,32,57,104
167,Ryan Gomes,SF,31,OKC,5,0,34,3,8,0,2,3,6,0,0,0,4,4,1,0,0,1,5,6
168,Drew Gooden,C,32,WAS,22,0,395,76,143,7,17,69,126,24,27,37,77,114,15,10,7,17,53,183
169,Archie Goodwin,SG,19,PHO,52,0,533,76,167,5,36,71,131,37,55,25,62,87,20,20,11,44,45,194
170,Ben Gordon,SG,30,CHA,19,0,279,37,108,8,29,29,79,17,21,3,24,27,21,10,2,21,18,99
171,Eric Gordon,SG,25,NOP,64,64,2057,356,817,101,258,255,559,175,223,30,135,165,208,74,12,134,114,988
172,Marcin Gortat,C,29,WAS,81,80,2655,455,840,1,1,454,839,157,229,202,565,767,138,41,121,126,201,1068
173,Danny Granger,SF,30,TOT,41,2,847,116,307,43,128,73,179,63,67,31,102,133,41,12,17,46,62,338
174,Aaron Gray,C,29,TOT,37,6,355,27,61,0,1,27,60,11,20,42,69,111,22,10,8,31,64,65
175,Danny Green,SG,26,SAS,68,59,1651,218,505,132,318,86,187,50,63,25,204,229,104,65,61,76,107,618
176,Draymond Green,SF,23,GSW,82,12,1797,187,459,55,165,132,294,82,123,86,323,409,152,102,72,91,231,511
177,Gerald Green,SG,28,PHO,82,48,2330,448,1006,204,510,244,496,195,230,48,227,275,122,70,42,145,220,1295
178,Jeff Green,SF,27,BOS,82,82,2805,482,1171,135,396,347,775,283,356,54,326,380,138,57,47,165,180,1382
179,Willie Green,SG,32,LAC,55,9,869,102,271,41,121,61,150,28,34,12,66,78,50,22,11,34,96,273
180,Blake Griffin,PF,24,LAC,80,80,2863,718,1359,12,44,706,1315,482,674,192,565,757,309,92,51,224,265,1930
181,Jorge Gutiérrez,PG,25,BRK,15,2,244,25,54,3,12,22,42,9,12,3,19,22,30,10,1,14,37,62
182,Jordan Hamilton,SF,23,TOT,60,12,1019,147,376,70,198,77,178,40,51,32,162,194,52,44,20,46,67,404
183,Justin Hamilton,C,23,TOT,8,0,72,9,20,3,9,6,11,5,5,4,3,7,0,5,0,4,8,26
184,Tyler Hansbrough,PF,28,TOR,64,4,978,93,196,0,2,93,194,126,185,120,167,287,17,28,19,47,132,312
185,Tim Hardaway,SG,21,NYK,81,1,1875,294,687,130,358,164,329,106,128,19,102,121,66,44,7,47,144,824
186,James Harden,SG,24,HOU,73,73,2777,549,1205,177,483,372,722,576,665,61,283,344,446,115,29,265,177,1851
187,Maurice Harkless,SF,20,ORL,80,41,1950,224,483,59,154,165,329,85,143,69,195,264,80,97,50,86,140,592
188,Josh Harrellson,C,24,DET,32,0,317,38,82,12,31,26,51,5,7,30,46,76,15,6,15,10,44,93
189,Al Harrington,PF,33,WAS,34,0,511,82,207,34,100,48,107,27,35,15,65,80,28,14,0,34,72,225
190,Devin Harris,PG,30,DAL,40,0,818,96,254,31,101,65,153,92,115,8,77,85,178,28,2,59,72,315
191,Elias Harris,SF,24,LAL,2,0,11,0,1,0,0,0,1,0,0,1,0,1,1,1,0,0,0,0
192,Manny Harris,SG,24,LAL,9,0,180,28,70,7,20,21,50,10,12,7,27,34,11,4,1,9,10,73
193,Mike Harris,PF,30,UTA,20,0,225,29,61,0,2,29,59,26,27,15,18,33,5,16,7,11,36,84
194,Tobias Harris,PF,21,ORL,61,36,1850,332,716,32,126,300,590,197,244,88,336,424,82,41,24,78,143,893
195,Udonis Haslem,PF,33,MIA,46,18,653,74,146,0,0,74,146,25,44,42,133,175,13,11,15,24,79,173
196,Spencer Hawes,C,25,TOT,80,78,2470,403,883,128,308,275,575,119,152,131,529,660,240,44,94,173,237,1053
197,Chuck Hayes,C,30,TOT,61,1,754,56,130,0,1,56,129,20,25,69,141,210,35,34,12,33,95,132
198,Gordon Hayward,SF,23,UTA,77,77,2800,426,1032,85,280,341,752,311,381,62,329,391,400,110,40,212,155,1248
199,Gerald Henderson,SG,26,CHA,77,77,2461,403,930,40,115,363,815,235,309,31,279,310,199,51,32,113,159,1081
200,Xavier Henry,SF,22,LAL,43,5,908,144,345,28,81,116,264,116,177,25,89,114,51,44,7,57,79,432
201,John Henson,PF,23,MIL,70,23,1856,344,639,0,1,344,638,91,177,171,326,497,113,41,116,114,185,779
202,Roy Hibbert,C,27,IND,81,81,2409,331,754,2,5,329,749,207,269,202,336,538,91,29,182,148,269,871
203,J.J. Hickson,PF,25,DEN,69,52,1859,332,654,0,8,332,646,150,290,206,426,632,96,47,51,128,177,814
204,Nenê Hilário,PF,31,WAS,53,37,1560,299,594,1,5,298,589,155,266,65,229,294,153,64,47,117,164,754
205,George Hill,PG,27,IND,76,76,2434,272,616,95,260,177,356,142,176,53,230,283,265,75,23,92,158,781
206,Jordan Hill,PF,26,LAL,72,32,1500,286,521,0,1,286,520,124,181,194,341,535,54,29,64,75,172,696
207,Solomon Hill,SF,22,IND,28,0,226,17,40,7,23,10,17,6,7,9,32,41,12,5,2,13,19,47
208,Kirk Hinrich,PG,33,CHI,73,61,2116,243,619,85,242,158,377,95,125,31,161,192,286,80,26,120,203,666
209,Jrue Holiday,PG,23,NOP,34,34,1143,203,454,30,77,173,377,51,63,28,114,142,268,56,12,105,92,487
210,Ryan Hollins,PF,29,LAC,61,0,482,53,72,0,0,53,72,35,56,31,59,90,8,9,31,29,87,141
211,Scotty Hopson,SG,24,CLE,2,0,7,0,4,0,2,0,2,1,2,0,0,0,1,1,0,0,0,1
212,Al Horford,C,27,ATL,29,29,958,238,420,4,11,234,409,58,85,66,178,244,76,27,44,64,56,538
213,Dwight Howard,C,28,HOU,71,71,2396,473,800,2,7,471,793,349,638,231,635,866,131,60,128,229,240,1297
214,Robbie Hummel,SF,24,MIN,53,5,655,67,177,32,89,35,88,15,16,35,97,132,23,16,2,10,57,181
215,Kris Humphries,PF,28,BOS,69,30,1376,231,461,0,2,231,459,117,144,127,282,409,67,31,61,64,136,579
216,Serge Ibaka,PF,24,OKC,81,81,2666,524,978,23,60,501,918,156,199,224,485,709,85,39,219,123,233,1227
217,Andre Iguodala,SF,30,GSW,63,63,2040,220,458,62,175,158,283,86,132,53,240,293,263,95,18,100,103,588
218,Ersan İlyasova,PF,26,MIL,55,47,1478,237,579,37,131,200,448,107,130,107,235,342,72,46,8,61,135,618
219,Kyrie Irving,PG,21,CLE,71,71,2496,532,1237,123,344,409,893,291,338,52,207,259,433,108,23,190,163,1478
220,Royal Ivey,SG,32,OKC,2,0,5,0,2,0,1,0,1,0,0,0,1,1,0,0,0,0,1,0
221,Jarrett Jack,PG,30,CLE,80,31,2252,286,698,63,185,223,513,125,149,22,201,223,324,56,22,133,133,760
222,Reggie Jackson,PG,23,OKC,80,36,2277,403,916,83,245,320,671,158,177,43,270,313,331,85,9,168,142,1047
223,Stephen Jackson,SF,35,LAC,9,0,107,6,26,1,14,5,12,2,4,2,8,10,5,6,1,6,11,15
224,Bernard James,C,28,DAL,30,0,146,11,23,0,1,11,22,6,11,15,27,42,3,3,8,10,24,28
225,Damion James,SF,26,SAS,5,1,50,2,9,0,2,2,7,2,2,1,11,12,3,0,1,1,3,6
226,LeBron James,PF,29,MIA,77,77,2902,767,1353,116,306,651,1047,439,585,81,452,533,488,121,26,270,126,2089
227,Mike James,PG,38,CHI,11,0,77,5,21,1,5,4,16,0,2,0,7,7,17,2,0,5,11,11
228,Antawn Jamison,PF,37,LAC,22,0,248,29,92,8,41,21,51,18,25,9,46,55,7,9,3,7,29,84
229,Othyus Jeffers,SG,28,TOT,6,1,47,3,6,0,2,3,4,3,4,1,8,9,1,0,0,1,3,9
230,Al Jefferson,C,29,CHA,73,73,2553,700,1376,3,15,697,1361,191,277,156,636,792,155,67,79,124,176,1594
231,Richard Jefferson,SF,33,UTA,82,78,2213,294,654,123,301,171,353,120,162,18,201,219,130,56,14,94,168,831
232,John Jenkins,SG,22,ATL,13,0,158,16,42,4,18,12,24,4,4,3,19,22,11,1,1,11,11,40
233,Brandon Jennings,PG,24,DET,80,79,2728,423,1135,154,457,269,678,241,321,59,185,244,609,101,8,215,157,1241
234,Jonas Jerebko,PF,26,DET,64,0,741,98,208,31,74,67,134,43,59,51,124,175,39,21,6,43,85,270
235,Amir Johnson,PF,26,TOR,77,72,2214,344,612,20,66,324,546,91,143,172,333,505,115,56,88,123,271,799
236,Chris Johnson,SF,23,BOS,40,0,789,85,214,43,127,42,87,37,43,31,66,97,31,27,4,22,63,250
237,James Johnson,SF,26,MEM,52,4,956,143,308,22,87,121,221,76,90,60,106,166,111,42,57,66,102,384
238,Joe Johnson,SG,32,BRK,79,79,2575,462,1018,162,404,300,614,159,195,48,222,270,216,47,10,120,129,1245
239,Orlando Johnson,SG,24,TOT,45,0,392,36,113,9,47,27,66,19,26,9,46,55,20,6,2,15,26,100
240,Wesley Johnson,SF,26,LAL,79,62,2240,277,651,100,271,177,380,61,77,70,278,348,124,86,77,90,207,715
241,Darius Johnson-Odom,SG,24,PHI,3,0,15,0,7,0,3,0,4,0,2,0,2,2,1,1,0,2,3,0
242,James Jones,SF,33,MIA,20,6,236,31,68,28,54,3,14,7,11,2,21,23,9,3,4,4,6,97
243,Perry Jones,PF,22,OKC,62,7,764,83,181,22,61,61,120,28,42,28,86,114,26,14,19,21,62,216
244,Solomon Jones,PF,29,ORL,11,0,85,6,17,0,0,6,17,2,4,8,8,16,2,2,2,2,12,14
245,Terrence Jones,PF,22,HOU,76,71,2078,386,712,31,101,355,611,118,195,162,366,528,87,53,99,71,139,921
246,DeAndre Jordan,C,25,LAC,82,82,2870,348,515,0,0,348,515,160,374,331,783,1114,74,80,203,123,264,856
247,Cory Joseph,SG,22,SAS,68,19,936,126,265,12,38,114,227,79,96,32,75,107,114,35,14,43,84,343
248,Chris Kaman,C,31,LAL,39,13,736,176,346,0,3,176,343,52,68,54,175,229,58,11,40,74,93,404
249,Enes Kanter,C,21,UTA,80,37,2138,419,853,0,1,419,852,149,204,222,376,598,75,28,42,144,230,987
250,Sergey Karasev,SF,20,CLE,22,1,156,12,35,4,19,8,16,9,10,0,16,16,6,3,1,11,22,37
251,Ryan Kelly,PF,22,LAL,59,25,1312,157,371,48,142,109,229,110,135,42,177,219,95,32,45,47,147,472
252,Michael Kidd-Gilchrist,SF,20,CHA,62,62,1502,167,353,1,9,166,344,113,184,109,215,324,52,43,39,60,145,448
253,Andrei Kirilenko,PF,32,BRK,45,4,857,82,160,1,5,81,155,61,119,55,91,146,72,40,19,54,65,226
254,Brandon Knight,PG,22,MIL,72,69,2400,461,1092,110,338,351,754,259,323,46,209,255,352,69,17,188,146,1291
255,Kyle Korver,SG,32,ATL,71,71,2408,289,609,185,392,104,217,87,94,22,260,282,208,70,24,102,147,850
256,Kosta Koufos,C,24,MEM,80,22,1349,227,459,0,0,227,459,60,93,160,258,418,39,32,71,67,182,514
257,Viacheslav Kravtsov,C,26,PHO,20,0,59,8,15,0,0,8,15,4,8,9,8,17,1,0,1,6,7,20
258,Ognjen Kuzmić,C,23,GSW,21,0,92,5,13,0,0,5,13,5,11,10,11,21,2,3,4,10,17,15
259,Doron Lamb,SG,22,ORL,53,0,695,63,160,36,90,27,70,29,36,8,41,49,43,11,1,27,54,191
260,Jeremy Lamb,SG,21,OKC,78,0,1538,263,609,88,247,175,362,51,64,27,162,189,115,56,26,61,143,665
261,Carl Landry,PF,30,SAC,18,1,233,31,60,0,0,31,60,14,17,15,42,57,5,3,1,9,34,76
262,Shane Larkin,PG,21,DAL,48,0,489,52,137,12,38,40,99,16,25,11,31,42,71,26,1,39,46,132
263,Ty Lawson,PG,26,DEN,62,61,2222,347,806,72,202,275,604,324,406,40,175,215,543,100,10,200,113,1090
264,Ricky Ledo,SG,21,DAL,11,0,33,6,17,3,8,3,9,4,4,0,2,2,2,1,0,2,2,19
265,Courtney Lee,SG,28,TOT,79,47,1973,295,614,72,194,223,420,99,112,29,158,187,115,65,28,73,127,761
266,David Lee,PF,30,GSW,69,67,2288,513,981,0,1,513,980,231,296,182,461,643,147,48,26,152,206,1257
267,Alex Len,C,20,PHO,42,3,362,33,78,0,0,33,78,20,31,39,60,99,4,4,18,26,68,86
268,Kawhi Leonard,SF,22,SAS,66,65,1923,337,645,69,182,268,463,101,126,76,336,412,133,114,50,80,127,844
269,Meyers Leonard,C,21,POR,40,0,355,41,91,0,6,41,85,16,21,26,85,111,18,7,5,15,76,98
270,Jon Leuer,PF,24,MEM,49,0,642,121,246,23,49,98,197,37,47,37,121,158,20,18,13,27,63,302
271,Rashard Lewis,SF,34,MIA,60,6,971,98,236,46,134,52,102,26,33,24,86,110,57,53,8,35,90,268
272,DeAndre Liggins,SG,25,MIA,1,0,1,1,1,0,0,1,1,0,0,1,0,1,0,0,0,0,0,2
273,Damian Lillard,PG,23,POR,82,82,2937,553,1304,218,554,335,750,371,426,35,253,288,457,64,22,193,197,1695
274,Jeremy Lin,PG,25,HOU,71,33,2054,295,662,82,229,213,433,218,265,34,153,187,294,68,27,176,166,890
275,Shaun Livingston,PG,28,BRK,76,54,1974,235,487,1,6,234,481,158,191,67,179,246,245,93,31,105,172,629
276,Brook Lopez,C,25,BRK,17,17,533,129,229,0,1,129,228,94,115,39,63,102,16,9,30,28,52,352
277,Robin Lopez,C,25,POR,82,82,2603,355,644,0,1,355,643,198,242,326,374,700,73,25,139,84,196,908
278,Kevin Love,PF,25,MIN,77,77,2797,650,1421,190,505,460,916,520,633,224,739,963,341,59,35,196,136,2010
279,Kyle Lowry,PG,27,TOR,79,79,2862,457,1080,190,500,267,580,313,385,88,281,369,586,121,15,194,267,1417
280,John Lucas III,PG,31,UTA,42,6,591,62,190,25,84,37,106,10,16,12,27,39,42,14,0,22,41,159
281,Shelvin Mack,PG,23,ATL,73,11,1490,209,501,62,184,147,317,64,74,21,139,160,271,50,2,89,100,544
282,Ian Mahinmi,C,27,IND,77,1,1248,91,189,0,1,91,188,90,145,107,150,257,24,41,72,58,207,272
283,Shawn Marion,SF,35,DAL,76,76,2409,341,708,58,162,283,546,51,65,132,365,497,124,90,37,95,125,791
284,Kendall Marshall,PG,22,LAL,54,45,1564,170,419,71,178,99,241,19,36,15,140,155,477,48,4,150,76,430
285,Cartier Martin,SF,29,TOT,59,6,870,111,264,59,151,52,113,48,65,13,97,110,33,27,7,34,71,329
286,Kenyon Martin,PF,36,NYK,32,15,633,63,123,0,1,63,122,11,19,36,98,134,50,25,27,26,85,137
287,Kevin Martin,SG,30,MIN,68,68,2177,440,1023,115,297,325,726,303,340,34,169,203,121,66,6,106,123,1298
288,Roger Mason,SG,33,MIA,25,2,260,25,67,17,48,8,19,7,7,1,21,22,19,6,1,9,26,74
289,Wesley Matthews,SG,27,POR,82,82,2780,445,1009,201,511,244,498,252,301,51,238,289,197,76,14,110,176,1343
290,Jason Maxiell,PF,30,ORL,34,13,488,47,105,0,0,47,105,15,31,28,58,86,9,8,20,14,47,109
291,Eric Maynor,PG,26,TOT,31,0,327,32,101,12,37,20,64,6,11,9,30,39,52,9,3,29,17,82
292,O.J. Mayo,SG,26,MIL,52,23,1346,224,550,84,227,140,323,76,88,24,100,124,113,28,13,95,111,608
294,Ray McCallum,PG,22,SAC,45,10,897,113,300,22,59,91,241,32,43,18,61,79,120,22,9,39,69,280
295,CJ McCollum,SG,22,POR,38,0,476,74,178,30,80,44,98,23,34,7,41,48,27,14,2,35,53,201
296,JaVale McGee,C,26,DEN,5,5,79,17,38,0,0,17,38,1,1,10,7,17,2,1,7,8,16,35
297,Ben McLemore,SG,20,SAC,82,55,2187,255,679,95,297,160,382,115,143,53,182,235,82,45,18,96,201,720
298,Josh McRoberts,PF,26,CHA,78,78,2360,247,566,105,291,142,275,62,85,85,288,373,333,58,46,83,189,661
299,Jodie Meeks,SG,26,LAL,77,70,2556,413,892,162,404,251,488,221,258,30,164,194,138,111,4,111,119,1209
300,Gal Mekel,PG,25,DAL,31,1,292,30,86,5,20,25,66,8,12,5,22,27,63,4,1,31,31,73
301,Khris Middleton,SF,22,MIL,82,64,2460,376,854,120,290,256,564,118,137,60,250,310,169,83,20,123,243,990
302,C.J. Miles,SG,26,CLE,51,34,984,178,409,83,211,95,198,64,75,18,85,103,52,46,15,44,103,503
303,Andre Miller,SG,37,TOT,58,2,982,106,231,11,21,95,210,60,77,28,102,130,197,34,9,61,75,283
304,Darius Miller,SF,23,NOP,45,7,723,73,166,25,77,48,89,29,36,9,43,52,43,24,9,22,88,200
305,Mike Miller,SF,33,MEM,82,4,1707,213,443,107,233,106,210,46,56,30,177,207,130,26,5,77,95,579
306,Quincy Miller,PF,21,DEN,52,16,789,94,256,30,94,64,162,39,55,36,111,147,26,22,32,48,70,257
307,Patty Mills,PG,25,SAS,81,2,1527,309,666,135,318,174,348,73,82,34,135,169,149,68,9,63,114,826
308,Paul Millsap,PF,28,ATL,74,73,2482,483,1047,76,212,407,835,286,391,154,473,627,232,129,78,185,210,1328
309,Tony Mitchell,PF,21,DET,21,0,79,5,12,1,1,4,11,11,19,15,11,26,2,6,3,4,9,22
311,Nazr Mohammed,C,36,CHI,80,1,562,54,126,0,0,54,126,16,30,66,109,175,20,14,30,37,77,124
312,Greg Monroe,PF,23,DET,82,82,2690,504,1015,0,1,504,1014,241,367,256,504,760,171,91,47,166,205,1249
313,E'Twaun Moore,SG,24,ORL,79,3,1506,195,456,57,161,138,295,52,68,29,107,136,112,60,13,55,106,499
314,Darius Morris,PG,23,TOT,27,0,313,39,96,12,38,27,58,17,26,7,19,26,44,13,0,27,33,107
315,Marcus Morris,SF,24,PHO,82,1,1800,288,651,99,260,189,391,121,159,84,235,319,88,72,18,95,157,796
316,Markieff Morris,PF,24,PHO,81,0,2153,411,845,34,108,377,737,259,327,139,346,485,144,68,51,147,232,1115
317,Anthony Morrow,SG,28,NOP,76,9,1426,238,520,88,195,150,325,72,87,29,111,140,59,38,12,51,102,636
318,Donatas Motiejūnas,PF,23,HOU,62,3,952,131,296,21,84,110,212,58,96,60,165,225,34,20,21,49,132,341
319,Arnett Moultrie,PF,23,PHI,12,2,187,16,38,0,0,16,38,4,5,11,24,35,2,8,4,7,22,36
320,Timofey Mozgov,C,27,DEN,82,30,1770,285,545,4,24,281,521,196,260,171,357,528,62,27,100,122,213,770
321,Shabazz Muhammad,SG,21,MIN,37,0,290,57,124,3,11,54,113,26,40,24,29,53,6,8,1,16,24,143
322,Byron Mullens,C,24,TOT,45,0,414,73,165,33,89,40,76,10,20,24,68,92,14,15,11,27,64,189
323,Erik Murphy,C,23,CHI,24,0,62,3,13,0,3,3,10,0,0,2,6,8,2,0,4,2,7,6
324,Toure' Murry,PG,24,NYK,51,0,373,56,129,5,12,51,117,23,39,13,31,44,49,19,1,34,46,140
325,Mike Muscala,PF,22,ATL,20,0,215,31,73,0,3,31,70,14,14,17,35,52,7,3,10,12,29,76
326,Hamady N'Diaye,C,27,SAC,14,0,74,3,9,0,0,3,9,0,1,5,13,18,3,0,4,3,15,6
327,Steve Nash*,PG,39,LAL,15,10,313,36,94,8,24,28,70,22,24,4,25,29,86,7,2,31,18,102
328,Gary Neal,SG,29,TOT,52,3,1114,193,471,68,180,125,291,94,105,10,80,90,83,18,0,64,65,548
329,Nemanja Nedović,SG,22,GSW,24,0,142,8,39,3,18,5,21,7,8,3,12,15,13,0,1,13,13,26
330,Jameer Nelson,PG,31,ORL,68,68,2179,294,747,136,391,158,356,96,112,29,202,231,476,52,5,166,146,820
331,Andrew Nicholson,PF,24,ORL,76,5,1174,180,420,28,89,152,331,47,57,53,202,255,25,18,23,51,150,435
332,Joakim Noah,C,28,CHI,80,80,2820,380,800,0,2,380,798,247,335,282,618,900,431,99,121,194,245,1007
333,Steve Novak,PF,30,TOR,54,1,540,60,146,52,122,8,24,6,6,8,50,58,13,12,4,5,44,178
334,Dirk Nowitzki,PF,35,DAL,80,80,2628,633,1273,131,329,502,944,338,376,40,458,498,216,73,45,117,165,1735
335,James Nunnally,SF,23,TOT,13,0,165,15,46,8,25,7,21,6,9,1,18,19,8,6,2,7,11,44
336,Jermaine O'Neal,PF,35,GSW,44,13,883,125,248,0,0,125,248,99,132,85,157,242,25,14,40,52,102,349
337,Kyle O'Quinn,C,23,ORL,69,19,1188,186,371,0,3,186,368,57,83,100,264,364,78,39,88,78,165,429
338,Greg Oden,C,26,MIA,23,6,212,27,49,0,0,27,49,13,23,23,31,54,1,7,13,12,52,67
339,Victor Oladipo,PG,21,ORL,80,44,2487,392,936,74,226,318,710,248,318,43,286,329,327,129,37,256,210,1106
340,Kelly Olynyk,C,22,BOS,70,9,1400,234,502,40,114,194,388,99,122,140,225,365,109,35,27,106,227,607
341,Arinze Onuaku,PF,26,TOT,5,0,30,1,5,0,0,1,5,1,2,2,6,8,3,0,0,1,3,3
342,Daniel Orton,C,23,PHI,22,4,251,21,47,0,0,21,47,23,30,16,45,61,15,6,16,18,38,65
343,Travis Outlaw,SF,29,SAC,63,4,1065,130,326,41,117,89,209,42,52,36,132,168,48,20,19,26,94,343
344,Zaza Pachulia,C,29,MIL,53,43,1325,149,349,0,1,149,348,110,130,141,192,333,136,45,14,92,124,408
345,Jannero Pargo,PG,34,CHA,29,0,242,52,118,24,60,28,58,8,11,1,19,20,52,14,1,26,17,136
346,Tony Parker,PG,31,SAS,68,68,1997,456,914,25,67,431,847,197,243,17,138,155,388,36,9,151,86,1134
347,Chandler Parsons,SF,25,HOU,74,74,2783,466,987,130,351,336,636,164,221,69,340,409,298,88,29,144,168,1226
348,Patrick Patterson,PF,24,TOT,65,13,1533,225,489,55,151,170,338,50,71,117,225,342,78,55,37,65,159,555
349,Chris Paul,PG,28,LAC,62,62,2171,406,870,78,212,328,658,295,345,38,230,268,663,154,4,145,157,1185
350,Nikola Peković,C,28,MIN,54,54,1663,379,701,0,0,379,701,186,249,206,262,468,50,30,23,84,129,944
351,Kendrick Perkins,C,29,OKC,62,62,1207,87,193,0,1,87,192,37,67,82,223,305,67,26,32,90,177,211
352,Paul Pierce,SF,36,BRK,75,68,2098,321,712,112,300,209,412,256,310,26,322,348,178,86,31,153,190,1010
353,Dexter Pittman,C,25,ATL,2,0,3,0,1,0,0,0,1,0,2,3,0,3,0,0,0,0,0,0
354,Mason Plumlee,C,23,BRK,70,22,1275,199,302,0,3,199,299,122,195,99,209,308,60,49,55,77,171,520
355,Miles Plumlee,C,25,PHO,80,79,1964,286,553,0,0,286,553,74,132,198,428,626,43,50,90,111,185,646
356,Quincy Pondexter,SG,25,MEM,15,2,270,31,79,11,34,20,45,21,26,10,16,26,20,5,1,15,18,94
357,Otto Porter,SF,20,WAS,37,0,319,33,91,4,21,29,70,8,12,21,36,57,10,8,1,14,26,78
358,Josh Powell,PF,31,HOU,1,0,19,2,6,0,0,2,6,0,0,0,5,5,0,0,1,1,1,4
359,Phil Pressey,PG,22,BOS,75,11,1132,78,253,28,106,50,147,29,45,20,85,105,241,68,5,87,97,213
360,A.J. Price,SG,27,MIN,28,0,99,19,46,6,22,13,24,0,2,1,9,10,13,1,0,7,5,44
361,Ronnie Price,SG,30,ORL,31,2,377,28,92,9,43,19,49,9,13,8,35,43,66,25,2,26,50,74
362,Pablo Prigioni,PG,36,NYK,66,27,1283,88,191,65,140,23,51,11,12,36,93,129,228,67,2,60,132,252
363,Tayshaun Prince,SF,33,MEM,76,76,1948,200,492,20,69,180,423,34,60,32,202,234,119,39,19,41,63,454
364,Miroslav Raduljica,C,26,MIL,48,2,465,68,126,0,0,68,126,45,55,54,54,108,23,7,13,28,84,181
365,Anthony Randolph,PF,24,DEN,43,5,527,68,176,18,61,50,115,52,69,20,102,122,32,26,19,39,64,206
366,Shavlik Randolph,PF,30,PHO,14,0,95,7,14,0,0,7,14,6,11,7,18,25,1,3,1,5,15,20
367,Zach Randolph,PF,32,MEM,79,79,2705,560,1198,2,20,558,1178,250,337,265,530,795,200,54,23,183,210,1372
368,J.J. Redick,SG,29,LAC,35,34,987,181,398,73,185,108,213,97,106,9,65,74,78,28,3,42,65,532
369,Glen Rice,SG,23,WAS,11,1,109,11,37,5,17,6,20,5,7,4,16,20,7,6,1,9,7,32
370,Luke Ridnour,PG,32,TOT,61,14,1141,126,327,37,108,89,219,17,26,23,74,97,176,32,8,66,92,306
371,Austin Rivers,PG,21,NOP,69,4,1339,192,474,36,99,156,375,110,173,26,103,129,160,45,9,77,134,530
372,Andre Roberson,SG,22,OKC,40,16,399,33,68,2,13,31,55,7,10,36,58,94,15,19,10,19,74,75
373,Brian Roberts,PG,28,NOP,72,42,1667,244,581,64,178,180,403,125,133,17,119,136,234,43,7,95,132,677
374,Nate Robinson,PG,29,DEN,44,1,866,164,383,58,154,106,229,71,85,21,60,81,112,36,4,58,92,457
375,Thomas Robinson,PF,22,POR,70,0,873,141,293,0,1,141,292,57,101,105,202,307,34,23,20,57,131,339
376,Rajon Rondo,PG,27,BOS,30,30,998,141,350,26,90,115,260,42,67,22,142,164,294,40,2,99,65,350
377,Derrick Rose,PG,25,CHI,10,10,311,58,164,16,47,42,117,27,32,9,23,32,43,5,1,34,15,159
378,Terrence Ross,SG,22,TOR,81,62,2159,318,751,161,408,157,343,82,98,43,209,252,79,64,27,88,183,879
379,Ricky Rubio,PG,23,MIN,82,82,2638,255,670,44,133,211,537,227,283,61,281,342,704,191,11,221,218,781
380,Brandon Rush,SG,28,UTA,38,0,418,30,90,16,47,14,43,3,5,5,39,44,24,5,9,20,31,79
381,Robert Sacre,C,24,LAL,65,13,1089,143,300,0,0,143,300,64,94,82,172,254,51,24,47,44,134,350
383,Larry Sanders,C,25,MIL,23,20,584,76,162,0,1,76,161,26,55,60,105,165,19,18,40,26,74,178
384,Dennis Schröder,PG,20,ATL,49,0,641,72,188,10,42,62,146,29,43,5,55,60,93,17,0,61,54,183
385,Luis Scola,PF,33,IND,82,2,1399,263,560,1,7,262,553,99,136,86,305,391,81,26,16,108,164,626
386,Mike Scott,PF,25,ATL,80,6,1482,301,628,62,200,239,428,103,132,62,222,284,75,30,7,79,121,767
387,Thabo Sefolosha,SG,29,OKC,61,61,1584,141,340,48,152,93,188,53,69,50,170,220,94,79,17,55,90,383
388,Kevin Séraphin,C,24,WAS,53,1,578,111,220,0,0,111,220,27,31,53,75,128,17,3,26,41,103,249
389,Ramon Sessions,PG,27,TOT,83,19,2214,330,769,35,124,295,645,326,404,38,165,203,340,49,9,148,90,1021
390,Mustafa Shakur,PG,29,OKC,3,0,11,0,3,0,1,0,2,1,2,0,0,0,4,0,0,2,2,1
391,Tornike Shengelia,SF,22,TOT,26,0,154,13,28,0,6,13,22,3,8,4,12,16,14,3,1,12,18,29
392,Iman Shumpert,SG,23,NYK,74,58,1962,183,484,76,228,107,256,53,71,81,227,308,129,92,13,79,209,495
393,Alexey Shved,SG,25,MIN,63,0,664,76,237,30,102,46,135,68,90,21,60,81,68,26,16,48,36,250
394,Henry Sims,C,23,TOT,46,25,875,130,274,0,1,130,273,90,121,104,133,237,52,28,20,41,116,350
395,Kyle Singler,SF,25,DET,82,36,2337,269,602,94,246,175,356,152,184,116,187,303,75,61,38,79,211,784
396,Chris Singleton,SF,24,WAS,25,0,250,25,67,7,19,18,48,18,25,18,37,55,6,9,3,17,25,75
397,Peyton Siva,SG,23,DET,24,0,224,18,57,7,25,11,32,11,15,2,12,14,34,9,1,18,27,54
398,Donald Sloan,SG,26,IND,48,1,392,44,117,10,42,34,75,12,20,4,40,44,50,10,1,22,19,110
399,Chris Smith,PG,26,NYK,2,0,2,0,0,0,0,0,0,0,0,0,0,0,0,0,0,0,0,0
400,Greg Smith,C,23,HOU,11,0,100,18,28,0,0,18,28,2,5,11,16,27,0,1,2,5,17,38
401,Ish Smith,PG,25,PHO,70,1,1006,119,281,1,23,118,258,22,39,31,98,129,179,49,13,65,66,261
402,J.R. Smith,SF,28,NYK,74,37,2421,396,955,189,480,207,475,90,138,35,261,296,219,65,20,108,196,1071
403,Jason Smith,PF,27,NOP,31,27,830,131,282,0,0,131,282,39,50,51,130,181,29,11,29,28,100,301
404,Josh Smith,SF,28,DET,77,76,2730,517,1233,70,265,447,968,160,301,102,418,520,252,105,110,199,197,1264
405,Tony Snell,SG,22,CHI,77,12,1231,129,336,57,178,72,158,31,41,19,105,124,68,29,15,44,84,346
406,James Southerland,SF,23,TOT,4,0,30,5,15,3,6,2,9,1,2,0,8,8,0,1,2,1,3,14
407,Marreese Speights,C,26,GSW,79,3,982,195,442,8,31,187,411,110,134,101,189,290,32,10,34,66,148,508
408,Tiago Splitter,C,29,SAS,59,50,1271,181,346,0,3,181,343,121,173,123,240,363,90,29,31,75,117,483
409,D.J. Stephens,SG,23,MIL,3,0,15,3,7,0,0,3,7,1,1,1,4,5,0,0,0,0,0,7
410,Lance Stephenson,SG,23,IND,78,78,2752,427,870,86,244,341,626,140,197,95,463,558,359,54,7,210,195,1080
411,Greg Stiemsma,C,28,NOP,55,20,1007,70,122,0,1,70,121,19,32,72,154,226,36,35,57,44,169,159
412,Julyan Stone,SG,25,TOR,21,0,120,7,17,2,8,5,9,2,3,2,18,20,12,3,0,5,13,18
413,Amar'e Stoudemire,C,31,NYK,65,21,1466,311,558,0,0,311,558,150,203,112,208,320,34,23,37,91,159,772
414,Rodney Stuckey,SG,27,DET,73,5,1950,372,853,24,88,348,765,244,292,39,130,169,152,54,10,125,131,1012
415,Jared Sullinger,PF,21,BOS,74,44,2041,384,899,56,208,328,691,158,203,241,360,601,118,35,49,119,251,982
416,Jeffery Taylor,SF,24,CHA,26,8,629,82,218,18,67,64,151,26,47,15,45,60,22,13,5,25,62,208
417,Tyshawn Taylor,PG,23,BRK,23,3,270,31,91,3,12,28,79,24,30,3,12,15,36,12,1,31,29,89
418,Jeff Teague,PG,25,ATL,79,79,2542,456,1040,74,225,382,815,318,376,34,174,208,528,89,17,232,158,1304
419,Marquis Teague,SG,20,TOT,40,3,443,38,119,5,18,33,101,26,35,1,39,40,58,10,5,39,46,107
420,Mirza Teletović,SF,28,BRK,72,7,1396,221,529,136,349,85,180,44,62,60,206,266,57,29,23,54,143,622
421,Garrett Temple,SG,27,WAS,75,0,638,51,141,6,29,45,112,30,43,21,47,68,72,35,11,42,72,138
422,Jason Terry,PG,36,BRK,35,0,570,55,152,39,103,16,49,10,15,4,33,37,56,13,0,27,48,159
423,Hasheem Thabeet,C,26,OKC,23,0,192,13,23,0,0,13,23,1,5,9,31,40,1,4,9,14,47,27
424,Adonis Thomas,SF,20,TOT,6,1,37,6,14,1,5,5,9,1,1,0,3,3,3,0,0,1,6,14
425,Isaiah Thomas,PG,24,SAC,72,54,2497,496,1096,127,364,369,732,346,407,47,163,210,454,93,8,213,185,1465
426,Lance Thomas,SF,25,NOP,5,0,42,2,9,0,0,2,9,2,4,2,5,7,3,0,0,2,4,6
427,Malcolm Thomas,PF,25,TOT,8,0,63,7,16,1,4,6,12,0,2,5,16,21,2,0,3,9,5,15
428,Hollis Thompson,SF,22,PHI,77,41,1742,171,372,67,167,104,205,52,73,73,174,247,73,53,12,60,144,461
429,Jason Thompson,PF,27,SAC,82,61,2007,251,496,0,0,251,496,84,145,153,374,527,53,32,56,95,251,586
430,Klay Thompson,SG,23,GSW,81,81,2868,559,1259,223,535,336,724,147,185,38,211,249,181,74,37,135,234,1488
431,Tristan Thompson,PF,22,CLE,82,82,2594,363,761,0,1,363,760,235,339,269,485,754,72,42,35,108,188,961
432,Marcus Thornton,SG,26,TOT,72,27,1741,252,639,109,316,143,323,90,112,57,141,198,77,58,11,67,110,703
433,Jamaal Tinsley,PG,35,UTA,8,5,110,4,20,1,15,3,5,0,0,2,9,11,23,2,0,9,10,9
434,Anthony Tolliver,PF,28,CHA,64,9,1298,129,307,102,247,27,60,33,41,33,135,168,42,19,15,23,82,393
435,P.J. Tucker,SF,28,PHO,81,81,2490,265,615,74,191,191,424,156,201,161,368,529,141,110,23,102,204,760
436,Ronny Turiaf,C,31,MIN,31,10,606,64,107,0,0,64,107,21,50,55,119,174,24,8,50,24,65,149
437,Hedo Türkoğlu,SF,34,LAC,38,0,392,42,109,22,50,20,59,9,18,11,78,89,33,19,10,16,50,115
438,Evan Turner,SF,25,TOT,81,56,2457,434,1021,50,156,384,865,213,262,62,346,408,262,67,7,189,195,1131
439,Jeremy Tyler,C,22,NYK,41,0,398,60,116,0,0,60,116,26,48,38,71,109,8,6,20,26,70,146
440,Ekpe Udoh,PF,26,MIL,42,14,804,57,143,0,0,57,143,30,47,61,87,148,31,15,44,38,96,144
441,Beno Udrih,SG,31,TOT,41,12,643,78,178,19,42,59,136,25,30,10,49,59,116,23,4,47,50,200
442,Jonas Valančiūnas,C,21,TOR,81,81,2282,359,676,0,1,359,675,198,260,226,488,714,57,24,71,136,249,916
443,Anderson Varejão,C,31,CLE,65,29,1800,227,459,0,7,227,452,92,135,187,442,629,140,69,39,72,164,546
444,Jarvis Varnado,PF,25,TOT,24,0,339,36,60,0,0,36,60,27,52,19,44,63,13,10,29,10,62,99
446,Jan Veselý,PF,23,TOT,54,1,776,89,173,0,0,89,173,19,56,81,110,191,21,53,35,36,121,197
447,Charlie Villanueva,PF,29,DET,20,0,180,35,92,14,56,21,36,8,14,6,28,34,6,4,5,7,16,92
448,Nikola Vučević,C,23,ORL,57,57,1812,353,696,0,0,353,696,105,137,185,441,626,104,60,47,112,169,811
449,Sasha Vujačić,SG,29,LAC,2,0,10,2,5,1,2,1,3,0,0,0,3,3,0,1,0,3,1,5
450,Dwyane Wade,SG,32,MIA,54,53,1775,415,761,9,32,406,729,189,258,60,181,241,252,79,29,161,106,1028
451,Dion Waiters,SG,22,CLE,70,24,2072,430,993,92,250,338,743,161,235,32,163,195,209,63,17,154,153,1113
452,Kemba Walker,PG,23,CHA,73,73,2614,449,1143,109,327,340,816,282,337,39,267,306,447,86,32,169,128,1289
453,John Wall,PG,23,WAS,82,82,2980,579,1337,108,308,471,1029,317,394,38,295,333,721,149,40,295,219,1583
454,Gerald Wallace,SF,31,BOS,58,16,1416,116,230,19,64,97,166,47,101,36,176,212,143,73,14,97,79,298
455,Casper Ware,PG,24,PHI,9,0,116,18,42,7,21,11,21,5,6,0,9,9,10,8,0,5,11,48
456,C.J. Watson,PG,29,IND,63,5,1193,146,334,53,145,93,189,69,88,19,82,101,107,60,8,60,66,414
457,Earl Watson,PG,34,POR,24,0,161,3,11,2,7,1,4,4,4,5,10,15,28,5,1,17,33,12
458,Maalik Wayns,PG,22,LAC,2,0,9,1,2,0,0,1,2,0,0,0,2,2,2,2,0,0,4,2
459,Martell Webster,SF,27,WAS,78,13,2157,254,587,146,372,108,215,105,125,38,184,222,97,41,15,58,150,759
460,David West,PF,33,IND,80,80,2472,458,939,4,15,454,924,198,251,120,422,542,223,61,74,133,186,1118
461,Russell Westbrook,PG,25,OKC,46,46,1412,346,791,68,214,278,577,242,293,55,208,263,319,88,7,177,104,1002
462,D.J. White,PF,27,CHA,2,0,10,0,1,0,0,0,1,0,0,0,2,2,0,1,0,0,1,0
463,Royce White,PF,22,SAC,3,0,9,0,1,0,0,0,1,0,0,0,0,0,0,0,0,0,2,0
464,Deron Williams,PG,29,BRK,64,58,2059,322,716,98,268,224,448,173,216,15,153,168,392,93,13,143,148,915
466,Elliot Williams,SG,24,PHI,67,2,1157,140,337,37,125,103,212,87,119,30,100,130,72,35,3,68,126,404
467,Lou Williams,PG,27,ATL,60,7,1445,197,493,79,231,118,262,152,179,10,114,124,210,45,4,92,65,625
468,Marvin Williams,PF,27,UTA,66,50,1674,231,526,84,234,147,292,57,73,82,252,334,78,54,31,53,151,603
469,Mo Williams,PG,31,POR,74,0,1834,280,672,83,225,197,447,78,89,42,111,153,321,55,10,149,197,721
470,Reggie Williams,SF,27,OKC,3,0,17,5,9,1,3,4,6,0,0,0,0,0,1,1,0,2,1,11
471,Shawne Williams,PF,27,LAL,36,13,751,73,192,42,129,31,63,14,20,25,142,167,30,19,30,21,93,202
472,Jeff Withey,C,23,NOP,58,4,684,69,129,0,1,69,128,52,73,49,101,150,26,15,50,20,73,190
473,Nate Wolters,PG,22,MIL,58,31,1309,170,389,18,62,152,327,59,90,33,116,149,187,35,15,57,67,417
474,Metta World Peace,SF,34,NYK,29,1,388,56,141,17,54,39,87,10,16,18,41,59,17,24,8,19,44,139
475,Brandan Wright,C,26,DAL,58,0,1077,224,331,0,0,224,331,77,106,102,142,244,31,32,55,35,94,525
476,Chris Wright,SF,25,MIL,8,0,126,21,35,0,1,21,34,6,15,10,10,20,5,7,5,5,17,48
477,Dorell Wright,SF,28,POR,68,13,984,111,297,69,202,42,95,52,69,29,162,191,64,23,16,39,62,343
478,Tony Wroten,PG,20,PHI,72,16,1765,345,808,40,188,305,620,209,326,69,159,228,217,78,16,204,151,939
479,Nick Young,SG,28,LAL,64,9,1810,387,889,135,350,252,539,235,285,29,137,166,95,46,12,95,156,1144
480,Thaddeus Young,PF,25,PHI,79,78,2718,582,1283,90,292,492,991,163,229,166,310,476,182,167,36,165,213,1417
481,Cody Zeller,C,21,CHA,82,3,1416,172,404,0,1,172,403,146,200,118,235,353,92,40,41,87,170,490
482,Tyler Zeller,C,24,CLE,70,9,1049,156,290,0,1,156,289,87,121,103,179,282,36,18,38,60,137,399
1,Quincy Acy,PF,24,NYK,68,22,1287,152,331,18,60,134,271,76,97,79,222,301,68,27,22,60,147,398
2,Jordan Adams,SG,20,MEM,30,0,248,35,86,10,25,25,61,14,23,9,19,28,16,16,7,14,24,94
3,Steven Adams,C,21,OKC,70,67,1771,217,399,0,2,217,397,103,205,199,324,523,66,38,86,99,222,537
4,Jeff Adrien,PF,28,MIN,17,0,215,19,44,0,0,19,44,22,38,23,54,77,15,4,9,9,30,60
5,Arron Afflalo,SG,29,TOT,78,72,2502,375,884,118,333,257,551,167,198,27,220,247,129,41,7,116,167,1035
6,Alexis Ajinça,C,26,NOP,68,8,957,181,329,0,0,181,329,81,99,104,211,315,47,21,51,69,151,443
7,Furkan Aldemir,PF,23,PHI,41,9,540,40,78,0,5,40,73,13,27,78,98,176,28,17,16,17,96,93
8,Cole Aldrich,C,26,NYK,61,16,976,144,301,0,0,144,301,50,64,101,237,338,75,37,65,59,122,338
9,LaMarcus Aldridge,PF,29,POR,71,71,2512,659,1415,37,105,622,1310,306,362,177,549,726,124,48,68,122,125,1661
10,Lavoy Allen,C,25,IND,63,0,1070,141,299,0,0,141,299,33,47,123,200,323,73,15,42,40,102,315
11,Tony Allen,SG,33,MEM,63,41,1648,225,455,10,29,215,426,79,126,103,177,280,86,129,30,86,166,539
12,Al-Farouq Aminu,SF,24,DAL,74,3,1366,147,357,34,124,113,233,84,118,114,228,342,59,70,62,55,137,412
13,Lou Amundson,PF,32,TOT,53,35,937,109,255,0,1,109,254,41,87,94,174,268,70,22,52,62,126,259
14,Chris Andersen,C,36,MIA,60,20,1132,120,207,4,13,116,194,76,114,76,223,299,43,26,61,40,88,320
15,Alan Anderson,SG,32,BRK,74,19,1744,195,440,73,210,122,230,82,101,31,173,204,83,56,5,60,148,545
16,Kyle Anderson,SF,21,SAS,33,8,358,31,89,3,11,28,78,9,14,5,67,72,28,15,7,10,28,74
17,Ryan Anderson,PF,26,NOP,61,5,1675,291,729,122,359,169,370,129,151,108,187,295,55,33,20,62,113,833
18,Giannis Antetokounmpo,SG,20,MIL,81,71,2541,383,780,7,44,376,736,257,347,100,442,542,207,73,85,173,254,1030
19,Carmelo Anthony,SF,30,NYK,40,40,1428,358,806,61,179,297,627,189,237,72,192,264,122,40,17,89,87,966
20,Joel Anthony,C,32,DET,49,0,406,36,62,0,0,36,62,15,22,32,61,93,5,12,49,12,55,87
21,Pero Antić,C,32,ATL,63,3,1037,108,296,52,173,56,123,88,123,58,131,189,49,18,14,49,132,356
22,Trevor Ariza,SF,29,HOU,82,82,2930,366,910,194,555,172,355,122,143,77,382,459,209,152,17,141,186,1048
23,Darrell Arthur,PF,26,DEN,58,4,988,155,384,26,110,129,274,46,59,53,118,171,57,48,26,47,146,382
24,Ömer Aşık,C,28,NOP,76,76,1982,213,412,0,0,213,412,131,225,244,504,748,72,29,54,95,144,557
25,D.J. Augustin,PG,27,TOT,82,14,1964,258,647,83,246,175,401,178,205,20,141,161,353,49,3,145,93,777
26,Jeff Ayres,PF,27,SAS,51,0,383,55,95,0,0,55,95,27,36,37,80,117,14,8,8,26,60,137
27,Luke Babbitt,SF,25,NOP,63,19,830,92,192,59,115,33,77,13,19,12,99,111,24,17,11,26,63,256
28,Cameron Bairstow,PF,24,CHI,18,1,64,3,14,0,0,3,14,4,5,6,2,8,1,2,1,3,8,10
29,Leandro Barbosa,SG,32,GSW,66,1,982,183,386,43,112,140,274,58,74,23,68,91,99,41,8,44,87,467
30,J.J. Barea,PG,30,DAL,77,10,1362,225,536,54,167,171,369,76,94,23,111,134,263,33,1,70,104,580
31,Andrea Bargnani,C,29,NYK,29,22,785,164,361,15,41,149,320,87,107,32,95,127,46,2,27,42,53,430
32,Harrison Barnes,SF,22,GSW,82,82,2318,316,656,87,215,229,441,108,150,117,336,453,116,61,19,71,146,827
33,Matt Barnes,SF,34,LAC,76,74,2271,277,624,136,376,141,248,74,95,51,251,302,114,67,50,87,240,764
34,Earl Barron,C,33,PHO,16,1,143,12,39,2,4,10,35,6,12,14,14,28,5,4,2,5,26,32
35,Will Barton,SG,24,TOT,58,0,983,150,353,23,85,127,268,74,94,26,136,162,81,48,19,61,70,397
36,Brandon Bass,PF,29,BOS,82,43,1929,344,683,9,32,335,651,169,214,139,259,398,104,41,32,83,140,866
37,Nicolas Batum,SF,26,POR,71,71,2380,240,600,100,309,140,291,84,98,62,354,416,341,78,40,132,106,664
38,Jerryd Bayless,PG,26,MIL,77,4,1717,220,516,37,120,183,396,121,137,22,189,211,233,59,12,133,163,598
39,Aron Baynes,C,28,SAS,70,17,1122,185,327,1,4,184,323,90,104,109,209,318,35,16,22,65,162,461
40,Kent Bazemore,SG,25,ATL,75,10,1324,141,331,48,132,93,199,60,100,21,201,222,78,52,33,73,127,390
41,Bradley Beal,SG,21,WAS,63,59,2107,363,851,106,259,257,592,130,166,57,184,241,194,76,18,123,136,962
42,Michael Beasley,PF,26,MIA,24,1,505,92,212,8,34,84,178,20,26,12,77,89,32,15,13,37,66,212
43,Marco Belinelli,SG,28,SAS,62,9,1388,199,470,86,230,113,240,84,99,26,131,157,94,31,3,61,85,568
44,Jerrelle Benimon,PF,23,UTA,2,0,3,0,0,0,0,0,0,0,0,1,2,3,0,0,0,1,0,0
45,Anthony Bennett,PF,21,MIN,57,3,894,125,297,7,23,118,274,41,64,52,164,216,48,27,16,36,87,298
46,Patrick Beverley,PG,26,HOU,56,55,1727,204,532,115,323,89,209,45,60,67,170,237,192,59,23,83,182,568
47,Sim Bhullar,C,22,SAC,3,0,3,1,2,0,0,1,2,0,0,0,1,1,1,0,1,0,0,2
48,Bismack Biyombo,C,22,CHO,64,21,1243,101,186,0,0,101,186,102,175,159,248,407,16,18,99,52,140,304
49,Tarik Black,C,23,TOT,63,39,1196,157,273,0,1,157,272,65,118,142,226,368,42,19,24,48,158,379
50,DeJuan Blair,PF,25,WAS,29,0,180,26,57,0,0,26,57,4,6,16,40,56,3,7,1,13,41,56
51,Steve Blake,PG,34,POR,81,0,1529,122,327,77,219,45,108,29,41,16,121,137,288,41,5,104,118,350
52,Eric Bledsoe,PG,25,PHO,81,81,2800,468,1046,88,272,380,774,353,441,72,351,423,493,127,45,274,189,1377
53,Vander Blue,SG,22,LAL,2,1,74,9,30,2,10,7,20,2,5,2,7,9,8,3,0,6,4,22
54,Bojan Bogdanović,SF,25,BRK,78,28,1854,261,576,91,256,170,320,87,106,50,163,213,68,34,9,78,104,700
55,Andrew Bogut,C,30,GSW,67,65,1583,200,355,0,0,200,355,22,42,141,402,543,180,39,113,106,188,422
56,Matt Bonner,PF,34,SAS,72,19,935,94,230,46,126,48,104,30,37,29,86,115,47,10,12,11,65,264
57,Trevor Booker,PF,27,UTA,79,5,1564,226,464,29,84,197,380,86,148,139,258,397,83,43,41,88,144,567
58,Carlos Boozer,PF,33,LAL,71,26,1692,371,743,0,0,371,743,94,150,111,371,482,95,41,12,92,184,836
59,Chris Bosh,C,30,MIA,44,44,1556,343,745,63,168,280,577,179,232,46,264,310,95,41,25,95,69,928
60,Avery Bradley,SG,24,BOS,77,77,2428,434,1012,124,352,310,660,79,100,46,195,241,135,82,15,109,177,1071
61,Elton Brand,C,35,ATL,36,4,486,42,95,0,1,42,94,12,23,28,72,100,22,17,25,18,54,96
62,Corey Brewer,SF,28,TOT,80,17,2087,343,805,63,235,280,570,168,226,80,217,297,173,114,19,131,173,917
63,Aaron Brooks,PG,30,CHI,82,21,1885,344,817,121,313,223,504,145,174,32,134,166,261,54,15,157,189,954
64,Jabari Brown,SG,22,LAL,19,5,568,70,170,23,62,47,108,64,85,3,33,36,40,12,2,32,33,227
65,Lorenzo Brown,PG,24,MIN,29,7,549,52,122,6,28,46,94,12,19,14,56,70,90,28,6,30,49,122
66,Markel Brown,SG,23,BRK,47,29,781,76,210,17,64,59,146,47,57,16,91,107,39,31,12,27,57,216
67,Shannon Brown,SG,29,MIA,5,2,89,7,19,3,7,4,12,3,4,0,1,1,3,4,0,4,8,20
68,Kobe Bryant,SG,36,LAL,35,35,1207,266,713,54,184,212,529,196,241,26,173,199,197,47,7,128,65,782
69,Chase Budinger,SF,26,MIN,67,4,1286,169,390,52,143,117,247,67,81,33,165,198,64,44,10,49,72,457
70,Reggie Bullock,SF,23,TOT,36,2,338,24,70,15,46,9,24,6,9,1,49,50,8,10,4,8,19,69
71,Trey Burke,PG,22,UTA,76,43,2288,370,1005,124,390,246,615,109,145,31,173,204,328,65,15,124,119,973
72,Alec Burks,SG,23,UTA,27,27,899,121,300,26,68,95,232,106,129,19,95,114,82,17,5,52,64,374
73,Caron Butler,SF,34,DET,78,21,1623,161,396,83,219,78,177,55,61,21,175,196,79,43,4,49,120,460
74,Jimmy Butler,SG,25,CHI,65,65,2513,421,912,73,193,348,719,386,463,114,265,379,212,114,36,93,108,1301
75,Rasual Butler,SF,35,WAS,75,1,1505,218,517,91,235,127,282,53,67,27,170,197,63,29,22,48,98,580
76,Dwight Buycks,PG,25,LAL,6,0,123,18,40,7,11,11,29,9,10,2,10,12,14,3,0,12,3,52
77,Will Bynum,SG,32,WAS,7,0,67,10,31,0,9,10,22,2,4,2,4,6,18,1,1,8,9,22
78,Bruno Caboclo,SF,19,TOR,8,0,23,4,12,2,3,2,9,0,0,1,1,2,0,0,1,4,3,10
79,Nick Calathes,SG,25,MEM,58,0,838,104,247,11,43,93,204,24,45,19,87,106,146,63,5,61,100,243
80,José Calderón,PG,33,NYK,42,42,1270,147,354,59,142,88,212,29,32,19,105,124,198,31,0,75,76,382
81,Kentavious Caldwell-Pope,SG,21,DET,82,82,2587,390,972,153,444,237,528,110,158,46,209,255,109,93,18,94,161,1043
82,Isaiah Canaan,PG,23,TOT,47,21,938,146,378,91,246,55,132,49,60,18,69,87,98,29,3,62,83,432
83,Clint Capela,C,20,HOU,12,0,90,14,29,0,0,14,29,4,23,10,26,36,2,1,9,5,14,32
84,DeMarre Carroll,SF,28,ATL,70,69,2189,318,653,120,304,198,349,127,181,99,273,372,118,94,17,75,154,883
85,Vince Carter,SG,38,MEM,66,1,1091,135,406,69,232,66,174,45,57,27,106,133,79,43,14,43,102,384
86,Michael Carter-Williams,PG,23,TOT,66,63,2149,364,919,36,153,328,766,202,291,64,289,353,442,111,30,253,167,966
87,Omri Casspi,SF,26,SAC,67,19,1416,209,427,35,87,174,340,140,191,54,206,260,102,31,9,88,107,593
88,Mario Chalmers,PG,28,MIA,80,37,2368,267,663,73,248,194,415,206,266,24,182,206,307,122,10,173,251,813
89,Tyson Chandler,C,32,DAL,75,75,2286,293,440,0,0,293,440,185,257,294,570,864,84,42,91,105,169,771
90,Wilson Chandler,SF,27,DEN,78,75,2471,418,975,139,406,279,569,110,142,96,379,475,134,58,29,110,231,1085
91,Will Cherry,PG,23,CLE,8,0,69,5,19,2,9,3,10,3,6,1,4,5,8,6,1,4,10,15
92,Patrick Christopher,SG,26,UTA,4,1,29,3,12,0,4,3,8,0,0,2,4,6,0,1,0,1,6,6
93,Earl Clark,PF,27,BRK,10,0,93,11,30,4,14,7,16,1,4,1,22,23,3,3,4,6,12,27
94,Ian Clark,SG,23,TOT,30,0,192,19,55,10,30,9,25,9,9,4,12,16,12,9,3,9,20,57
95,Jordan Clarkson,PG,22,LAL,59,38,1476,267,596,38,121,229,475,131,158,56,135,191,206,51,12,96,109,703
96,Victor Claver,SF,26,POR,10,0,76,9,20,6,11,3,9,0,0,3,17,20,1,1,1,4,12,24
97,Norris Cole,PG,26,TOT,75,25,1831,230,558,55,176,175,382,58,81,13,146,159,255,57,15,99,124,573
98,Darren Collison,PG,27,SAC,45,45,1565,260,550,60,161,200,389,145,184,19,124,143,252,67,14,112,95,725
99,Nick Collison,PF,34,OKC,66,2,1101,106,253,16,60,90,193,45,65,90,160,250,90,35,25,45,156,273
100,Mike Conley,PG,27,MEM,70,70,2225,393,882,107,277,286,605,214,249,29,180,209,375,89,14,156,139,1107
101,Jack Cooley,C,23,UTA,16,0,87,9,22,0,0,9,22,9,21,10,15,25,1,6,3,3,23,27
102,Chris Copeland,SF,30,IND,50,12,828,112,310,52,167,60,143,33,45,23,88,111,51,11,11,59,78,309
103,Bryce Cotton,PG,22,UTA,15,0,159,29,69,7,20,22,49,15,18,3,15,18,15,4,0,12,6,80
104,DeMarcus Cousins,C,24,SAC,59,59,2013,498,1066,2,8,496,1058,423,541,185,562,747,210,90,103,254,241,1421
105,Robert Covington,SF,24,PHI,70,49,1956,299,756,167,446,132,310,178,217,65,251,316,105,97,31,128,189,943
106,Allen Crabbe,SG,22,POR,51,9,683,63,153,30,85,33,68,12,16,7,66,73,39,19,15,15,74,168
107,Jamal Crawford,SG,34,LAC,64,4,1703,332,839,119,364,213,475,227,252,18,106,124,158,59,14,92,108,1010
108,Jae Crowder,SF,24,TOT,82,17,1647,229,545,61,208,168,337,109,141,72,221,293,94,72,25,49,137,628
109,Dante Cunningham,PF,27,NOP,66,27,1652,155,339,1,10,154,329,29,47,70,186,256,50,46,37,35,101,340
110,Jared Cunningham,SG,23,LAC,19,0,89,12,33,4,13,8,20,7,13,1,8,9,10,3,0,7,12,35
111,Seth Curry,PG,24,PHO,2,0,8,0,3,0,1,0,2,0,0,0,2,2,1,0,0,0,2,0
112,Stephen Curry,PG,26,GSW,80,80,2613,653,1341,286,646,367,695,308,337,56,285,341,619,163,16,249,158,1900
113,Samuel Dalembert,C,33,NYK,32,21,544,57,130,0,0,57,130,14,20,53,115,168,29,14,41,39,70,128
114,Troy Daniels,SG,23,TOT,47,0,397,61,165,43,118,18,47,11,13,8,25,33,22,6,1,20,40,176
115,Luigi Datome,SF,27,TOT,21,1,209,43,89,18,40,25,49,1,1,3,26,29,9,2,7,9,15,105
116,Brandon Davies,PF,23,TOT,27,6,423,55,137,8,34,47,103,24,37,38,45,83,30,18,7,29,59,142
117,Anthony Davis,PF,21,NOP,68,68,2455,642,1199,1,12,641,1187,371,461,173,523,696,149,100,200,95,141,1656
118,Ed Davis,PF,25,LAL,79,24,1840,282,469,0,0,282,469,92,189,230,370,600,94,49,98,58,202,656
119,Glen Davis,PF,29,LAC,74,0,904,117,255,0,4,117,251,60,95,43,126,169,39,41,21,39,132,294
120,Andre Dawkins,SG,23,MIA,4,0,22,1,6,1,6,0,0,0,0,0,2,2,1,0,0,1,3,3
121,Austin Daye,SF,26,TOT,34,4,344,50,141,24,71,26,70,5,6,10,65,75,17,12,5,23,39,129
122,Dewayne Dedmon,C,25,ORL,59,15,845,91,162,0,1,91,161,34,64,118,177,295,9,16,50,51,141,216
123,Matthew Dellavedova,SG,24,CLE,67,13,1380,111,307,68,167,43,140,29,38,37,89,126,204,24,2,61,152,319
124,Luol Deng,SF,29,MIA,72,72,2421,369,787,78,220,291,567,191,251,103,273,376,139,65,22,108,109,1007
125,DeMar DeRozan,SG,25,TOR,60,60,2100,409,990,25,88,384,902,361,434,41,236,277,210,73,11,137,122,1204
126,Boris Diaw,PF,32,SAS,81,15,1984,291,632,54,169,237,463,72,93,78,270,348,233,36,23,126,148,708
127,Gorgui Dieng,C,25,MIN,73,49,2193,259,512,1,6,258,506,191,244,223,386,609,146,71,126,126,188,710
128,Spencer Dinwiddie,PG,21,DET,34,1,455,51,169,12,65,39,104,31,34,4,44,48,104,19,6,33,53,145
129,Joey Dorsey,PF,31,HOU,69,17,854,80,145,0,1,80,144,24,83,103,176,279,25,40,25,41,157,184
130,Toney Douglas,SG,28,NOP,12,0,177,19,51,5,18,14,33,8,13,2,20,22,24,11,4,10,20,51
131,Chris Douglas-Roberts,SG,28,LAC,12,0,103,5,21,1,7,4,14,8,8,1,11,12,4,1,0,0,14,19
133,Zoran Dragić,SG,25,TOT,16,1,75,11,30,3,14,8,16,3,5,5,3,8,5,2,0,5,6,28
134,Larry Drew,PG,24,PHI,12,1,219,20,58,4,26,16,32,2,3,1,14,15,45,6,0,25,13,46
135,Andre Drummond,C,21,DET,82,82,2502,494,961,0,2,494,959,142,365,437,667,1104,55,73,153,120,285,1130
136,Jared Dudley,SG,29,MIL,72,22,1717,198,423,74,192,124,231,48,67,45,175,220,130,72,11,62,113,518
137,Tim Duncan,C,38,SAS,77,77,2227,419,819,2,7,417,812,230,311,170,534,704,230,63,151,131,165,1070
138,Mike Dunleavy,SF,34,CHI,63,63,1838,209,481,107,263,102,218,70,87,28,220,248,114,39,21,60,123,595
139,Kevin Durant,SF,26,OKC,27,27,913,238,467,64,159,174,308,146,171,16,162,178,110,24,25,74,40,686
140,Cleanthony Early,SF,23,NYK,39,7,647,76,214,22,84,54,130,36,48,22,75,97,36,24,12,40,57,210
141,Wayne Ellington,SG,27,LAL,65,36,1675,254,617,90,243,164,374,52,64,31,179,210,105,33,2,50,77,650
142,Monta Ellis,SG,29,DAL,80,80,2699,602,1354,81,284,521,1070,228,303,34,156,190,329,148,25,198,197,1513
143,James Ennis,SF,24,MIA,62,3,1051,101,247,31,95,70,152,79,94,51,125,176,48,25,17,39,89,312
144,Tyler Ennis,PG,20,TOT,33,1,411,52,144,12,43,40,101,5,7,7,28,35,73,18,5,42,36,121
145,Jeremy Evans,SF,27,UTA,38,0,266,32,58,2,5,30,53,24,29,26,45,71,13,11,12,5,29,90
146,Reggie Evans,PF,34,SAC,47,7,764,58,137,0,2,58,135,60,97,97,202,299,32,22,5,45,91,176
147,Tyreke Evans,SG,25,NOP,79,76,2690,521,1165,69,227,452,938,202,291,82,334,416,521,100,37,246,198,1313
148,Dante Exum,PG,19,UTA,82,41,1817,145,416,83,264,62,152,20,32,27,104,131,198,41,14,118,147,393
149,Festus Ezeli,C,25,GSW,46,7,504,76,139,0,0,76,139,49,78,60,95,155,9,7,42,32,77,201
150,Kenneth Faried,PF,25,DEN,75,71,2086,373,736,1,8,372,728,199,288,242,426,668,89,62,57,118,211,946
151,Jordan Farmar,PG,28,LAC,36,0,529,61,158,35,97,26,61,10,11,8,34,42,67,20,5,32,52,167
152,Derrick Favors,PF,23,UTA,74,74,2280,482,918,1,6,481,912,222,332,196,411,607,112,60,123,121,210,1187
153,Raymond Felton,PG,30,DAL,29,3,281,43,106,10,34,33,72,12,15,2,24,26,41,11,4,18,17,108
154,Landry Fields,SF,26,TOR,26,9,216,20,41,1,2,19,39,5,6,10,16,26,15,11,0,8,9,46
155,Evan Fournier,SG,22,ORL,58,32,1661,253,575,85,225,168,350,107,147,28,125,153,120,40,2,82,116,698
156,Randy Foye,SG,31,DEN,50,21,1087,148,402,94,263,54,139,45,55,9,76,85,119,34,11,60,97,435
157,Jamaal Franklin,SG,23,DEN,3,0,13,1,2,1,2,0,0,0,0,1,1,2,3,0,1,3,4,3
158,Tim Frazier,PG,24,TOT,11,3,239,21,61,5,17,16,44,10,21,6,22,28,60,8,0,25,26,57
159,Jimmer Fredette,PG,25,NOP,50,0,509,63,166,9,48,54,118,43,45,8,32,40,58,15,2,33,43,178
160,Joel Freeland,C,27,POR,48,8,617,74,151,0,0,74,151,21,25,62,129,191,16,9,23,23,93,169
161,Channing Frye,PF,31,ORL,75,51,1870,191,487,136,346,55,141,31,35,27,266,293,94,47,39,78,191,549
162,Danilo Gallinari,SF,26,DEN,59,27,1426,228,568,107,301,121,267,171,191,31,187,218,83,47,20,57,94,734
163,Langston Galloway,PG,23,NYK,45,41,1457,204,511,62,176,142,335,63,78,37,153,190,150,52,12,61,129,533
164,Francisco García,SF,33,HOU,14,0,200,17,63,10,45,7,18,1,4,3,14,17,15,9,5,10,20,45
165,Kevin Garnett,PF,38,TOT,47,47,952,143,306,1,7,142,299,36,45,48,263,311,77,46,17,46,109,323
166,Marc Gasol,C,30,MEM,81,81,2687,530,1072,3,17,527,1055,350,440,115,515,630,307,70,131,176,208,1413
167,Pau Gasol,PF,34,CHI,78,78,2681,570,1153,12,26,558,1127,294,366,220,699,919,210,25,147,158,147,1446
168,Rudy Gay,SF,28,SAC,68,67,2408,508,1116,79,220,429,896,337,393,98,301,399,250,71,41,183,157,1432
169,Alonzo Gee,SF,27,TOT,54,2,662,87,186,13,35,74,151,54,77,37,57,94,25,35,7,33,58,241
170,Paul George,SF,24,IND,6,0,91,18,49,9,22,9,27,8,11,4,18,22,6,5,1,12,11,53
171,Taj Gibson,PF,29,CHI,62,17,1692,254,506,0,0,254,506,132,184,162,234,396,71,36,75,77,162,640
172,Manu Ginóbili,SG,37,SAS,70,0,1587,251,589,89,258,162,331,147,204,28,183,211,293,67,20,154,138,738
173,Rudy Gobert,C,22,UTA,82,37,2158,258,427,0,2,258,425,170,273,265,510,775,109,64,189,111,175,686
174,Drew Gooden,PF,33,WAS,51,7,864,110,276,23,59,87,217,34,44,72,151,223,49,21,9,28,91,277
175,Archie Goodwin,SG,20,PHO,41,2,535,79,201,12,41,67,160,61,83,27,47,74,44,18,9,48,55,231
176,Aaron Gordon,PF,19,ORL,47,8,797,93,208,13,48,80,160,44,61,46,123,169,33,21,22,38,83,243
177,Ben Gordon,SG,31,ORL,56,0,790,129,295,35,97,94,198,56,67,6,57,63,50,14,1,55,60,349
178,Drew Gordon,PF,24,PHI,9,0,71,8,19,0,3,8,16,1,2,7,11,18,2,1,0,8,7,17
179,Eric Gordon,SG,26,NOP,61,60,2018,285,694,141,315,144,379,107,133,28,131,159,229,50,14,122,145,818
180,Marcin Gortat,C,30,WAS,82,82,2453,439,775,0,3,439,772,123,175,180,537,717,97,49,110,100,191,1001
181,Danny Granger,SF,31,MIA,30,6,613,65,162,30,84,35,78,28,37,20,60,80,17,13,6,24,67,188
182,Jerami Grant,SF,20,PHI,65,11,1377,124,352,49,156,75,196,114,193,49,149,198,79,40,68,85,144,411
183,Danny Green,SG,27,SAS,81,80,2312,322,738,191,457,131,281,111,127,54,289,343,158,101,87,93,163,946
184,Draymond Green,PF,24,GSW,79,79,2490,339,765,111,329,228,436,132,200,114,533,647,291,123,99,133,253,921
185,Erick Green,PG,23,DEN,43,1,410,61,162,14,47,47,115,10,12,7,24,31,39,12,0,14,26,146
186,Gerald Green,SG,29,PHO,74,4,1446,324,778,137,387,187,391,99,120,33,153,186,91,42,12,104,145,884
187,JaMychal Green,PF,24,TOT,24,1,164,27,47,0,6,27,41,8,10,19,26,45,4,5,5,14,25,62
188,Jeff Green,SF,28,TOT,78,70,2454,416,967,97,292,319,675,239,287,64,264,328,134,53,34,108,147,1168
189,Willie Green,SG,33,ORL,52,2,951,118,306,42,121,76,185,28,34,14,65,79,68,26,5,48,81,306
190,Blake Griffin,PF,25,LAC,67,67,2356,574,1144,10,25,564,1119,311,427,126,382,508,354,63,35,152,196,1469
191,Jorge Gutiérrez,PG,26,TOT,20,1,175,22,41,0,3,22,38,9,13,5,20,25,22,6,0,12,25,53
192,P.J. Hairston,SG,22,CHO,45,2,687,87,269,49,163,38,106,31,36,22,70,92,21,21,13,22,61,254
193,Jordan Hamilton,SF,24,LAC,14,2,122,14,35,10,21,4,14,0,0,2,14,16,7,2,0,4,14,38
194,Justin Hamilton,C,24,TOT,41,14,712,85,178,10,31,75,147,39,47,57,77,134,36,27,30,26,70,219
195,Tyler Hansbrough,PF,29,TOR,74,8,1058,86,165,1,7,85,158,97,139,106,159,265,21,30,15,20,141,270
196,Tim Hardaway,SG,22,NYK,70,30,1681,279,717,121,354,158,363,125,156,12,144,156,127,20,14,82,119,804
197,James Harden,SG,25,HOU,81,81,2981,647,1470,208,555,439,915,715,824,75,384,459,565,154,60,321,208,2217
198,Maurice Harkless,SF,21,ORL,45,4,674,63,158,10,56,53,102,22,41,38,68,106,25,32,9,27,66,158
199,Devin Harris,PG,31,DAL,76,3,1685,219,524,95,266,124,258,132,162,13,122,135,237,78,14,85,147,665
200,Gary Harris,SG,20,DEN,55,6,719,66,217,21,103,45,114,35,47,21,43,64,29,39,7,38,71,188
201,Joe Harris,SG,23,CLE,51,1,493,48,120,31,84,17,36,9,15,7,34,41,26,7,2,27,62,136
202,Tobias Harris,SF,22,ORL,68,63,2369,442,949,87,239,355,710,193,245,73,357,430,124,69,36,115,134,1164
203,Udonis Haslem,PF,34,MIA,62,25,995,107,239,2,10,105,229,45,64,71,187,258,46,21,13,41,113,261
204,Spencer Hawes,PF,26,LAC,73,15,1274,163,415,55,176,108,239,44,68,30,228,258,88,24,53,61,173,425
205,Chuck Hayes,C,31,TOR,29,0,255,22,46,0,0,22,46,6,11,18,33,51,20,10,4,8,37,50
206,Gordon Hayward,SF,24,UTA,76,76,2618,484,1087,120,330,364,757,375,462,54,319,373,313,108,30,206,131,1463
207,Brendan Haywood,C,35,CLE,22,1,119,14,30,0,0,14,30,7,13,6,23,29,2,2,10,10,17,35
208,Gerald Henderson,SG,27,CHO,80,72,2315,370,847,45,136,325,711,184,217,36,237,273,206,51,22,110,135,969
209,Xavier Henry,SF,23,LAL,9,0,86,3,13,0,0,3,13,14,24,2,2,4,3,3,0,3,6,20
210,John Henson,C,24,MIL,67,11,1228,196,346,0,0,196,346,78,137,124,188,312,59,28,135,87,152,470
211,Roy Hibbert,C,28,IND,76,76,1926,317,710,0,2,317,708,168,204,156,384,540,84,18,125,107,216,802
212,J.J. Hickson,C,26,DEN,73,8,1411,218,459,0,2,218,457,116,201,150,302,452,57,36,35,96,136,552
213,Nenê Hilário,PF,32,WAS,67,58,1693,307,601,1,5,306,596,122,202,84,261,345,123,66,22,124,180,737
214,George Hill,PG,28,IND,43,36,1267,255,535,69,193,186,342,113,143,25,154,179,220,44,14,69,111,692
215,Jordan Hill,C,27,LAL,70,57,1874,357,777,3,11,354,766,124,168,174,382,556,103,34,52,106,164,841
216,Solomon Hill,SF,23,IND,82,78,2381,251,634,68,208,183,426,159,193,70,244,314,184,66,18,115,177,729
217,Kirk Hinrich,SG,34,CHI,66,22,1610,142,381,58,168,84,213,35,50,20,101,121,148,46,14,73,144,377
218,Jrue Holiday,PG,24,NOP,40,37,1303,238,534,51,135,187,399,65,76,32,103,135,274,63,23,91,110,592
219,Justin Holiday,SG,25,GSW,59,4,657,91,235,35,109,56,126,37,45,12,61,73,48,40,12,29,54,254
220,Ryan Hollins,C,30,SAC,46,9,441,53,82,0,0,53,82,31,54,36,67,103,14,6,19,25,65,137
221,Rodney Hood,SG,22,UTA,50,21,1064,155,374,62,170,93,204,61,80,9,108,117,83,30,12,45,119,433
222,Al Horford,C,28,ATL,76,76,2318,519,965,11,36,508,929,107,141,131,413,544,244,68,98,100,121,1156
223,Dwight Howard,C,29,HOU,41,41,1223,251,423,1,2,250,421,143,271,110,321,431,50,28,53,115,137,646
224,Lester Hudson,SG,30,LAC,5,0,56,6,14,3,6,3,8,3,4,1,7,8,5,6,1,3,4,18
225,Robbie Hummel,SF,25,MIN,45,4,742,79,172,16,51,63,121,24,29,31,103,134,27,16,9,18,86,198
226,Kris Humphries,PF,29,WAS,64,17,1345,211,446,0,7,211,439,87,117,118,298,416,57,34,25,46,130,509
227,Serge Ibaka,PF,25,OKC,64,64,2116,374,786,77,205,297,581,92,110,135,364,499,55,30,155,97,194,917
228,Andre Iguodala,SF,31,GSW,77,0,2069,231,496,74,212,157,284,68,114,44,213,257,228,89,25,88,100,604
229,Ersan İlyasova,PF,27,MIL,58,36,1319,263,557,74,190,189,367,69,107,80,197,277,56,36,19,45,149,669
230,Joe Ingles,SF,27,UTA,79,32,1673,147,354,72,202,75,152,30,40,22,153,175,182,72,10,98,124,396
231,Kyrie Irving,PG,22,CLE,75,75,2730,578,1235,157,378,421,857,315,365,55,182,237,389,114,20,186,146,1628
232,Jarrett Jack,PG,31,BRK,80,27,2241,359,817,39,146,320,671,200,227,19,226,245,373,75,13,191,143,957
233,Reggie Jackson,PG,24,TOT,77,40,2268,432,996,72,241,360,755,181,218,56,271,327,462,62,9,186,167,1117
234,Bernard James,C,29,DAL,16,2,158,12,27,0,0,12,27,20,23,18,21,39,4,2,15,6,17,44
235,LeBron James,SF,30,CLE,69,69,2493,624,1279,120,339,504,940,375,528,51,365,416,511,109,49,272,135,1743
236,Al Jefferson,C,30,CHO,65,61,1992,486,1010,2,5,484,1005,108,165,99,449,548,113,47,84,68,139,1082
237,Cory Jefferson,PF,24,BRK,50,1,531,75,167,2,15,73,152,31,54,47,98,145,16,10,21,20,61,183
238,Richard Jefferson,SF,34,DAL,74,18,1244,144,324,66,155,78,169,78,114,25,158,183,61,32,11,52,115,432
239,John Jenkins,SG,23,ATL,24,3,297,49,99,21,52,28,47,16,19,2,37,39,13,10,0,8,15,135
240,Brandon Jennings,PG,25,DET,41,41,1173,218,543,76,211,142,332,120,143,21,83,104,272,44,4,90,64,632
241,Jonas Jerebko,PF,27,TOT,75,0,1230,169,379,54,140,115,239,56,66,93,189,282,71,46,18,44,135,448
242,Grant Jerrett,PF,21,TOT,8,0,51,7,26,1,15,6,11,1,1,2,7,9,3,2,2,3,11,16
243,Amir Johnson,PF,27,TOR,75,72,1979,298,519,19,46,279,473,79,129,159,297,456,117,44,59,110,225,694
244,Chris Johnson,SF,24,TOT,29,2,526,62,154,28,95,34,59,14,16,8,47,55,15,26,7,15,44,166
245,James Johnson,PF,27,TOR,70,17,1370,238,404,11,51,227,353,67,102,61,196,257,95,54,70,79,155,554
246,Joe Johnson,SG,33,BRK,80,80,2791,446,1025,121,337,325,688,141,176,53,331,384,292,59,14,137,120,1154
247,Nick Johnson,SG,22,HOU,28,0,262,26,75,5,21,21,54,17,25,13,26,39,11,7,3,19,34,74
248,Tyler Johnson,SG,22,MIA,32,2,603,70,167,18,48,52,119,32,47,14,67,81,42,33,9,30,42,190
249,Wesley Johnson,SF,27,LAL,76,59,2245,286,691,91,259,195,432,90,112,67,252,319,124,59,45,87,162,753
250,Dahntay Jones,SF,34,LAC,33,0,123,6,21,0,4,6,17,9,11,1,10,11,2,3,0,1,23,21
251,James Jones,SF,34,CLE,57,2,669,74,201,63,175,11,26,39,46,9,53,62,24,13,8,13,67,250
252,Perry Jones,SF,23,OKC,43,13,631,73,184,14,60,59,124,24,37,6,70,76,18,17,8,24,50,184
253,Terrence Jones,PF,23,HOU,33,24,889,158,299,13,37,145,262,57,94,78,142,220,36,18,59,37,78,386
254,DeAndre Jordan,C,26,LAC,82,82,2820,379,534,1,4,378,530,187,471,397,829,1226,61,81,183,109,245,946
255,Jerome Jordan,C,28,BRK,44,0,383,50,94,0,0,50,94,38,44,52,53,105,13,8,15,22,58,138
256,Cory Joseph,PG,23,SAS,79,14,1444,207,411,16,44,191,367,105,143,44,148,192,188,46,17,67,105,535
257,Chris Kaman,C,32,POR,74,13,1398,283,549,0,0,283,549,72,102,149,335,484,65,18,54,108,140,638
258,Enes Kanter,C,22,TOT,75,74,2135,482,928,16,45,466,883,183,234,277,394,671,55,36,29,145,189,1163
259,Sergey Karasev,SG,21,BRK,33,16,555,54,134,16,54,38,80,29,38,22,44,66,46,23,1,24,45,153
260,Ryan Kelly,PF,23,LAL,52,34,1233,104,309,45,134,59,175,79,95,13,133,146,92,30,24,37,118,332
261,Michael Kidd-Gilchrist,SF,21,CHO,55,52,1587,224,482,0,0,224,482,150,214,109,307,416,77,30,38,63,115,598
262,Sean Kilpatrick,SG,25,MIN,4,0,72,7,20,4,13,3,7,4,4,1,5,6,4,3,0,2,3,22
263,Andrei Kirilenko,SF,33,BRK,7,0,36,0,5,0,0,0,5,3,4,2,6,8,1,1,0,1,1,3
264,Alex Kirk,C,23,CLE,5,0,14,1,4,0,0,1,4,2,2,1,0,1,1,0,0,0,1,4
266,Kyle Korver,SG,33,ATL,75,75,2418,292,600,221,449,71,151,106,118,15,289,304,196,52,42,107,140,911
267,Kosta Koufos,C,25,MEM,81,3,1348,182,358,0,0,182,358,55,85,121,305,426,37,29,63,69,148,419
268,Ognjen Kuzmić,C,24,GSW,16,0,72,8,12,0,0,8,12,4,4,7,10,17,6,2,1,5,13,20
269,Jeremy Lamb,SG,22,OKC,47,8,633,104,250,38,111,66,139,49,55,8,99,107,44,21,6,27,52,295
270,Carl Landry,PF,31,SAC,70,15,1192,190,369,0,0,190,369,123,150,99,169,268,26,15,17,54,132,503
271,Shane Larkin,PG,22,NYK,76,22,1865,187,432,35,116,152,316,61,78,29,147,176,226,93,9,83,150,470
272,Joffrey Lauvergne,C,23,DEN,24,1,268,36,89,3,16,33,73,18,28,27,50,77,13,8,10,22,43,93
273,Zach LaVine,PG,19,MIN,77,40,1902,286,677,57,167,229,510,149,177,27,187,214,276,54,10,193,158,778
274,Ty Lawson,PG,27,DEN,75,75,2665,404,926,70,205,334,721,265,363,42,192,234,720,92,9,185,128,1143
275,Ricky Ledo,SG,22,TOT,17,0,244,32,96,10,27,22,69,16,22,16,20,36,19,6,1,26,21,90
276,Courtney Lee,SG,29,MEM,77,74,2354,288,643,90,224,198,419,111,129,21,157,178,151,75,12,78,129,777
277,David Lee,PF,31,GSW,49,4,904,160,313,0,2,160,311,68,104,81,176,257,85,31,26,49,83,388
278,Malcolm Lee,SG,24,PHI,1,0,2,0,1,0,0,0,1,0,0,0,0,0,0,0,0,0,0,0
279,Alex Len,C,21,PHO,69,44,1518,179,353,1,3,178,350,73,104,142,312,454,32,34,105,74,213,432
280,Kawhi Leonard,SF,23,SAS,64,64,2033,394,822,67,192,327,630,202,252,85,376,461,161,148,48,97,128,1057
281,Meyers Leonard,C,22,POR,55,7,847,125,245,47,112,78,133,30,32,46,204,250,32,10,14,39,113,327
282,Jon Leuer,PF,25,MEM,63,6,824,121,273,7,29,114,244,37,59,50,157,207,46,17,9,35,86,286
283,Damian Lillard,PG,24,POR,82,82,2925,590,1360,196,572,394,788,344,398,49,329,378,507,97,21,222,164,1720
284,Jeremy Lin,PG,26,LAL,74,30,1907,277,654,65,176,212,478,213,268,26,170,196,339,82,32,166,189,832
285,Shaun Livingston,PG,29,GSW,78,2,1468,198,396,0,2,198,394,65,91,43,140,183,259,49,20,102,110,461
286,Brook Lopez,C,26,BRK,72,44,2100,506,987,1,10,505,977,223,274,214,321,535,50,43,126,104,206,1236
287,Robin Lopez,C,26,POR,59,59,1638,234,437,0,1,234,436,98,127,190,204,394,55,16,84,73,122,566
288,Kevin Love,PF,26,CLE,75,75,2532,413,952,144,392,269,560,258,321,142,589,731,168,51,39,122,140,1228
289,Kyle Lowry,PG,28,TOR,70,70,2414,430,1043,132,391,298,652,252,312,54,274,328,473,109,13,173,212,1244
290,Kalin Lucas,PG,25,MEM,1,0,6,0,1,0,0,0,1,0,0,0,0,0,0,1,0,0,1,0
291,John Lucas III,PG,32,DET,21,0,272,42,104,9,29,33,75,5,5,4,12,16,60,8,0,16,18,98
292,Shelvin Mack,PG,24,ATL,55,0,833,117,292,40,127,77,165,25,31,8,71,79,155,30,2,49,32,299
293,Ian Mahinmi,C,28,IND,61,6,1146,117,212,0,0,117,212,31,102,105,251,356,33,30,46,59,172,265
294,Devyn Marble,SG,22,ORL,16,7,208,14,44,4,22,10,22,5,16,5,26,31,17,9,2,9,14,37
295,Shawn Marion,SF,36,CLE,57,24,1101,119,267,12,46,107,221,26,34,64,138,202,51,27,27,33,58,276
296,Kendall Marshall,PG,23,MIL,28,3,417,46,101,18,46,28,55,8,9,2,26,28,86,21,0,35,26,118
297,Cartier Martin,SF,30,DET,23,0,198,15,53,6,33,9,20,0,0,0,20,20,11,3,1,5,20,36
298,Kenyon Martin,PF,37,MIL,11,0,104,9,22,0,0,9,22,2,2,6,13,19,5,5,6,3,13,20
299,Kevin Martin,SG,31,MIN,39,36,1302,267,625,75,191,192,434,170,193,19,123,142,89,33,1,76,76,779
300,Wesley Matthews,SG,28,POR,60,60,2024,337,752,173,445,164,307,109,145,38,184,222,139,77,10,81,132,956
301,Jason Maxiell,PF,31,CHO,61,0,878,81,192,0,0,81,192,41,71,86,117,203,19,18,44,29,96,203
302,O.J. Mayo,SG,27,MIL,71,15,1697,296,701,99,277,197,424,115,139,30,157,187,197,57,18,128,165,806
303,Luc Mbah a Moute,PF,28,PHI,67,61,1916,251,636,62,202,189,434,96,163,82,246,328,106,81,21,99,104,660
304,James Michael McAdoo,PF,22,GSW,15,0,137,24,44,0,0,24,44,14,25,15,22,37,2,5,9,6,21,62
305,Ray McCallum,PG,23,SAC,68,30,1436,206,470,34,111,172,359,57,84,52,128,180,188,45,11,85,92,503
306,CJ McCollum,SG,23,POR,62,3,973,159,365,55,139,104,226,51,73,14,77,91,64,43,8,48,81,424
307,K.J. McDaniels,SG,21,TOT,62,15,1352,172,434,43,150,129,284,100,133,65,135,200,72,44,70,105,126,487
308,Doug McDermott,SF,23,CHI,36,0,321,43,107,13,41,30,66,10,15,6,37,43,6,4,1,17,29,109
309,Mitch McGary,PF,22,OKC,32,2,485,88,165,0,2,88,163,25,40,53,112,165,14,16,16,31,72,201
310,JaVale McGee,C,27,TOT,23,0,256,42,79,0,0,42,79,22,33,18,43,61,3,2,20,18,30,106
311,Ben McLemore,SG,21,SAC,82,82,2670,363,831,140,391,223,440,130,160,31,210,241,140,77,19,138,219,996
312,Jerel McNeal,PG,27,PHO,6,0,36,3,11,1,2,2,9,2,2,0,3,3,2,3,1,5,5,9
313,Josh McRoberts,PF,27,MIA,17,4,296,28,53,8,19,20,34,8,13,7,38,45,33,12,3,22,41,72
314,Jodie Meeks,SG,27,DET,60,0,1462,222,534,74,212,148,322,145,160,12,92,104,79,59,6,57,76,663
315,Gal Mekel,PG,26,NOP,4,0,43,3,20,0,3,3,17,0,0,0,1,1,13,2,0,2,1,6
316,Khris Middleton,SF,23,MIL,79,58,2378,406,869,109,268,297,601,134,156,48,299,347,182,122,11,113,183,1055
317,C.J. Miles,SG,27,IND,70,40,1841,329,827,154,446,175,381,130,161,18,196,214,75,60,26,73,132,942
318,Andre Miller,PG,38,TOT,81,0,1253,145,290,7,34,138,256,58,77,37,116,153,284,32,6,104,103,355
319,Darius Miller,SF,24,NOP,5,1,43,1,7,0,1,1,6,0,0,0,1,1,2,1,0,1,8,2
320,Mike Miller,SF,34,CLE,52,15,701,37,114,32,98,5,16,3,4,4,87,91,46,14,4,23,74,109
321,Quincy Miller,PF,22,TOT,10,0,119,9,38,3,18,6,20,8,11,4,16,20,8,7,5,5,9,29
322,Patty Mills,PG,26,SAS,51,0,801,128,336,62,182,66,154,33,40,21,54,75,87,28,2,35,58,351
323,Elijah Millsap,SG,27,UTA,47,5,924,81,238,28,90,53,148,58,86,28,122,150,58,56,16,67,124,248
324,Paul Millsap,PF,29,ATL,73,73,2390,443,930,77,216,366,714,255,337,139,431,570,223,130,69,166,201,1218
325,Nikola Mirotić,PF,23,CHI,82,3,1654,253,624,99,313,154,311,228,284,63,341,404,97,54,54,89,172,833
326,Nazr Mohammed,C,37,CHI,23,0,128,13,30,0,0,13,30,1,3,11,27,38,3,4,5,7,16,27
327,Greg Monroe,PF,24,DET,69,57,2137,423,853,0,0,423,853,252,336,229,475,704,142,78,34,149,148,1098
328,E'Twaun Moore,SG,25,CHI,56,0,504,62,139,13,38,49,101,12,20,12,34,46,33,20,6,14,45,149
329,Eric Moreland,PF,23,SAC,3,0,2,1,1,0,0,1,1,0,0,0,1,1,0,0,0,0,1,2
330,Darius Morris,PG,24,BRK,38,0,299,36,106,7,33,29,73,4,9,7,20,27,48,9,0,21,20,83
331,Marcus Morris,PF,25,PHO,81,35,2045,331,763,112,313,219,450,71,113,73,312,385,133,63,16,73,188,845
332,Markieff Morris,PF,25,PHO,82,82,2581,512,1100,57,179,455,921,177,232,110,396,506,192,101,39,170,245,1258
333,Anthony Morrow,SG,29,OKC,74,0,1806,285,615,141,325,144,290,79,89,40,155,195,60,54,11,38,135,790
334,Donatas Motiejūnas,PF,24,HOU,71,62,2037,353,700,49,133,304,567,100,166,137,284,421,130,56,34,123,203,855
335,Timofey Mozgov,C,28,TOT,81,80,2045,314,566,2,6,312,560,155,216,203,388,591,55,33,97,116,227,785
336,Shabazz Muhammad,SG,22,MIN,38,13,866,194,397,20,51,174,346,104,145,63,91,154,44,18,7,35,49,512
338,Mike Muscala,PF,23,ATL,40,8,502,83,151,9,22,74,129,22,25,52,67,119,25,16,19,21,52,197
339,Shabazz Napier,PG,23,MIA,51,10,1012,87,228,43,118,44,110,44,56,17,96,113,130,40,4,81,76,261
340,Gary Neal,SG,30,TOT,54,1,1193,188,503,50,164,138,339,117,135,14,115,129,100,23,1,65,88,543
341,Jameer Nelson,PG,32,TOT,63,29,1407,205,504,89,258,116,246,24,36,33,113,146,253,47,6,109,136,523
342,Andrew Nicholson,PF,25,ORL,40,3,492,83,190,13,41,70,149,15,25,17,65,82,22,6,12,24,51,194
343,Joakim Noah,C,29,CHI,67,67,2049,190,427,0,2,190,425,105,174,219,427,646,312,48,74,123,203,485
344,Nerlens Noel,C,20,PHI,75,71,2311,302,653,0,0,302,653,140,230,185,426,611,128,133,142,146,208,744
345,Lucas Nogueira,C,22,TOR,6,0,23,2,8,0,0,2,8,2,4,2,9,11,1,2,0,2,6,6
347,Dirk Nowitzki,PF,36,DAL,77,77,2282,487,1062,104,274,383,788,255,289,44,413,457,143,39,33,82,160,1333
348,Jusuf Nurkić,C,20,DEN,62,27,1103,171,383,0,2,171,381,84,132,125,257,382,50,52,68,86,207,426
349,Johnny O'Bryant,PF,21,MIL,34,15,368,44,120,0,0,44,120,12,27,26,38,64,17,5,4,25,44,100
350,Kyle O'Quinn,PF,24,ORL,51,17,824,119,242,12,43,107,199,44,57,46,153,199,59,31,39,55,110,294
351,Victor Oladipo,SG,22,ORL,72,71,2573,473,1086,84,248,389,838,262,320,51,251,302,295,120,19,204,187,1292
352,Kelly Olynyk,C,23,BOS,64,13,1423,251,528,61,175,190,353,93,136,92,211,303,109,64,39,98,213,656
353,Arinze Onuaku,C,27,MIN,6,1,68,12,14,0,0,12,14,3,8,7,14,21,4,1,3,2,6,27
354,Zaza Pachulia,C,30,MIL,73,45,1730,240,529,0,3,240,526,126,160,197,303,500,178,80,21,133,170,606
355,Kostas Papanikolaou,SF,24,HOU,43,1,795,69,197,31,106,38,91,13,18,39,79,118,85,29,13,55,71,182
356,Jannero Pargo,PG,35,CHO,9,0,73,15,35,9,22,6,13,2,2,0,3,3,8,0,0,3,8,41
357,Jabari Parker,PF,19,MIL,25,25,738,129,263,4,16,125,247,46,66,50,88,138,42,31,5,47,42,308
358,Tony Parker,PG,32,SAS,68,68,1953,404,832,38,89,366,743,130,166,15,114,129,335,44,2,146,108,976
359,Chandler Parsons,SF,26,DAL,66,66,2186,383,829,132,347,251,482,139,193,64,259,323,161,69,19,96,140,1037
360,Patrick Patterson,PF,25,TOR,81,4,2156,240,535,105,283,135,252,63,80,127,306,433,155,60,44,54,149,648
361,Chris Paul,PG,29,LAC,82,82,2857,568,1170,139,349,429,821,289,321,52,324,376,838,156,15,190,203,1564
362,Adreian Payne,PF,23,TOT,32,22,739,91,220,1,9,90,211,30,46,48,114,162,30,19,9,44,88,213
363,Elfrid Payton,PG,20,ORL,82,63,2489,301,708,11,42,290,666,118,214,107,242,349,533,142,20,203,193,731
364,Nikola Peković,C,29,MIN,31,29,815,139,328,0,0,139,328,108,129,89,145,234,27,19,12,42,59,386
365,Kendrick Perkins,C,30,TOT,68,3,1148,102,227,0,1,102,226,42,83,91,229,320,51,16,42,95,162,246
366,Paul Pierce,SF,37,WAS,73,73,1914,293,656,118,303,175,353,164,210,45,249,294,144,46,24,92,160,868
367,Mason Plumlee,C,24,BRK,82,45,1743,280,489,0,3,280,486,157,317,175,337,512,74,65,63,106,207,717
368,Miles Plumlee,C,26,TOT,73,28,1194,136,254,0,0,136,254,22,46,112,208,320,34,41,66,51,111,294
370,Otto Porter,SF,21,WAS,74,13,1432,176,391,35,104,141,287,58,79,70,151,221,65,44,30,52,97,445
371,Dwight Powell,PF,23,TOT,29,0,236,31,67,3,11,28,56,25,33,18,32,50,9,9,6,11,40,90
372,Phil Pressey,PG,23,BOS,50,0,600,64,174,16,65,48,109,33,49,13,67,80,117,30,6,41,54,177
373,A.J. Price,PG,28,TOT,26,0,324,51,137,15,57,36,80,16,24,6,26,32,46,7,0,14,15,133
374,Ronnie Price,PG,31,LAL,43,20,982,77,223,31,109,46,114,36,45,19,50,69,165,67,4,52,118,221
375,Pablo Prigioni,PG,37,TOT,67,3,1197,91,228,57,166,34,62,35,41,30,89,119,171,79,1,62,88,274
376,Tayshaun Prince,SF,34,TOT,58,16,1397,177,402,31,67,146,335,49,65,52,158,210,93,29,16,35,55,434
377,Miroslav Raduljica,C,27,MIN,5,0,23,3,8,0,0,3,8,2,2,2,3,5,0,1,0,2,8,8
378,Julius Randle,PF,20,LAL,1,0,14,1,3,0,0,1,3,0,2,0,0,0,0,0,0,1,1,2
379,Shavlik Randolph,PF,31,TOT,21,0,126,9,35,0,5,9,30,6,12,16,22,38,4,5,3,3,16,24
380,Zach Randolph,PF,33,MEM,71,71,2304,454,932,7,20,447,912,228,298,225,522,747,153,69,14,156,175,1143
381,J.J. Redick,SG,30,LAC,78,78,2409,447,938,200,458,247,480,183,203,22,145,167,137,39,8,95,134,1277
382,Glen Rice,SG,24,WAS,5,0,43,3,15,1,7,2,8,4,6,2,2,4,2,0,0,2,11,11
383,Jason Richardson,SG,34,PHI,19,15,416,62,178,31,96,31,82,17,22,13,53,66,38,13,3,16,28,172
384,Luke Ridnour,PG,33,ORL,47,0,683,75,176,20,63,55,113,18,21,8,60,68,96,20,4,38,67,188
386,Andre Roberson,SG,23,OKC,67,65,1286,92,201,21,85,71,116,23,48,60,195,255,70,53,29,46,141,228
387,Brian Roberts,PG,29,CHO,72,10,1330,176,452,62,193,114,259,66,74,13,96,109,162,33,6,57,75,480
389,Nate Robinson,PG,30,TOT,42,1,591,88,255,31,112,57,143,31,46,17,33,50,97,20,3,30,76,238
390,Thomas Robinson,PF,23,TOT,54,4,798,126,260,0,2,126,258,56,106,95,208,303,33,32,20,59,104,308
391,Rajon Rondo,PG,28,TOT,68,68,2018,275,645,27,86,248,559,31,78,73,300,373,538,91,7,210,153,608
392,Derrick Rose,PG,26,CHI,51,51,1530,338,835,76,271,262,564,152,187,35,126,161,251,36,16,161,63,904
393,Terrence Ross,SF,23,TOR,82,61,2092,309,753,145,390,164,363,44,56,32,194,226,86,53,25,69,136,807
394,Ricky Rubio,PG,24,MIN,22,22,692,78,219,13,51,65,168,57,71,19,106,125,193,38,1,64,59,226
395,Damjan Rudež,SF,28,IND,68,2,1047,119,263,69,170,50,93,16,23,8,39,47,53,16,5,47,79,323
396,Brandon Rush,SG,29,GSW,33,0,271,11,54,3,27,8,27,5,11,4,37,41,12,5,12,11,27,30
397,Robert Sacre,C,25,LAL,67,18,1133,126,306,0,1,126,305,55,82,89,144,233,55,28,43,36,121,307
398,John Salmons,SF,35,NOP,21,0,270,16,48,8,26,8,22,2,4,4,17,21,13,9,4,5,25,42
399,JaKarr Sampson,SF,21,PHI,74,32,1131,146,346,31,127,115,219,63,94,35,128,163,77,38,26,76,135,386
400,Larry Sanders,C,26,MIL,27,26,586,86,172,0,0,86,172,24,48,67,99,166,23,26,39,28,104,196
401,Dennis Schröder,PG,21,ATL,77,10,1516,284,665,52,148,232,517,148,179,29,135,164,317,49,4,150,127,768
402,Luis Scola,PF,34,IND,81,16,1659,300,642,5,20,295,622,158,226,138,388,526,105,47,18,94,192,763
403,Mike Scott,PF,26,ATL,68,0,1123,201,453,66,192,135,261,61,77,45,154,199,75,25,3,39,83,529
404,Thabo Sefolosha,SF,30,ATL,52,7,976,104,249,25,78,79,171,45,58,53,170,223,75,53,21,38,67,278
405,Kevin Séraphin,C,25,WAS,79,0,1235,231,450,0,2,231,448,58,82,87,201,288,59,10,59,98,197,520
406,Ramon Sessions,PG,28,TOT,64,10,1188,125,334,19,60,106,274,133,173,23,121,144,182,29,0,86,73,402
407,Iman Shumpert,SG,24,TOT,62,25,1545,193,471,67,196,126,275,43,64,55,169,224,135,81,16,91,138,496
408,Alexey Shved,SG,26,TOT,42,9,767,133,335,47,139,86,196,121,150,23,76,99,106,30,6,48,48,434
409,Henry Sims,C,24,PHI,73,32,1399,238,502,4,22,234,480,106,137,121,238,359,79,39,30,99,135,586
410,Kyle Singler,SF,26,TOT,80,58,1743,172,446,96,241,76,205,40,52,33,161,194,85,47,21,55,153,480
411,Donald Sloan,PG,27,IND,53,21,1107,145,355,41,131,104,224,60,77,12,131,143,190,23,0,65,47,391
412,Marcus Smart,PG,20,BOS,67,38,1808,175,477,91,272,84,205,82,127,61,161,222,208,99,18,90,176,523
413,Greg Smith,PF,24,DAL,42,2,363,30,49,0,0,30,49,20,39,26,53,79,9,7,11,11,53,80
414,Ish Smith,PG,26,TOT,55,14,832,143,367,18,60,125,307,34,57,15,85,100,180,36,6,78,50,338
415,J.R. Smith,SG,29,TOT,70,51,2080,315,755,163,426,152,329,54,72,30,188,218,195,82,22,97,163,847
416,Jason Smith,C,28,NYK,82,31,1785,257,592,15,42,242,550,127,153,98,226,324,140,32,44,104,205,656
417,Josh Smith,PF,29,TOT,83,35,2300,414,987,72,228,342,759,127,255,152,378,530,277,87,116,206,228,1027
418,Russ Smith,PG,23,TOT,12,0,65,8,25,2,11,6,14,12,13,1,5,6,8,3,0,12,13,30
419,Tony Snell,SF,23,CHI,72,22,1412,159,371,73,197,86,174,44,55,31,145,176,62,32,11,48,86,435
420,Marreese Speights,C,27,GSW,76,9,1207,318,646,5,18,313,628,150,178,109,216,325,72,20,34,82,189,791
421,Tiago Splitter,C,30,SAS,52,35,1030,169,303,0,0,169,303,90,120,91,161,252,78,35,37,60,103,428
422,Nik Stauskas,SG,21,SAC,73,1,1127,108,296,48,149,60,147,55,64,11,77,88,67,20,17,40,92,319
423,Lance Stephenson,SG,24,CHO,61,25,1573,207,550,18,105,189,445,69,110,39,238,277,240,38,8,128,134,501
424,Greg Stiemsma,C,29,TOR,17,0,66,6,8,0,0,6,8,2,4,9,6,15,3,2,0,7,15,14
425,David Stockton,PG,23,SAC,3,0,33,2,6,1,2,1,4,3,6,0,2,2,9,2,0,4,1,8
426,Jarnell Stokes,PF,21,MEM,19,2,126,21,37,0,0,21,37,15,28,16,18,34,4,5,5,7,25,57
427,Amar'e Stoudemire,PF,32,TOT,59,15,1245,273,490,0,4,273,486,134,186,110,219,329,45,29,38,78,161,680
428,Rodney Stuckey,PG,28,IND,71,36,1874,332,754,55,141,277,613,177,216,36,212,248,219,56,10,118,131,896
429,Jared Sullinger,PF,22,BOS,58,49,1566,311,708,52,184,259,524,96,129,147,294,441,134,44,42,78,153,770
430,Jeffery Taylor,SF,25,CHO,29,13,430,45,114,11,36,34,78,26,41,14,39,53,22,12,1,19,36,127
431,Jeff Teague,PG,26,ATL,73,72,2228,408,887,71,207,337,680,275,319,30,154,184,513,125,31,205,139,1162
432,Mirza Teletović,PF,29,BRK,40,4,892,122,319,62,193,60,126,33,46,27,167,194,46,14,16,53,74,339
433,Sebastian Telfair,PG,29,OKC,16,1,327,46,125,18,60,28,65,24,34,2,28,30,45,10,0,18,29,134
434,Garrett Temple,SG,28,WAS,52,18,735,68,170,33,88,35,82,35,48,24,66,90,56,42,9,34,76,204
435,Jason Terry,SG,37,HOU,77,18,1641,188,446,126,323,62,123,39,48,15,106,121,147,66,19,74,116,541
436,Isaiah Thomas,PG,25,TOT,67,1,1726,335,797,129,346,206,451,302,348,33,120,153,284,57,5,143,150,1101
438,Malcolm Thomas,PF,26,PHI,17,0,194,18,40,0,7,18,33,9,13,16,40,56,7,3,1,13,17,45
439,Tyrus Thomas,PF,28,MEM,2,0,7,1,1,0,0,1,1,2,2,0,0,0,1,0,0,0,0,4
440,Hollis Thompson,SG,23,PHI,71,23,1776,224,543,115,287,109,256,63,89,53,145,198,85,57,26,66,141,626
441,Jason Thompson,PF,28,SAC,81,63,1991,201,428,0,1,201,427,89,143,139,391,530,85,33,57,84,239,491
442,Klay Thompson,SG,24,GSW,77,77,2455,602,1299,239,545,363,754,225,256,27,220,247,222,87,60,149,122,1668
443,Tristan Thompson,PF,23,CLE,82,15,2194,267,488,0,0,267,488,159,248,274,383,657,39,34,61,83,189,693
444,Marcus Thornton,SG,27,TOT,48,0,721,140,345,54,143,86,202,46,56,23,63,86,36,27,7,27,38,380
445,Anthony Tolliver,PF,29,TOT,76,11,1432,161,393,106,290,55,103,54,69,51,185,236,59,24,16,51,137,482
446,P.J. Tucker,SF,29,PHO,78,63,2383,261,596,87,252,174,344,104,143,114,388,502,122,107,23,96,179,713
447,Ronny Turiaf,C,32,MIN,2,0,19,0,0,0,0,0,0,0,0,0,1,1,2,0,0,0,0,0
448,Hedo Türkoğlu,SF,35,LAC,62,2,705,83,188,60,139,23,49,6,11,5,94,99,37,19,7,29,66,232
449,Evan Turner,SG,26,BOS,82,57,2260,320,746,33,119,287,627,106,141,40,377,417,449,83,19,198,180,779
450,Ekpe Udoh,PF,27,LAC,33,0,128,11,24,0,0,11,24,7,9,7,19,26,8,8,7,7,20,29
451,Beno Udrih,PG,32,MEM,79,12,1494,246,505,26,97,220,408,87,102,20,123,143,220,46,8,89,88,605
452,Jonas Valančiūnas,C,22,TOR,80,80,2096,373,652,0,1,373,651,217,276,215,478,693,39,33,95,109,222,963
453,Anderson Varejão,C,32,CLE,26,26,636,111,200,0,2,111,198,33,45,57,113,170,35,19,16,35,58,255
454,Greivis Vásquez,PG,28,TOR,82,29,1991,296,725,133,351,163,374,50,66,22,194,216,302,46,10,119,177,775
455,Charlie Villanueva,PF,30,DAL,64,1,678,150,362,83,221,67,141,20,35,30,119,149,19,15,22,28,64,403
456,Noah Vonleh,PF,19,CHO,25,0,259,30,76,5,13,25,63,18,26,28,58,86,4,4,9,11,20,83
457,Nikola Vučević,C,24,ORL,74,74,2529,631,1206,2,6,629,1200,164,218,238,572,810,147,54,54,148,220,1428
458,Dwyane Wade,SG,33,MIA,62,62,1971,509,1084,29,102,480,982,284,370,58,161,219,299,73,21,209,105,1331
459,Dion Waiters,SG,23,TOT,80,23,2208,375,946,73,246,302,700,117,172,41,151,192,163,90,21,113,155,940
460,Henry Walker,SF,27,MIA,24,13,628,58,168,45,132,13,36,14,18,7,75,82,29,24,9,24,76,175
461,Kemba Walker,PG,24,CHO,62,58,2119,378,981,85,280,293,701,234,283,35,185,220,318,89,31,100,92,1075
462,John Wall,PG,24,WAS,79,79,2837,519,1166,65,217,454,949,284,362,36,330,366,792,138,45,304,180,1387
463,Gerald Wallace,SF,32,BOS,32,0,286,14,34,1,3,13,31,6,15,17,40,57,11,15,4,18,19,35
464,T.J. Warren,SF,21,PHO,40,1,614,113,214,5,21,108,193,14,19,41,44,85,25,18,9,27,51,245
465,C.J. Watson,PG,30,IND,57,21,1422,181,417,70,175,111,242,138,167,18,145,163,208,57,9,100,107,570
466,David Wear,PF,24,SAC,2,0,7,0,2,0,1,0,1,0,0,2,0,2,1,0,0,0,1,0
467,Travis Wear,SF,24,NYK,51,1,672,84,209,11,30,73,179,20,26,31,75,106,40,15,11,35,55,199
468,Martell Webster,SF,28,WAS,32,0,352,24,91,10,43,14,48,48,64,10,36,46,17,7,1,22,24,106
469,David West,PF,34,IND,66,66,1895,323,686,4,20,319,666,119,161,108,341,449,223,48,48,120,160,769
470,Russell Westbrook,PG,26,OKC,67,67,2302,627,1471,86,288,541,1183,546,654,124,364,488,574,140,14,293,184,1886
471,Hassan Whiteside,C,25,MIA,48,32,1142,243,387,0,0,243,387,78,156,145,337,482,6,27,123,58,129,564
472,Shayne Whittington,PF,23,IND,20,0,108,19,42,1,6,18,36,18,23,10,19,29,6,5,2,5,18,57
473,Andrew Wiggins,SF,19,MIN,82,82,2969,497,1137,39,126,458,1011,354,466,134,240,374,170,86,50,177,190,1387
474,C.J. Wilcox,SG,24,LAC,21,0,101,16,38,7,19,9,19,2,2,1,6,7,8,3,1,10,7,41
475,Deron Williams,PG,30,BRK,68,55,2114,298,771,87,237,211,534,201,241,29,208,237,448,64,17,154,157,884
476,Derrick Williams,PF,23,SAC,74,6,1462,217,485,49,156,168,329,134,196,41,161,202,50,34,4,56,67,617
477,Elliot Williams,SG,25,TOT,13,0,119,14,37,8,18,6,19,1,4,0,8,8,12,4,0,4,12,37
478,Lou Williams,SG,28,TOR,80,0,2016,375,928,152,447,223,481,340,395,24,127,151,164,88,10,101,103,1242
479,Marvin Williams,PF,28,CHO,78,37,2035,210,495,95,265,115,230,62,87,58,328,386,100,69,36,60,146,577
480,Mo Williams,PG,32,TOT,68,33,1980,341,860,119,348,222,512,163,187,22,152,174,424,46,14,172,162,964
481,Reggie Williams,SF,28,SAS,20,0,105,15,39,3,19,12,20,4,4,5,12,17,10,1,0,2,12,37
482,Shawne Williams,SF,28,TOT,63,22,1087,121,300,64,178,57,122,35,40,36,130,166,44,25,21,30,135,341
483,Jeff Withey,C,24,NOP,37,0,259,32,64,0,0,32,64,34,50,23,41,64,11,4,18,12,26,98
484,Nate Wolters,PG,23,TOT,21,0,247,20,57,0,7,20,50,2,6,8,26,34,21,8,2,13,18,42
485,Brandan Wright,PF,27,TOT,75,7,1449,233,363,0,3,233,360,78,112,128,193,321,41,50,94,34,102,544
486,Dorell Wright,SF,29,POR,48,2,592,72,190,41,108,31,82,34,42,14,97,111,41,20,11,18,55,219
487,Tony Wroten,PG,21,PHI,30,15,895,175,434,37,142,138,292,120,180,22,64,86,157,48,8,113,72,507
488,James Young,SG,19,BOS,31,0,332,36,102,17,66,19,36,16,29,9,33,42,13,8,2,5,22,105
489,Nick Young,SG,29,LAL,42,0,1000,174,476,83,225,91,251,132,148,17,79,96,41,23,11,44,83,563
490,Thaddeus Young,PF,26,TOT,76,68,2434,451,968,38,115,413,853,131,200,127,284,411,173,124,25,117,171,1071
491,Cody Zeller,C,22,CHO,62,45,1487,172,373,1,1,171,372,127,164,97,265,362,100,34,49,62,156,472
492,Tyler Zeller,C,25,BOS,82,59,1731,340,619,0,0,340,619,153,186,146,319,465,113,18,52,76,205,833
1,Quincy Acy,PF,25,SAC,59,29,876,119,214,19,49,100,165,50,68,65,123,188,27,29,24,27,103,307
2,Jordan Adams,SG,21,MEM,2,0,15,2,6,0,1,2,5,3,5,0,2,2,3,3,0,2,2,7
3,Steven Adams,C,22,OKC,80,80,2014,261,426,0,0,261,426,114,196,219,314,533,62,42,89,84,223,636
4,Arron Afflalo,SG,30,NYK,71,57,2371,354,799,91,238,263,561,110,131,23,243,266,144,25,10,82,142,909
5,Alexis Ajinça,C,27,NOP,59,17,861,150,315,0,1,150,314,52,62,75,194,269,31,19,36,54,134,352
6,Cole Aldrich,C,27,LAC,60,5,800,134,225,0,0,134,225,60,84,86,202,288,50,47,68,64,139,328
7,LaMarcus Aldridge,PF,30,SAS,74,74,2261,536,1045,0,16,536,1029,259,302,176,456,632,110,38,81,99,151,1331
8,Cliff Alexander,PF,20,POR,8,0,36,5,10,0,0,5,10,0,0,2,4,6,0,1,2,1,1,10
9,Lavoy Allen,PF,26,IND,79,28,1599,191,370,0,0,191,370,46,73,162,262,424,76,26,42,69,147,428
10,Tony Allen,SG,34,MEM,64,57,1620,215,469,15,42,200,427,90,138,104,192,296,70,110,18,78,175,535
11,Al-Farouq Aminu,SF,25,POR,82,82,2341,299,719,126,349,173,370,115,156,98,401,499,138,72,53,120,171,839
12,Lou Amundson,PF,33,NYK,29,0,204,19,53,0,0,19,53,14,27,23,26,49,12,6,7,15,44,52
13,Chris Andersen,C,37,TOT,27,15,402,38,72,4,14,34,58,25,36,36,62,98,12,15,13,9,29,105
14,Alan Anderson,SG,33,WAS,13,0,192,21,59,12,37,9,22,11,15,1,26,27,14,4,1,2,25,65
15,James Anderson,SG,26,SAC,51,15,721,67,178,23,86,44,92,22,29,13,73,86,41,21,14,42,54,179
16,Justin Anderson,SF,22,DAL,55,9,647,71,175,22,83,49,92,44,55,18,114,132,29,19,25,24,45,208
17,Kyle Anderson,SF,22,SAS,78,11,1245,138,295,12,37,126,258,62,83,25,219,244,123,60,29,59,97,350
18,Ryan Anderson,PF,27,NOP,66,7,2008,397,929,131,358,266,571,199,228,131,265,396,73,38,25,90,109,1124
19,Giannis Antetokounmpo,PG,21,MIL,80,79,2823,513,1013,28,109,485,904,296,409,113,499,612,345,94,113,208,258,1350
20,Thanasis Antetokounmpo,SF,23,NYK,2,0,6,3,4,0,1,3,3,0,0,0,1,1,0,0,0,0,2,6
21,Carmelo Anthony,SF,31,NYK,72,72,2530,567,1307,105,310,462,997,334,403,98,458,556,299,62,38,176,180,1573
22,Joel Anthony,C,33,DET,19,0,96,6,10,0,0,6,10,6,8,8,13,21,1,2,12,2,15,18
23,Keith Appling,PG,23,ORL,5,0,27,2,8,0,3,2,5,2,2,0,1,1,1,1,0,3,5,6
24,Trevor Ariza,SF,30,HOU,81,81,2859,357,859,185,499,172,360,126,161,67,299,366,188,160,26,113,177,1025
25,Darrell Arthur,PF,27,DEN,70,16,1516,221,489,45,117,176,372,40,53,86,207,293,96,53,48,66,185,527
26,Ömer Aşık,C,29,NOP,68,64,1178,104,195,0,0,104,195,61,112,120,294,414,26,21,23,60,124,269
27,D.J. Augustin,PG,28,TOT,62,0,1178,148,350,68,168,80,182,103,128,8,87,95,198,38,4,84,85,467
28,Jeff Ayres,C,28,LAC,17,0,107,12,23,0,1,12,22,6,6,4,18,22,5,0,3,6,18,30
29,Luke Babbitt,SF,26,NOP,47,13,845,122,289,44,109,78,180,39,50,25,123,148,53,11,7,23,90,327
30,Cameron Bairstow,C,25,CHI,18,2,103,13,40,1,5,12,35,7,8,4,24,28,6,2,3,4,19,34
31,Leandro Barbosa,SG,33,GSW,68,0,1079,171,370,39,110,132,260,52,62,28,89,117,82,44,10,53,107,433
32,J.J. Barea,PG,31,DAL,74,16,1667,317,711,100,260,217,451,74,96,26,126,152,302,26,2,113,110,808
33,Andrea Bargnani,C,30,BRK,46,0,634,127,279,3,16,124,263,47,57,28,69,97,18,4,9,26,61,304
34,Harrison Barnes,SF,23,GSW,66,59,2042,295,633,82,214,213,419,102,134,77,248,325,117,41,10,57,136,774
35,Matt Barnes,SF,35,MEM,76,45,2190,264,693,119,370,145,323,111,138,84,336,420,163,78,57,121,234,758
36,Will Barton,SG,25,DEN,82,1,2353,425,983,112,325,313,658,216,268,59,417,476,203,71,39,139,147,1178
37,Brandon Bass,PF,30,LAL,66,0,1342,174,317,0,2,174,315,125,148,104,181,285,74,33,55,42,125,473
38,Nicolas Batum,SF,27,CHO,70,70,2448,372,873,139,399,233,474,163,192,55,373,428,403,65,43,205,114,1046
39,Jerryd Bayless,SG,27,MIL,52,18,1505,185,437,101,231,84,206,70,90,21,120,141,163,47,11,73,111,541
40,Aron Baynes,C,29,DET,81,1,1233,194,384,0,2,194,382,126,165,140,244,384,51,21,52,67,151,514
41,Kent Bazemore,SF,26,ATL,75,68,2083,320,725,109,305,211,420,123,151,28,351,379,171,98,38,138,176,872
42,Bradley Beal,SG,22,WAS,55,35,1708,359,799,105,271,254,528,135,176,41,147,188,162,54,11,112,117,958
43,Michael Beasley,PF,27,HOU,20,0,363,107,205,3,9,104,196,38,49,29,69,98,16,11,9,24,39,255
44,Marco Belinelli,SG,29,SAC,68,7,1672,245,635,91,297,154,338,115,138,10,107,117,127,37,2,80,91,696
45,Anthony Bennett,PF,22,TOR,19,0,84,8,27,3,14,5,13,9,10,6,17,23,0,5,0,4,8,28
46,Patrick Beverley,PG,27,HOU,71,63,2041,258,594,124,310,134,284,60,88,73,177,250,239,94,26,91,234,700
47,Bismack Biyombo,C,23,TOR,82,22,1808,156,288,0,1,156,287,142,226,182,473,655,29,19,133,71,225,454
48,Nemanja Bjelica,PF,27,MIN,60,0,1075,110,235,48,125,62,110,40,55,49,161,210,83,26,21,47,154,308
49,Tarik Black,C,24,LAL,39,0,496,57,104,0,0,57,104,19,45,44,113,157,16,14,18,22,78,133
50,DeJuan Blair,C,26,WAS,29,0,218,28,68,0,1,28,67,5,13,20,37,57,11,8,2,15,53,61
51,Steve Blake,PG,35,DET,58,2,986,93,240,52,151,41,89,16,20,9,80,89,200,24,5,81,70,254
52,Eric Bledsoe,PG,26,PHO,31,31,1059,223,492,48,129,175,363,138,172,18,107,125,190,63,19,110,75,632
53,Bojan Bogdanović,SF,26,BRK,79,39,2115,324,749,129,338,195,411,110,132,36,219,255,99,29,5,115,119,887
54,Andrew Bogut,C,31,GSW,70,66,1451,175,279,1,1,174,278,24,50,121,371,492,162,33,114,83,221,375
55,Matt Bonner,C,35,SAS,30,2,206,29,57,15,34,14,23,3,4,3,24,27,9,6,1,3,16,76
56,Devin Booker,SG,19,PHO,76,51,2108,367,867,99,289,268,578,215,256,27,160,187,200,44,20,160,225,1048
57,Trevor Booker,PF,28,UTA,79,2,1632,190,388,12,41,178,347,71,106,166,286,452,84,59,41,81,169,463
58,Chris Bosh,PF,31,MIA,53,53,1778,358,767,81,222,277,545,213,268,48,342,390,128,36,34,78,101,1010
59,Avery Bradley,SG,25,BOS,76,72,2536,456,1019,147,407,309,612,96,123,48,172,220,158,117,19,109,164,1155
60,Elton Brand,C,36,PHI,17,1,225,31,72,0,1,31,71,8,9,9,54,63,18,9,8,11,32,70
61,Corey Brewer,SF,29,HOU,82,12,1669,212,552,61,224,151,328,105,140,42,157,199,109,84,19,78,168,590
62,Aaron Brooks,PG,31,CHI,69,0,1108,188,469,66,185,122,284,49,64,21,80,101,180,30,10,82,132,491
63,Anthony Brown,SF,23,LAL,29,11,599,39,126,20,70,19,56,17,20,9,61,70,19,14,5,15,34,115
64,Lorenzo Brown,PG,25,PHO,8,0,61,8,25,1,8,7,17,3,4,0,7,7,11,3,1,9,4,20
65,Markel Brown,SG,24,BRK,62,6,982,127,322,38,121,89,201,71,94,23,99,122,91,38,15,54,94,363
66,Kobe Bryant,SF,37,LAL,66,66,1863,398,1113,133,467,265,646,232,281,41,206,247,184,62,13,129,115,1161
67,Chase Budinger,SF,27,TOT,66,2,929,104,239,24,86,80,153,39,56,43,107,150,64,32,10,44,62,271
68,Reggie Bullock,SF,24,DET,37,0,429,43,98,22,53,21,45,14,15,14,54,68,27,10,2,8,29,122
69,Trey Burke,PG,23,UTA,64,0,1366,262,634,88,256,174,378,67,82,18,94,112,148,35,6,80,86,679
70,Alec Burks,SG,24,UTA,31,3,797,137,334,32,79,105,255,106,141,16,93,109,63,18,4,51,71,412
71,Caron Butler,SF,35,SAC,17,1,176,25,59,3,18,22,41,10,12,5,17,22,10,9,1,3,19,63
72,Jimmy Butler,SG,26,CHI,67,67,2474,470,1035,64,205,406,830,395,475,79,279,358,321,110,43,132,124,1399
73,Rasual Butler,SF,36,SAS,46,0,432,49,104,15,49,34,55,11,16,3,53,56,24,13,23,8,11,124
74,Bruno Caboclo,SF,20,TOR,6,1,43,1,12,1,7,0,5,0,0,1,1,2,1,2,1,4,2,3
75,José Calderón,PG,34,NYK,72,72,2024,209,455,84,203,125,252,42,48,22,207,229,298,63,7,87,135,544
76,Kentavious Caldwell-Pope,SG,22,DET,76,76,2789,403,960,114,369,289,591,185,228,70,212,282,138,110,17,105,167,1105
77,Isaiah Canaan,SG,24,PHI,77,39,1966,260,722,176,485,84,237,150,180,20,154,174,137,56,12,91,133,846
78,Clint Capela,C,21,HOU,77,35,1471,231,397,0,1,231,396,80,211,194,300,494,47,59,92,60,190,542
79,DeMarre Carroll,SF,29,TOR,26,22,786,105,270,46,118,59,152,30,50,31,91,122,27,44,6,28,63,286
80,Vince Carter,SG,39,MEM,60,3,1005,133,343,59,169,74,174,70,84,31,115,146,56,38,16,35,101,395
81,Michael Carter-Williams,PG,24,MIL,54,37,1649,251,555,15,55,236,500,106,162,48,228,276,281,80,41,153,162,623
82,Omri Casspi,PF,27,SAC,69,21,1880,299,622,112,274,187,348,103,159,58,352,410,95,56,17,94,154,813
83,Willie Cauley-Stein,C,22,SAC,66,39,1412,191,339,0,2,191,337,81,125,134,218,352,37,48,66,46,146,463
84,Mario Chalmers,PG,29,TOT,61,7,1373,182,444,46,149,136,295,218,262,24,133,157,230,88,13,110,181,628
85,Tyson Chandler,C,33,PHO,66,60,1618,183,314,0,1,183,313,106,171,175,401,576,64,36,44,93,145,472
86,Rakeem Christmas,PF,24,IND,1,0,6,2,2,0,0,2,2,0,0,1,0,1,0,0,0,0,1,4
87,Ian Clark,SG,24,GSW,66,1,578,89,202,30,84,59,118,28,34,13,55,68,64,17,13,43,58,236
88,Coty Clarke,SF,23,BOS,3,0,6,2,4,2,2,0,2,0,0,0,1,1,0,0,0,1,0,6
89,Jordan Clarkson,SG,23,LAL,79,79,2552,475,1098,111,320,364,778,164,204,93,220,313,192,88,7,135,168,1225
90,Norris Cole,PG,27,NOP,45,23,1198,196,484,33,102,163,382,52,65,10,141,151,167,37,5,75,102,477
91,Darren Collison,PG,28,SAC,74,15,2219,377,776,87,217,290,559,194,226,28,141,169,318,76,4,130,142,1035
92,Nick Collison,PF,35,OKC,59,4,699,50,109,0,2,50,107,23,33,68,103,171,52,15,16,50,107,123
93,Mike Conley,PG,28,MEM,56,56,1761,294,696,78,215,216,481,191,229,26,138,164,342,67,16,84,100,857
94,Pat Connaughton,SG,23,POR,34,0,143,13,49,5,21,8,28,5,5,11,21,32,10,2,0,10,6,36
95,Chris Copeland,PF,31,MIL,24,1,156,17,51,10,36,7,15,6,7,1,9,10,11,2,0,6,17,50
96,Bryce Cotton,PG,23,TOT,8,0,39,4,10,0,3,4,7,0,0,0,0,0,3,3,0,5,2,8
97,DeMarcus Cousins,C,25,SAC,65,65,2246,601,1332,70,210,531,1122,476,663,158,589,747,214,101,92,249,236,1748
98,Robert Covington,SF,25,PHI,67,49,1903,274,712,170,482,104,230,140,177,65,354,419,97,105,40,143,232,858
99,Allen Crabbe,SG,23,POR,81,8,2105,311,678,112,285,199,393,98,113,27,189,216,99,63,16,64,192,832
100,Jamal Crawford,SG,35,LAC,79,5,2126,379,939,117,344,262,595,245,271,20,125,145,183,52,12,113,122,1120
101,Jae Crowder,SF,25,BOS,73,73,2308,360,813,122,363,238,450,196,239,70,303,373,135,126,35,83,198,1038
102,Dante Cunningham,SF,28,NOP,80,46,1971,186,412,55,174,131,238,57,82,57,179,236,77,42,33,41,173,484
103,Jared Cunningham,SG,24,TOT,44,3,410,36,105,12,39,24,66,36,55,3,35,38,20,14,2,21,41,120
104,Seth Curry,PG,25,SAC,44,9,692,102,224,50,111,52,113,45,54,9,51,60,67,22,3,36,41,299
105,Stephen Curry,PG,27,GSW,79,79,2700,805,1598,402,886,403,712,363,400,68,362,430,527,169,15,262,161,2375
106,Troy Daniels,SG,24,CHO,43,0,476,89,187,59,122,30,65,5,9,7,50,57,21,11,3,24,40,242
107,Anthony Davis,C,22,NOP,61,61,2164,560,1136,35,108,525,1028,326,430,130,497,627,116,78,125,121,148,1481
108,Ed Davis,PF,26,POR,81,0,1684,206,337,0,0,206,337,114,204,224,375,599,88,57,72,64,202,526
109,Branden Dawson,PF,22,LAC,6,0,29,2,5,0,0,2,5,1,1,2,2,4,0,0,1,0,2,5
110,Dewayne Dedmon,C,26,ORL,58,20,705,99,177,0,0,99,177,57,76,67,161,228,13,22,46,32,109,255
111,Bryce Dejean-Jones,SG,23,NOP,14,11,279,28,69,12,32,16,37,11,21,8,40,48,15,10,2,11,17,79
112,Sam Dekker,PF,21,HOU,3,0,6,0,0,0,0,0,0,0,0,0,1,1,0,1,0,0,0,0
113,Matthew Dellavedova,PG,25,CLE,76,14,1867,207,511,98,239,109,272,57,66,33,129,162,337,44,9,116,178,569
114,Luol Deng,PF,30,MIA,74,73,2394,339,745,88,256,251,489,145,192,108,335,443,140,74,29,81,122,911
115,DeMar DeRozan,SG,26,TOR,78,78,2804,614,1377,47,139,567,1238,555,653,64,285,349,315,81,21,175,167,1830
116,Boris Diaw,PF,33,SAS,76,4,1386,202,383,25,69,177,314,56,76,58,175,233,176,26,21,97,102,485
117,Gorgui Dieng,C,26,MIN,82,39,2220,308,579,6,20,302,559,205,248,157,428,585,143,94,96,140,219,827
118,Spencer Dinwiddie,PG,22,DET,12,0,159,19,54,1,10,18,44,19,33,4,13,17,22,3,0,7,20,58
119,Toney Douglas,PG,29,NOP,61,18,1262,183,445,81,203,102,242,84,99,25,118,143,157,70,5,64,131,531
120,Goran Dragić,PG,29,MIA,72,72,2363,417,875,64,205,353,670,120,165,54,223,277,419,71,17,185,188,1018
121,Andre Drummond,C,22,DET,81,81,2666,552,1060,2,6,550,1054,208,586,395,803,1198,67,119,112,155,245,1314
122,Jared Dudley,PF,30,WAS,81,41,2098,233,487,100,238,133,249,72,98,54,232,286,170,75,18,80,190,638
123,Duje Dukan,SF,24,SAC,1,0,24,2,10,2,5,0,5,0,0,2,2,4,1,1,0,0,2,6
124,Tim Duncan,C,39,SAS,61,60,1536,215,441,0,2,215,439,92,131,115,332,447,163,47,78,90,125,522
125,Mike Dunleavy,SF,35,CHI,31,30,703,77,188,39,99,38,89,29,37,8,75,83,39,14,10,26,66,222
126,Kevin Durant,SF,27,OKC,72,72,2578,698,1381,186,481,512,900,447,498,45,544,589,361,69,85,250,137,2029
127,Cleanthony Early,SF,24,NYK,17,2,154,12,40,4,15,8,25,3,4,4,22,26,6,2,3,9,16,31
128,Jarell Eddie,SF,24,WAS,26,0,147,20,65,15,47,5,18,8,8,2,21,23,5,5,1,1,5,63
129,Wayne Ellington,SG,28,BRK,76,41,1615,218,561,96,268,122,293,54,63,20,154,174,83,48,5,45,82,586
130,Monta Ellis,SG,30,IND,81,81,2734,436,1021,87,282,349,739,162,206,42,229,271,383,150,37,203,174,1121
131,James Ennis,SF,25,TOT,22,5,329,54,113,26,58,28,55,25,34,21,21,42,21,16,5,19,28,159
132,Tyler Ennis,PG,21,MIL,46,7,654,84,187,13,39,71,148,25,34,13,62,75,95,25,1,46,64,206
133,Jeremy Evans,SF,28,DAL,30,2,251,26,48,4,16,22,32,15,21,11,43,54,2,6,9,7,19,71
134,Tyreke Evans,SG,26,NOP,25,25,765,136,314,33,85,103,229,74,93,20,109,129,164,32,8,73,66,379
135,Festus Ezeli,C,26,GSW,46,13,770,125,228,0,0,125,228,70,132,91,166,257,32,18,50,38,94,320
136,Kenneth Faried,PF,26,DEN,67,64,1694,349,626,1,2,348,624,136,222,235,346,581,79,32,60,91,169,835
137,Jordan Farmar,PG,29,MEM,12,10,291,42,100,16,45,26,55,10,10,4,21,25,37,15,2,18,22,110
138,Derrick Favors,PF,24,UTA,62,59,1983,418,811,0,4,418,807,180,254,169,334,503,94,74,91,104,150,1016
139,Cristiano Felício,C,23,CHI,31,4,321,40,72,0,4,40,68,25,35,30,72,102,26,6,13,13,31,105
140,Raymond Felton,PG,31,DAL,80,31,2192,277,682,60,213,217,469,149,176,36,222,258,284,68,15,121,141,763
141,Evan Fournier,SF,23,ORL,79,71,2566,429,929,156,390,273,539,199,238,33,192,225,213,96,2,133,214,1213
142,Randy Foye,SG,32,TOT,81,8,1642,169,482,75,250,94,232,61,74,24,132,156,161,39,29,86,131,474
143,Tim Frazier,PG,25,TOT,51,2,741,96,229,16,48,80,181,53,74,26,84,110,162,33,2,65,73,261
144,Jimmer Fredette,SG,26,TOT,6,0,18,2,5,1,2,1,3,4,5,0,0,0,1,1,0,2,2,9
146,Danilo Gallinari,SF,27,DEN,53,53,1839,287,700,87,239,200,461,375,432,52,229,281,135,42,19,77,87,1036
147,Langston Galloway,PG,24,NYK,82,7,2033,231,588,77,224,154,364,86,114,43,245,288,207,77,22,61,177,625
148,Kevin Garnett,PF,39,MIN,38,38,556,54,115,0,1,54,114,14,21,15,135,150,62,28,10,16,70,122
149,Marc Gasol,C,31,MEM,52,52,1791,328,707,2,3,326,704,203,245,58,304,362,196,50,70,118,141,861
150,Pau Gasol,C,35,CHI,72,72,2291,467,995,24,69,443,926,229,289,155,638,793,294,42,146,164,148,1187
151,Rudy Gay,SF,29,SAC,70,70,2379,466,1007,74,215,392,792,198,254,103,353,456,120,100,51,139,184,1204
152,Alonzo Gee,SF,28,NOP,73,38,1632,132,255,17,60,115,195,44,66,60,185,245,72,63,13,55,169,325
153,Paul George,SF,25,IND,81,81,2819,605,1449,210,566,395,883,454,528,79,484,563,329,152,29,265,230,1874
154,Taj Gibson,PF,30,CHI,73,55,1936,263,500,0,3,263,497,101,146,206,298,504,106,47,77,78,180,627
155,Manu Ginóbili,SG,38,SAS,58,0,1134,197,435,70,179,127,256,91,112,26,120,146,177,66,11,99,99,555
156,Rudy Gobert,C,23,UTA,61,60,1932,198,354,0,0,198,354,161,283,208,460,668,91,45,135,114,163,557
157,Drew Gooden,PF,34,WAS,30,0,305,33,103,7,41,26,62,9,14,28,57,85,13,8,11,13,40,82
158,Archie Goodwin,PG,21,PHO,57,13,1114,176,422,23,99,153,323,130,193,27,115,142,118,27,13,100,84,505
159,Aaron Gordon,PF,20,ORL,78,37,1863,274,579,42,142,232,437,129,193,154,353,507,128,59,55,66,153,719
160,Eric Gordon,SG,27,NOP,45,44,1481,231,552,113,294,118,258,111,125,10,89,99,121,43,14,73,98,686
161,Marcin Gortat,C,31,WAS,75,74,2256,433,764,0,1,433,763,146,207,222,519,741,106,47,96,121,193,1012
162,Andrew Goudelock,PG,27,HOU,8,0,50,9,20,1,9,8,11,3,4,1,1,2,4,6,2,7,4,22
163,Jerami Grant,PF,21,PHI,77,52,2066,251,599,35,146,216,453,212,322,99,262,361,135,54,127,110,215,749
164,Jerian Grant,PG,23,NYK,76,6,1265,154,391,22,100,132,291,96,123,23,120,143,177,50,10,87,97,426
165,Danny Green,SG,28,SAS,79,79,2062,211,561,116,349,95,212,34,46,48,255,303,141,79,64,75,141,572
166,Draymond Green,PF,25,GSW,81,81,2808,401,819,100,258,301,561,229,329,134,635,769,598,119,113,259,240,1131
167,Erick Green,PG,24,TOT,9,0,42,5,13,1,5,4,8,2,2,3,3,6,3,1,0,0,4,13
168,Gerald Green,SG,30,MIA,69,14,1557,230,587,84,260,146,327,72,92,25,138,163,56,38,19,46,123,616
169,JaMychal Green,PF,25,MEM,78,15,1446,230,495,15,45,215,450,103,137,139,234,373,67,46,33,83,189,578
170,Jeff Green,SF,29,TOT,80,41,2253,354,824,67,213,287,611,164,220,74,258,332,138,58,40,93,164,939
171,Blake Griffin,PF,26,LAC,35,35,1170,301,603,6,18,295,585,141,194,51,243,294,170,28,17,83,95,749
172,Jorge Gutiérrez,PG,27,CHO,12,0,63,6,11,0,2,6,9,10,11,0,7,7,17,3,0,6,3,22
173,P.J. Hairston,SF,23,TOT,66,52,1313,145,408,70,241,75,167,50,64,25,149,174,38,32,11,41,137,410
174,Jordan Hamilton,SF,25,NOP,11,4,304,49,116,13,45,36,71,14,21,12,50,62,25,8,3,17,24,125
175,Tyler Hansbrough,PF,30,CHO,44,0,343,32,71,2,3,30,68,38,65,40,49,89,8,12,7,12,55,104
176,Tim Hardaway,SG,23,ATL,51,1,864,114,265,48,142,66,123,50,56,7,79,86,51,21,7,23,48,326
177,James Harden,SG,26,HOU,82,82,3125,710,1617,236,657,474,960,720,837,63,438,501,612,139,51,374,229,2376
178,Maurice Harkless,SF,22,POR,78,14,1457,195,411,39,140,156,271,69,111,101,179,280,67,49,35,62,124,498
179,Justin Harper,PF,26,DET,5,0,35,4,10,4,9,0,1,1,2,0,1,1,0,1,0,2,3,13
180,Montrezl Harrell,PF,22,HOU,39,1,379,58,90,0,1,58,89,24,46,25,40,65,17,11,11,17,48,140
181,Devin Harris,PG,32,DAL,64,0,1280,167,374,52,158,115,216,101,140,18,120,138,118,60,13,66,124,487
182,Gary Harris,SG,21,DEN,76,76,2439,359,765,105,297,254,468,109,133,54,166,220,147,97,18,98,143,932
183,Joe Harris,SG,24,CLE,5,0,15,1,4,1,4,0,0,0,0,0,3,3,2,0,0,1,1,3
184,Tobias Harris,PF,23,TOT,76,74,2513,417,889,80,239,337,650,202,243,96,414,510,169,65,40,108,153,1116
185,Aaron Harrison,SG,21,CHO,21,0,93,5,19,3,10,2,9,5,12,4,11,15,2,6,0,4,10,18
186,Udonis Haslem,PF,35,MIA,37,0,260,23,61,1,9,22,52,12,16,10,65,75,14,5,2,5,25,59
187,Spencer Hawes,PF,27,CHO,57,6,1035,124,306,38,102,86,204,54,65,51,193,244,109,22,27,58,111,340
188,Chuck Hayes,C,32,HOU,2,0,24,1,2,0,0,1,2,2,2,0,8,8,2,0,0,3,6,4
189,Gordon Hayward,SF,25,UTA,80,80,2893,521,1202,143,410,378,792,393,477,61,336,397,296,95,27,202,183,1578
190,Gerald Henderson,SG,28,POR,72,0,1431,232,529,48,136,184,393,112,146,30,181,211,75,39,19,68,87,624
191,John Henson,C,25,MIL,57,1,960,164,291,0,1,164,290,69,117,87,134,221,54,18,109,64,131,397
192,Mario Hezonja,SF,20,ORL,79,9,1413,181,418,67,192,114,226,49,54,28,148,176,109,39,17,97,124,478
193,Roy Hibbert,C,29,LAL,81,81,1878,182,411,0,2,182,409,117,145,132,266,398,95,32,110,76,252,481
194,J.J. Hickson,C,27,TOT,35,9,436,80,155,0,1,80,154,46,103,39,93,132,23,15,14,25,47,206
195,Nenê Hilário,PF,33,WAS,57,11,1094,209,384,0,3,209,381,107,185,52,207,259,97,54,26,76,156,525
196,George Hill,PG,29,IND,74,73,2524,326,739,128,314,198,425,114,150,58,240,298,259,83,17,101,149,894
197,Jordan Hill,C,28,IND,73,11,1513,278,549,0,1,278,548,89,125,156,295,451,87,36,37,92,155,645
198,Solomon Hill,SF,24,IND,59,3,866,93,208,24,74,69,134,36,42,39,127,166,57,37,11,33,68,246
199,Darrun Hilliard,SG,22,DET,38,2,383,52,131,19,50,33,81,29,40,5,40,45,27,9,1,19,28,152
200,Kirk Hinrich,PG,35,TOT,46,7,631,49,129,24,62,25,67,15,16,8,62,70,73,15,2,30,64,137
201,Jrue Holiday,PG,25,NOP,65,23,1831,410,935,87,259,323,676,182,216,27,168,195,391,88,22,167,148,1089
202,Justin Holiday,SG,26,TOT,53,5,773,88,228,36,105,52,123,27,37,12,78,90,56,32,19,39,61,239
203,Ryan Hollins,C,31,TOT,37,12,460,49,79,0,0,49,79,26,42,47,51,98,10,6,21,24,62,124
204,Rondae Hollis-Jefferson,SF,21,BRK,29,17,615,63,138,4,14,59,124,37,52,39,115,154,43,39,16,26,61,167
205,Richaun Holmes,PF,22,PHI,51,1,702,114,222,8,44,106,178,51,74,62,73,135,33,19,40,32,92,287
206,Rodney Hood,SG,23,UTA,79,79,2541,408,972,161,449,247,523,172,200,38,229,267,213,73,16,125,202,1149
207,Al Horford,C,29,ATL,82,82,2631,529,1048,88,256,441,792,103,129,148,448,596,263,68,121,107,163,1249
208,Dwight Howard,C,30,HOU,71,71,2280,372,600,0,6,372,594,232,474,238,597,835,98,69,113,166,219,976
209,Marcelo Huertas,PG,32,LAL,53,0,869,97,230,16,61,81,169,27,29,18,72,90,182,26,7,80,76,237
210,Josh Huestis,PF,24,OKC,5,0,55,5,12,4,6,1,6,0,4,2,8,10,0,1,2,3,3,14
211,Kris Humphries,PF,30,TOT,53,17,835,121,295,34,108,87,187,67,84,57,161,218,36,16,23,38,94,343
212,R.J. Hunter,SG,22,BOS,36,0,315,36,98,19,63,17,35,6,7,2,35,37,13,14,4,11,29,97
213,Serge Ibaka,PF,26,OKC,78,78,2500,416,869,60,184,356,685,91,121,141,392,533,66,38,148,108,211,983
214,Andre Iguodala,SF,32,GSW,65,1,1732,176,368,54,154,122,214,51,83,52,211,263,219,73,19,79,102,457
215,Ersan İlyasova,PF,28,TOT,74,56,1881,280,661,96,259,184,402,111,154,144,259,403,67,52,33,71,171,767
216,Joe Ingles,SF,28,UTA,81,2,1241,124,291,81,210,43,81,13,18,19,132,151,96,55,4,65,98,342
217,Damien Inglis,SF,20,MIL,20,1,156,13,37,3,13,10,24,7,8,2,29,31,10,6,3,11,11,36
218,Kyrie Irving,PG,23,CLE,53,53,1667,394,879,84,262,310,617,169,191,44,113,157,249,56,18,124,107,1041
219,Jarrett Jack,PG,32,BRK,32,32,1027,140,358,31,102,109,256,100,112,9,127,136,236,34,7,94,77,411
220,Reggie Jackson,PG,25,DET,79,79,2424,540,1244,118,334,422,910,291,337,58,195,253,492,59,11,223,187,1489
221,LeBron James,SF,31,CLE,76,76,2709,737,1416,87,282,650,1134,359,491,111,454,565,514,104,49,249,143,1920
222,Al Jefferson,C,31,CHO,47,18,1096,245,505,0,0,245,505,72,111,57,244,301,70,30,41,34,117,562
223,Cory Jefferson,PF,25,PHO,8,0,50,9,22,0,1,9,21,4,6,6,10,16,0,0,1,0,8,22
224,Richard Jefferson,SF,35,CLE,74,5,1326,143,312,66,173,77,139,58,87,15,113,128,59,33,14,43,129,410
225,John Jenkins,SG,24,TOT,43,3,480,71,160,16,51,55,109,20,24,8,49,57,35,8,1,27,22,178
226,Brandon Jennings,PG,26,TOT,48,7,868,112,304,51,155,61,149,57,78,16,80,96,170,29,7,57,57,332
227,Jonas Jerebko,PF,28,BOS,78,0,1176,118,286,43,108,75,178,61,78,77,211,288,62,20,24,52,137,340
228,Amir Johnson,PF,28,BOS,79,76,1800,249,426,10,43,239,383,69,121,178,327,505,138,52,83,94,214,577
229,Chris Johnson,SF,25,UTA,70,2,857,72,194,27,99,45,95,34,42,27,105,132,45,32,20,40,100,205
230,James Johnson,PF,28,TOR,57,32,926,114,240,20,66,94,174,39,68,28,98,126,67,29,33,54,84,287
231,Joe Johnson,SF,34,TOT,81,81,2703,377,859,120,313,257,546,118,142,49,243,292,318,61,4,159,146,992
232,Orlando Johnson,SG,26,TOT,7,1,101,9,34,2,10,7,24,6,8,4,11,15,2,3,3,4,9,26
233,Stanley Johnson,SF,19,DET,73,6,1687,225,600,63,205,162,395,80,102,58,248,306,118,55,12,114,178,593
234,Tyler Johnson,SG,23,MIA,36,5,863,118,243,27,71,91,172,51,64,28,81,109,79,24,14,47,66,314
235,Wesley Johnson,SF,28,LAC,80,9,1666,208,515,103,309,105,206,30,46,37,211,248,49,89,56,54,173,549
236,Nikola Jokić,C,20,DEN,80,55,1733,307,600,28,84,279,516,154,190,181,379,560,189,79,50,104,208,796
237,Dahntay Jones,SF,35,CLE,1,0,42,6,14,1,2,5,12,0,0,1,4,5,2,1,2,0,6,13
238,James Jones,SF,35,CLE,48,0,463,58,142,41,104,17,38,21,26,8,42,50,14,11,10,13,50,178
239,Terrence Jones,PF,24,HOU,50,11,1044,166,367,25,79,141,288,77,116,62,149,211,41,23,39,49,86,434
240,Tyus Jones,PG,19,MIN,37,0,573,56,156,16,53,40,103,28,39,7,40,47,108,31,3,33,33,156
241,DeAndre Jordan,C,27,LAC,77,77,2598,357,508,0,1,357,507,266,619,267,792,1059,90,51,177,107,207,980
242,Cory Joseph,SG,24,TOR,80,4,2046,257,585,30,110,227,475,133,174,39,171,210,250,63,20,102,131,677
243,Chris Kaman,C,33,POR,16,2,112,20,43,1,4,19,39,3,3,7,17,24,11,1,1,8,15,44
244,Frank Kaminsky,C,22,CHO,81,3,1708,215,525,68,202,147,323,108,148,69,266,335,98,38,43,58,126,606
245,Enes Kanter,C,23,OKC,82,1,1721,414,719,10,21,404,698,200,251,249,415,664,33,26,33,115,166,1038
246,Sergey Karasev,SF,22,BRK,40,5,399,30,74,11,37,19,37,26,28,8,50,58,35,6,2,22,27,97
247,Sasha Kaun,C,30,CLE,25,0,95,9,17,0,0,9,17,5,11,12,14,26,3,4,5,7,11,23
248,Ryan Kelly,PF,24,LAL,36,0,470,55,149,5,37,50,112,37,54,21,100,121,20,13,10,18,39,152
249,Michael Kidd-Gilchrist,SF,22,CHO,7,7,205,33,61,3,7,30,54,20,29,12,33,45,9,3,3,8,9,89
250,Sean Kilpatrick,SG,26,TOT,31,0,616,123,270,39,114,84,156,60,67,12,44,56,29,12,2,31,37,345
251,Brandon Knight,SG,24,PHO,52,50,1870,371,895,120,351,251,544,156,183,36,166,202,263,61,20,177,124,1018
252,Kyle Korver,SG,34,ATL,80,80,2401,268,616,158,397,110,219,45,54,14,246,260,164,60,35,98,161,739
253,Kosta Koufos,C,26,SAC,78,14,1482,236,444,0,0,236,444,57,104,169,254,423,33,40,70,48,185,529
254,Jeremy Lamb,SG,23,CHO,66,0,1227,230,510,56,181,174,329,64,88,44,208,252,77,42,30,50,105,580
255,Carl Landry,PF,32,PHI,36,12,569,139,250,6,13,133,237,67,91,49,97,146,32,12,9,22,69,351
256,Shane Larkin,PG,23,BRK,78,17,1751,222,502,39,108,183,394,83,107,28,152,180,342,95,12,146,121,566
257,Joffrey Lauvergne,C,24,DEN,59,15,1041,195,380,13,53,182,327,62,69,77,213,290,56,13,15,54,115,465
258,Zach LaVine,SG,20,MIN,82,33,2294,433,959,123,316,310,643,161,203,27,201,228,251,69,17,155,193,1150
259,Ty Lawson,PG,28,TOT,66,13,1411,139,354,36,108,103,246,59,86,26,94,120,237,53,7,95,87,373
260,Courtney Lee,SG,30,TOT,79,65,2334,290,639,82,217,208,422,99,118,29,176,205,136,85,28,72,134,761
261,David Lee,PF,32,TOT,55,5,903,178,335,0,1,178,334,71,93,101,204,305,84,22,28,66,114,427
262,Alex Len,C,22,PHO,78,46,1821,264,624,1,7,263,617,174,239,178,416,594,97,38,62,145,230,703
263,Kawhi Leonard,SF,24,SAS,72,72,2380,551,1090,129,291,422,799,292,334,95,398,493,186,128,71,105,133,1523
264,Meyers Leonard,PF,23,POR,61,10,1333,195,435,86,228,109,207,35,46,51,263,314,92,8,18,77,183,511
265,Jon Leuer,PF,26,PHO,67,27,1255,224,466,42,110,182,356,77,101,76,297,373,72,38,30,75,125,567
266,Damian Lillard,PG,25,POR,75,75,2676,618,1474,229,610,389,864,414,464,45,257,302,512,65,28,242,165,1879
267,Jeremy Lin,SG,27,CHO,78,13,2048,300,728,76,226,224,502,238,292,42,211,253,235,58,42,150,165,914
268,Shaun Livingston,PG,30,GSW,78,3,1520,203,379,2,12,201,367,80,93,42,127,169,237,57,27,78,140,488
269,Kevon Looney,PF,19,GSW,5,0,21,4,7,1,2,3,5,0,0,4,6,10,0,0,0,1,2,9
270,Brook Lopez,C,27,BRK,73,73,2457,591,1157,2,14,589,1143,317,403,204,369,573,147,58,124,175,215,1501
271,Robin Lopez,C,27,NYK,82,82,2219,357,662,0,1,357,661,128,161,268,334,602,114,16,129,133,182,842
272,Kevin Love,PF,27,CLE,77,77,2424,409,977,158,439,251,538,258,314,149,613,762,186,58,41,142,159,1234
273,Kyle Lowry,PG,29,TOR,77,77,2851,512,1198,212,547,300,651,398,491,55,310,365,494,158,34,225,211,1634
274,Trey Lyles,PF,20,UTA,80,33,1382,191,436,49,128,142,308,57,82,59,240,299,59,26,18,65,114,488
275,Shelvin Mack,PG,25,TOT,52,27,1058,182,415,39,125,143,290,45,61,13,115,128,187,34,3,95,72,448
276,Ian Mahinmi,C,29,IND,71,71,1816,264,448,0,0,264,448,132,225,138,369,507,104,65,75,100,220,660
277,Devyn Marble,SG,23,ORL,28,0,249,21,71,8,32,13,39,10,24,6,32,38,12,13,1,7,25,60
278,Boban Marjanović,C,27,SAS,54,4,508,105,174,0,0,105,174,87,114,73,121,194,21,12,23,29,54,297
279,Kendall Marshall,PG,24,PHI,30,6,400,43,118,16,49,27,69,9,13,2,26,28,73,16,2,43,30,111
280,Jarell Martin,PF,21,MEM,27,0,380,54,116,0,2,54,114,45,62,39,47,86,15,8,7,19,58,153
281,Kevin Martin,SG,32,TOT,55,13,1095,156,419,49,136,107,283,153,172,14,96,110,58,26,3,54,83,514
282,Wesley Matthews,SF,29,DAL,78,78,2644,331,854,189,525,142,329,126,146,27,211,238,151,78,17,78,179,977
283,O.J. Mayo,SG,28,MIL,41,24,1090,119,321,52,162,67,159,31,40,13,92,105,118,48,8,72,126,321
284,Luc Mbah a Moute,PF,29,LAC,75,61,1274,94,207,13,40,81,167,30,57,60,111,171,30,44,19,34,100,231
285,James Michael McAdoo,PF,23,GSW,41,1,262,45,84,1,2,44,82,26,49,30,28,58,17,10,8,16,39,117
286,Ray McCallum,PG,24,TOT,41,6,475,55,146,15,42,40,104,12,15,8,39,47,60,12,7,24,29,137
287,CJ McCollum,SG,24,POR,80,80,2780,641,1431,197,472,444,959,187,226,47,212,259,341,97,23,196,187,1666
288,T.J. McConnell,PG,23,PHI,81,17,1606,218,464,31,89,187,375,26,41,43,207,250,367,95,10,140,114,493
289,Chris McCullough,PF,20,BRK,24,4,362,44,109,13,34,31,75,11,23,25,43,68,9,28,12,15,39,112
290,K.J. McDaniels,SF,22,HOU,37,1,235,29,72,7,25,22,47,24,30,16,26,42,10,7,6,17,30,89
291,Doug McDermott,SF,24,CHI,81,4,1861,291,644,110,259,181,385,72,84,37,158,195,59,14,6,53,127,764
292,Mitch McGary,PF,23,OKC,20,0,72,11,23,0,4,11,19,4,10,4,14,18,3,1,2,7,10,26
293,JaVale McGee,C,28,DAL,34,2,370,77,134,0,1,77,133,18,36,53,80,133,3,5,26,21,49,172
294,Ben McLemore,SG,22,SAC,68,53,1443,195,455,67,185,128,270,74,103,34,114,148,79,52,10,99,140,531
295,Jordan McRae,PG,24,TOT,22,1,195,34,78,10,22,24,56,21,28,4,16,20,25,3,1,15,17,99
296,Josh McRoberts,PF,28,MIA,42,1,595,55,148,12,49,43,99,28,40,22,83,105,81,18,7,30,68,150
297,Jodie Meeks,SG,28,DET,3,0,43,7,20,4,9,3,11,4,4,1,4,5,3,0,0,1,2,22
298,Salah Mejri,C,29,DAL,34,6,397,49,78,0,1,49,77,27,46,41,82,123,10,8,36,23,54,125
299,Jordan Mickey,PF,21,BOS,16,0,57,8,22,0,0,8,22,5,10,6,7,13,1,0,11,1,5,21
300,Khris Middleton,SG,24,MIL,79,79,2852,507,1142,143,361,364,781,277,312,44,258,302,331,131,19,180,204,1434
301,C.J. Miles,SF,28,IND,64,24,1464,259,634,142,387,117,247,93,124,25,150,175,63,53,29,70,142,753
302,Andre Miller,PG,39,TOT,39,4,461,59,106,2,8,57,98,24,32,12,39,51,87,16,0,37,46,144
303,Mike Miller,SF,35,DEN,47,2,373,22,62,19,52,3,10,0,0,6,47,53,40,13,4,17,53,63
304,Patty Mills,PG,27,SAS,81,3,1662,260,612,123,320,137,292,47,58,27,131,158,226,59,6,76,102,690
305,Elijah Millsap,SG,28,UTA,20,0,173,11,39,1,12,10,27,13,18,6,29,35,19,7,3,9,33,36
306,Paul Millsap,PF,30,ATL,81,81,2647,501,1066,74,232,427,834,309,408,198,534,732,265,147,139,191,237,1385
307,Nikola Mirotić,PF,24,CHI,66,38,1646,248,609,135,346,113,263,146,181,58,304,362,100,58,46,102,151,777
308,Nazr Mohammed,C,38,OKC,5,0,19,3,5,0,0,3,5,2,2,1,3,4,0,0,0,3,4,8
309,Greg Monroe,C,25,MIL,79,67,2314,491,941,0,1,491,940,228,308,218,478,696,178,72,67,129,163,1210
310,Luis Montero,SG,22,POR,12,0,42,5,19,1,9,4,10,3,4,0,4,4,1,0,0,4,1,14
311,E'Twaun Moore,SG,26,CHI,59,22,1263,187,389,47,104,140,285,22,35,19,114,133,99,37,18,53,103,443
312,Eric Moreland,PF,24,SAC,8,0,48,3,6,0,0,3,6,2,4,3,8,11,1,0,4,3,4,8
313,Marcus Morris,SF,26,DET,80,80,2856,410,945,108,298,302,647,203,271,91,313,404,201,67,23,140,170,1131
314,Markieff Morris,PF,26,TOT,64,45,1629,305,718,47,155,258,563,108,147,73,279,352,124,58,34,135,184,765
315,Anthony Morrow,SG,30,OKC,68,6,926,136,333,79,204,57,129,29,39,10,52,62,24,22,5,17,64,380
316,Donatas Motiejūnas,PF,25,HOU,37,22,547,90,205,16,57,74,148,34,53,37,72,109,41,17,5,44,69,230
317,Timofey Mozgov,C,29,CLE,76,48,1326,203,359,1,7,202,352,68,95,110,227,337,33,22,57,71,159,475
318,Emmanuel Mudiay,PG,19,DEN,68,66,2068,329,905,74,232,255,673,140,209,32,200,232,372,65,35,217,141,872
319,Shabazz Muhammad,SF,23,MIN,82,0,1682,317,681,44,152,273,529,185,242,100,167,267,52,24,7,70,94,863
320,Xavier Munford,SG,23,MEM,14,0,244,32,77,9,23,23,54,7,14,3,28,31,22,13,3,15,25,80
321,Mike Muscala,C,24,ATL,60,0,565,76,152,12,39,64,113,31,39,38,79,117,34,13,27,27,72,195
322,Larry Nance,PF,23,LAL,63,22,1266,158,300,1,10,157,290,32,47,101,211,312,44,54,23,41,124,349
323,Shabazz Napier,PG,24,ORL,55,0,600,68,201,34,104,34,97,33,45,9,46,55,97,23,1,46,38,203
324,Gary Neal,SG,31,WAS,40,2,807,151,325,41,100,110,225,47,55,11,72,83,47,20,1,29,55,390
325,Jameer Nelson,PG,33,DEN,39,15,1036,113,307,43,144,70,163,30,35,19,96,115,190,25,5,66,100,299
326,Raul Neto,PG,23,UTA,81,53,1499,180,418,64,162,116,256,52,70,17,103,120,174,62,2,109,122,476
327,Andrew Nicholson,PF,26,ORL,56,0,823,146,310,41,114,105,196,51,65,34,167,201,25,10,22,41,69,384
328,Joakim Noah,C,30,CHI,29,2,635,51,133,0,1,51,132,22,45,87,168,255,110,18,29,52,77,124
329,Nerlens Noel,C,21,PHI,67,62,1965,306,587,1,2,305,585,134,227,154,388,542,122,118,100,158,192,747
330,Lucas Nogueira,C,23,TOR,29,1,225,28,44,1,3,27,41,8,15,18,28,46,7,12,12,11,29,65
331,Steve Novak,PF,32,TOT,10,0,44,8,18,7,15,1,3,1,1,0,5,5,0,0,0,1,3,24
332,Dirk Nowitzki,PF,37,DAL,75,75,2364,498,1112,126,342,372,770,250,280,52,437,489,132,52,52,84,161,1372
333,Jusuf Nurkić,C,21,DEN,32,3,547,101,242,0,3,101,239,61,99,65,110,175,40,24,44,55,91,263
334,J.J. O'Brien,SF,23,UTA,2,0,6,0,1,0,0,0,1,0,0,0,1,1,0,1,0,0,1,0
335,Johnny O'Bryant,PF,22,MIL,66,4,857,86,209,1,1,85,208,27,40,65,111,176,32,18,8,31,100,200
336,Kyle O'Quinn,PF,25,NYK,65,1,764,129,271,5,22,124,249,46,60,76,174,250,72,20,49,61,107,309
337,Jahlil Okafor,C,20,PHI,53,48,1591,397,781,1,6,396,775,133,194,122,251,373,65,22,61,124,140,928
338,Victor Oladipo,SG,23,ORL,72,52,2379,425,970,98,282,327,688,205,247,48,297,345,282,116,54,153,174,1153
339,Kelly Olynyk,C,24,BOS,69,8,1395,253,556,85,210,168,346,96,128,72,209,281,105,52,33,74,163,687
340,Kelly Oubre,SF,20,WAS,63,9,671,90,211,25,79,65,132,31,49,25,108,133,13,22,7,34,100,236
341,Zaza Pachulia,C,31,DAL,76,69,2004,219,470,0,3,219,467,212,276,249,469,718,128,64,22,119,181,650
342,Kostas Papanikolaou,SF,25,DEN,26,6,294,24,66,10,32,14,34,9,14,8,32,40,16,13,5,21,24,67
343,Jabari Parker,PF,20,MIL,76,72,2408,443,899,9,35,434,864,175,228,123,272,395,130,69,29,116,154,1070
344,Tony Parker,PG,33,SAS,72,72,1980,350,710,27,65,323,645,130,171,17,159,176,379,54,11,131,114,857
345,Chandler Parsons,SF,27,DAL,61,51,1799,320,651,104,251,216,400,93,136,29,256,285,169,46,21,95,114,837
346,Lamar Patterson,SG,24,ATL,35,0,395,28,80,12,49,16,31,16,22,4,46,50,39,9,2,23,45,84
347,Patrick Patterson,PF,26,TOR,79,0,2020,204,493,106,293,98,200,29,34,77,265,342,94,53,32,65,128,543
348,Chris Paul,PG,30,LAC,74,74,2420,515,1114,122,329,393,785,294,328,39,271,310,738,152,13,194,185,1446
349,Adreian Payne,PF,24,MIN,52,2,486,53,145,9,32,44,113,17,26,20,91,111,29,16,11,36,77,132
350,Cameron Payne,PG,21,OKC,57,1,698,114,278,36,111,78,167,19,24,9,76,85,108,36,6,44,80,283
351,Elfrid Payton,PG,21,ORL,73,69,2145,318,730,30,92,288,638,112,190,77,184,261,468,89,20,177,159,778
352,Nikola Peković,C,30,MIN,12,3,156,19,50,0,0,19,50,16,20,7,14,21,11,1,0,9,22,54
353,Kendrick Perkins,C,31,NOP,37,5,542,40,75,0,0,40,75,11,25,25,103,128,31,11,11,41,64,91
354,Paul Pierce,SF,38,LAC,68,38,1231,144,397,75,242,69,155,54,66,12,174,186,71,33,17,58,129,417
355,Tibor Pleiß,C,26,UTA,12,0,82,11,25,0,2,11,23,2,2,6,9,15,2,1,2,8,19,24
356,Mason Plumlee,C,25,POR,82,82,2084,267,517,0,4,267,513,215,335,201,427,628,226,68,85,154,253,749
357,Miles Plumlee,C,27,MIL,61,14,870,140,233,0,0,140,233,34,59,94,138,232,16,21,50,40,73,314
358,Otto Porter,SF,22,WAS,75,73,2276,339,717,98,267,241,450,95,126,97,294,391,120,105,32,70,163,871
359,Bobby Portis,PF,20,CHI,62,4,1102,186,436,16,52,170,384,48,66,123,214,337,52,25,22,54,100,436
360,Kristaps Porziņģis,PF,20,NYK,72,72,2047,373,886,81,243,292,643,201,240,132,394,526,94,53,134,121,205,1028
361,Dwight Powell,PF,24,DAL,69,2,992,146,296,2,16,144,280,105,142,84,189,273,44,36,24,40,118,399
362,Norman Powell,SG,22,TOR,49,24,725,97,229,36,89,61,140,43,53,16,95,111,47,29,10,32,59,273
363,Phil Pressey,PG,24,TOT,23,0,283,30,78,4,18,26,60,13,25,3,28,31,75,18,4,33,28,77
364,Ronnie Price,PG,32,PHO,62,18,1211,116,302,68,196,48,106,31,41,25,74,99,147,74,13,70,161,331
365,Pablo Prigioni,PG,38,LAC,59,3,823,55,147,28,95,27,52,7,8,38,76,114,130,53,1,49,82,145
366,Tayshaun Prince,SF,35,MIN,77,44,1462,102,229,4,23,98,206,13,19,32,115,147,73,36,13,27,62,221
367,Julius Randle,PF,21,LAL,81,60,2286,358,835,10,36,348,799,193,270,172,657,829,144,53,29,149,242,919
368,Zach Randolph,PF,34,MEM,68,53,2016,431,907,6,26,425,881,172,216,179,350,529,142,43,13,105,146,1040
369,J.J. Redick,SG,31,LAC,75,75,2097,422,880,200,421,222,459,182,205,10,129,139,106,42,5,78,135,1226
370,Willie Reed,C,25,BRK,39,2,426,76,133,0,0,76,133,30,55,49,73,122,10,6,30,16,47,182
371,Josh Richardson,SG,22,MIA,52,2,1107,123,272,53,115,70,157,42,63,21,86,107,73,36,25,35,107,341
372,Austin Rivers,SG,23,LAC,67,7,1464,226,516,62,185,164,331,79,116,22,108,130,99,48,9,61,137,593
373,Andre Roberson,SG,24,OKC,70,70,1553,136,274,32,103,104,171,33,54,79,172,251,47,53,42,35,133,337
374,Brian Roberts,PG,30,TOT,51,0,470,74,165,15,42,59,123,42,47,6,35,41,54,10,2,23,35,205
375,Glenn Robinson,SF,22,IND,45,4,508,65,151,14,37,51,114,27,39,12,56,68,26,17,9,18,21,171
376,Nate Robinson,PG,31,NOP,2,1,23,0,1,0,1,0,0,0,0,0,0,0,4,1,0,0,5,0
377,Thomas Robinson,PF,24,BRK,71,7,917,130,291,0,1,130,290,47,109,136,223,359,46,39,36,69,111,307
378,Rajon Rondo,PG,29,SAC,72,72,2537,355,782,62,170,293,612,87,150,77,358,435,839,141,10,278,175,859
379,Derrick Rose,PG,27,CHI,66,66,2097,447,1048,44,150,403,898,142,179,46,179,225,311,44,14,175,84,1080
380,Terrence Ross,SF,24,TOR,73,7,1747,270,626,131,339,139,287,49,62,21,164,185,56,54,25,46,120,720
381,Terry Rozier,PG,21,BOS,39,0,311,29,106,6,27,23,79,8,10,24,39,63,37,6,1,19,23,72
382,Ricky Rubio,PG,25,MIN,76,76,2323,219,586,62,190,157,396,266,314,40,286,326,658,162,10,193,201,766
383,Damjan Rudež,SF,29,MIN,33,0,277,25,62,17,50,8,12,8,8,5,15,20,11,3,1,13,33,75
384,Brandon Rush,SG,30,GSW,72,25,1055,111,260,65,157,46,103,18,28,21,160,181,57,20,23,33,57,305
385,D'Angelo Russell,PG,19,LAL,80,48,2259,392,956,130,370,262,586,140,190,47,227,274,266,93,13,196,142,1054
386,Robert Sacre,C,26,LAL,25,1,320,31,75,0,0,31,75,25,38,32,40,72,14,4,10,12,43,87
387,JaKarr Sampson,SF,22,TOT,73,40,1160,140,317,14,63,126,254,80,122,46,144,190,46,23,33,70,142,374
388,Dennis Schröder,PG,22,ATL,80,6,1621,329,781,77,239,252,542,144,182,25,179,204,349,70,9,183,138,879
389,Luis Scola,PF,35,TOR,76,76,1636,269,598,65,161,204,437,61,84,84,276,360,66,46,27,68,178,664
390,Mike Scott,PF,27,ATL,75,0,1146,176,376,62,158,114,218,50,63,53,153,206,78,25,17,42,102,464
391,Thabo Sefolosha,SF,31,ATL,75,11,1758,188,372,42,124,146,248,62,99,52,282,334,107,85,37,68,109,480
392,Kevin Séraphin,C,26,NYK,48,0,526,84,205,0,2,84,203,19,23,31,95,126,47,8,36,43,67,187
393,Ramon Sessions,PG,29,WAS,82,5,1667,280,592,36,111,244,481,214,283,25,178,203,239,46,5,115,102,810
394,Iman Shumpert,SG,25,CLE,54,5,1316,114,305,43,146,71,159,40,51,32,171,203,92,54,19,57,119,311
395,Jonathon Simmons,SG,26,SAS,55,2,813,122,242,18,47,104,195,69,92,16,80,96,58,24,5,53,103,331
396,Henry Sims,C,25,BRK,14,4,263,33,77,0,0,33,77,25,30,21,51,72,9,9,14,12,37,91
397,Kyle Singler,SF,27,OKC,68,2,977,86,221,30,97,56,124,29,44,50,91,141,24,30,9,32,120,231
398,Donald Sloan,PG,28,BRK,61,33,1318,154,350,38,99,116,251,78,104,17,156,173,268,32,4,80,73,424
399,Marcus Smart,PG,21,BOS,61,10,1667,184,529,61,241,123,288,129,166,76,179,255,185,91,18,80,183,558
400,Greg Smith,PF,25,MIN,18,0,192,18,32,0,0,18,32,7,17,12,30,42,6,4,1,7,28,43
401,Ish Smith,PG,27,TOT,77,53,2239,397,967,56,170,341,797,122,176,43,262,305,502,88,24,175,133,972
402,J.R. Smith,SG,30,CLE,77,77,2362,353,850,204,510,149,340,45,71,43,174,217,130,81,21,59,204,955
403,Jason Smith,C,29,ORL,76,2,1181,244,503,4,16,240,487,54,67,53,166,219,62,33,65,57,163,546
404,Josh Smith,PF,30,TOT,55,7,880,127,349,41,143,86,206,37,67,51,141,192,90,34,47,77,118,332
405,Russ Smith,PG,24,MEM,15,0,66,7,22,1,5,6,17,8,13,1,8,9,11,5,1,7,5,23
406,Tony Snell,SF,24,CHI,64,33,1301,126,339,56,155,70,184,30,33,19,180,199,63,16,17,52,100,338
407,Marreese Speights,C,28,GSW,72,0,832,197,456,24,62,173,394,94,114,77,162,239,61,19,34,66,117,512
408,Tiago Splitter,C,31,ATL,36,2,579,81,155,0,2,81,153,39,48,45,75,120,30,20,12,24,71,201
409,Nik Stauskas,SG,22,PHI,73,35,1809,210,545,106,325,104,220,91,118,23,160,183,138,44,20,94,115,617
410,Lance Stephenson,SF,25,TOT,69,13,1372,228,474,30,78,198,396,87,111,40,183,223,133,43,9,94,135,573
411,Alex Stepheson,PF,28,TOT,8,0,73,9,27,0,0,9,27,4,12,19,9,28,2,1,5,0,12,22
412,Jarnell Stokes,C,22,TOT,7,0,18,3,5,0,0,3,5,1,2,1,3,4,1,1,0,0,1,7
413,Amar'e Stoudemire,C,33,MIA,52,36,762,125,221,0,0,125,221,50,67,65,157,222,27,18,41,47,92,300
414,Rodney Stuckey,PG,29,IND,58,1,1275,183,443,20,83,163,360,131,158,19,137,156,142,43,8,76,77,517
415,Jared Sullinger,PF,23,BOS,81,73,1915,351,806,29,103,322,703,103,161,194,479,673,187,75,47,102,209,834
416,Edy Tavares,C,23,ATL,11,0,73,11,19,0,0,11,19,3,8,7,14,21,3,1,6,5,8,25
417,Jeff Teague,PG,27,ATL,79,78,2255,434,988,110,275,324,713,261,312,33,181,214,470,97,24,218,167,1239
418,Mirza Teletović,PF,30,PHO,79,1,1686,332,777,181,460,151,317,120,155,55,247,302,89,32,21,84,159,965
419,Garrett Temple,SF,29,WAS,80,43,1951,201,505,89,258,112,247,91,125,36,176,212,140,69,18,64,195,582
420,Jason Terry,SG,38,HOU,72,7,1258,151,376,93,261,58,115,27,33,14,65,79,103,47,9,49,91,422
421,Isaiah Thomas,PG,26,BOS,82,79,2644,591,1382,167,465,424,917,474,544,46,197,243,509,91,9,220,167,1823
422,Lance Thomas,PF,27,NYK,59,5,1313,169,382,44,109,125,273,102,119,34,97,131,53,22,7,57,109,484
423,Hollis Thompson,SG,24,PHI,77,17,2154,270,680,149,392,121,288,69,96,54,218,272,99,36,24,76,187,758
424,Jason Thompson,C,29,TOT,47,7,471,52,108,5,15,47,93,38,54,32,102,134,29,12,20,15,80,147
425,Klay Thompson,SG,25,GSW,80,80,2666,651,1386,276,650,375,736,193,221,35,271,306,166,60,49,138,152,1771
426,Tristan Thompson,PF,24,CLE,82,34,2269,247,420,0,0,247,420,149,242,268,470,738,62,38,51,61,202,643
427,Marcus Thornton,SG,28,TOT,61,8,1109,216,542,91,270,125,272,67,79,38,112,150,85,47,4,51,90,590
428,Anthony Tolliver,PF,30,DET,72,5,1341,128,332,98,272,30,60,29,47,39,190,229,52,26,16,28,86,383
429,Axel Toupane,SF,23,DEN,21,0,305,25,70,13,40,12,30,13,17,8,23,31,15,7,6,6,40,76
430,Karl-Anthony Towns,C,20,MIN,82,82,2627,625,1153,30,88,595,1065,223,275,229,629,858,161,58,138,183,245,1503
431,P.J. Tucker,SF,30,PHO,82,80,2540,239,582,68,206,171,376,106,142,165,347,512,177,106,20,111,202,652
432,Evan Turner,SG,27,BOS,81,12,2271,343,753,20,83,323,670,148,179,50,347,397,359,80,28,169,139,854
433,Myles Turner,C,19,IND,60,30,1367,264,530,3,14,261,516,88,121,68,264,332,41,25,86,67,158,619
434,Beno Udrih,PG,33,TOT,44,5,707,86,198,15,44,71,154,18,20,8,64,72,116,14,1,53,51,205
435,Jonas Valančiūnas,C,23,TOR,60,59,1557,303,536,0,0,303,536,162,213,184,363,547,42,25,80,85,158,768
436,Anderson Varejão,C,33,TOT,53,0,496,53,124,0,1,53,123,32,50,37,104,141,35,16,10,22,70,138
437,Greivis Vásquez,PG,29,MIL,23,0,460,45,138,18,73,27,65,22,26,5,42,47,91,10,0,40,42,130
438,Rashad Vaughn,SG,19,MIL,70,6,1001,81,266,43,147,38,119,12,15,11,77,88,39,29,16,28,73,217
439,Charlie Villanueva,PF,31,DAL,62,4,665,125,327,47,172,78,155,22,24,24,128,152,24,18,15,31,71,319
440,Noah Vonleh,PF,20,POR,78,56,1174,117,278,11,46,106,232,38,51,91,214,305,30,27,26,50,152,283
441,Nikola Vučević,C,25,ORL,65,60,2037,533,1046,2,9,531,1037,113,150,174,402,576,179,53,70,123,173,1181
442,Sasha Vujačić,SG,31,NYK,61,25,908,106,277,52,143,54,134,32,39,26,123,149,84,34,5,44,83,296
443,Dwyane Wade,SG,34,MIA,74,73,2258,540,1183,7,44,533,1139,322,406,82,220,302,344,79,42,203,116,1409
444,Dion Waiters,SG,24,OKC,78,15,2152,282,706,86,240,196,466,112,157,36,166,202,154,81,15,120,143,762
445,Kemba Walker,PG,25,CHO,81,81,2885,568,1331,182,490,386,841,371,438,56,301,357,421,126,39,171,111,1689
446,John Wall,PG,25,WAS,77,77,2784,572,1349,115,328,457,1021,272,344,42,337,379,789,145,59,318,159,1531
447,T.J. Warren,SF,22,PHO,47,4,1070,221,441,28,70,193,371,45,64,57,90,147,44,37,16,32,94,515
448,C.J. Watson,PG,31,ORL,33,2,656,47,137,14,48,33,89,34,39,10,56,66,88,19,5,25,49,142
449,Briante Weber,PG,23,TOT,7,4,169,14,39,0,5,14,34,3,4,8,17,25,21,9,3,9,12,31
451,David West,PF,35,SAS,78,19,1404,244,448,3,7,241,441,63,80,72,237,309,143,44,55,68,142,554
452,Russell Westbrook,PG,27,OKC,80,80,2750,656,1444,101,341,555,1103,465,573,145,481,626,834,163,20,342,200,1878
453,Hassan Whiteside,C,26,MIA,73,43,2125,413,682,0,0,413,682,214,329,238,627,865,30,44,269,137,201,1040
454,Shayne Whittington,PF,24,IND,7,0,41,5,11,0,2,5,9,1,2,5,7,12,3,1,1,5,7,11
455,Andrew Wiggins,SF,20,MIN,81,81,2845,594,1294,57,190,537,1104,430,565,105,186,291,164,78,46,182,165,1675
456,C.J. Wilcox,SG,25,LAC,23,0,167,26,66,9,23,17,43,9,12,1,11,12,10,10,2,2,15,70
457,Alan Williams,PF,23,PHO,10,0,68,10,24,0,0,10,24,9,14,14,24,38,5,4,5,6,15,29
458,Deron Williams,PG,31,DAL,65,63,2106,321,775,97,282,224,493,179,206,19,171,190,378,61,14,150,155,918
459,Derrick Williams,SF,24,NYK,80,9,1435,254,565,44,150,210,415,194,256,47,249,296,75,29,9,61,69,746
460,Elliot Williams,PG,26,MEM,5,0,45,2,10,1,4,1,6,3,4,1,3,4,4,0,0,1,2,8
461,Lou Williams,SG,29,LAL,67,35,1907,283,693,110,320,173,373,352,424,31,138,169,167,62,19,107,107,1028
462,Marvin Williams,PF,29,CHO,81,81,2338,338,747,152,378,186,369,120,144,127,394,521,110,58,77,62,133,948
463,Mo Williams,PG,33,CLE,41,14,748,132,302,36,102,96,200,38,42,6,66,72,98,14,5,57,60,338
464,Justise Winslow,SF,19,MIA,78,8,2232,195,462,32,116,163,346,80,117,81,322,403,117,68,26,95,184,502
465,Jeff Withey,C,25,UTA,51,10,658,87,162,0,2,87,160,43,59,56,117,173,20,21,53,28,75,217
466,Christian Wood,PF,20,PHI,17,0,145,22,53,4,11,18,42,13,21,13,25,38,3,5,7,2,11,61
467,Metta World Peace,SF,36,LAL,35,5,590,55,177,26,84,29,93,40,57,19,70,89,27,22,11,15,67,176
468,Brandan Wright,PF,28,MEM,12,2,212,35,52,0,0,35,52,13,24,14,29,43,6,5,15,10,21,83
469,Delon Wright,PG,23,TOR,27,1,229,36,80,5,13,31,67,26,35,8,29,37,31,8,3,16,7,103
470,Tony Wroten,PG,22,PHI,8,3,144,22,65,3,17,19,48,20,37,2,19,21,20,3,0,29,11,67
471,James Young,SG,20,BOS,29,0,199,11,36,6,26,5,10,1,4,4,22,26,9,6,1,5,17,29
472,Joe Young,PG,23,IND,41,0,384,62,169,10,46,52,123,20,25,6,44,50,65,15,0,33,30,154
473,Nick Young,SG,30,LAL,54,2,1033,126,372,77,237,49,135,63,76,14,83,97,34,23,7,30,50,392
474,Thaddeus Young,PF,27,BRK,73,73,2407,495,963,7,30,488,933,105,163,176,484,660,135,112,37,136,182,1102
475,Cody Zeller,C,23,CHO,73,60,1774,231,437,1,10,230,427,175,232,138,317,455,71,57,63,68,204,638
476,Tyler Zeller,C,26,BOS,60,3,710,138,290,0,0,138,290,88,108,62,116,178,29,10,22,46,97,364
1,Álex Abrines,SG,23,OKC,68,6,1055,134,341,94,247,40,94,44,49,18,68,86,40,37,8,33,114,406
2,Quincy Acy,PF,26,TOT,38,1,558,70,170,37,90,33,80,45,60,20,95,115,18,14,15,21,67,222
3,Steven Adams,C,23,OKC,80,80,2389,374,655,0,1,374,654,157,257,281,332,613,86,89,78,146,195,905
4,Arron Afflalo,SG,31,SAC,61,45,1580,185,420,62,151,123,269,83,93,9,116,125,78,21,6,42,104,515
5,Alexis Ajinça,C,28,NOP,39,15,584,89,178,0,4,89,174,29,40,46,131,177,12,20,22,31,77,207
6,Cole Aldrich,C,28,MIN,62,0,531,45,86,0,0,45,86,15,22,51,107,158,25,25,23,17,85,105
7,LaMarcus Aldridge,PF,31,SAS,72,72,2335,500,1049,23,56,477,993,220,271,172,351,523,139,46,88,98,158,1243
8,Lavoy Allen,PF,27,IND,61,5,871,77,168,0,1,77,167,23,33,105,114,219,57,18,24,29,78,177
9,Tony Allen,SG,35,MEM,71,66,1914,274,595,15,54,259,541,80,130,166,225,391,98,115,29,100,178,643
10,Al-Farouq Aminu,PF,26,POR,61,25,1773,183,466,70,212,113,254,96,136,77,374,451,99,60,44,94,102,532
11,Chris Andersen,C,38,CLE,12,0,114,9,22,0,3,9,19,10,14,9,22,31,5,5,7,5,20,28
12,Alan Anderson,SF,34,LAC,30,0,308,30,80,14,44,16,36,12,16,3,21,24,11,3,0,7,35,86
13,Justin Anderson,SF,23,TOT,75,10,1228,186,439,58,194,128,245,102,129,69,176,245,66,41,23,66,109,532
14,Kyle Anderson,SF,23,SAS,72,14,1020,93,209,15,40,78,169,45,57,33,175,208,91,51,26,39,63,246
15,Ryan Anderson,PF,28,HOU,72,72,2116,323,773,204,506,119,267,129,150,112,218,330,68,31,14,55,142,979
16,Giannis Antetokounmpo,SF,22,MIL,80,80,2845,656,1259,49,180,607,1079,471,612,142,558,700,434,131,151,234,246,1832
17,Carmelo Anthony,SF,32,NYK,74,74,2538,602,1389,151,421,451,968,304,365,62,376,438,213,60,34,153,198,1659
18,Joel Anthony,C,34,SAS,19,0,122,10,16,0,0,10,16,5,8,8,23,31,3,2,6,4,11,25
19,Trevor Ariza,SF,31,HOU,80,80,2773,326,798,191,555,135,243,93,126,54,404,458,175,147,20,73,133,936
20,Darrell Arthur,PF,28,DEN,41,7,639,95,215,53,117,42,98,19,22,25,87,112,42,19,21,36,76,262
21,Ömer Aşık,C,30,NOP,31,19,482,31,65,0,0,31,65,23,39,48,115,163,15,5,10,14,51,85
22,D.J. Augustin,PG,29,ORL,78,20,1538,195,517,95,274,100,243,131,161,15,102,117,209,31,1,90,101,616
23,Luke Babbitt,SF,27,MIA,68,55,1065,113,281,87,210,26,71,11,15,12,129,141,36,20,11,25,118,324
24,Ron Baker,SG,23,NYK,52,13,857,82,217,23,86,59,131,28,43,12,86,98,107,34,8,56,74,215
25,Wade Baldwin,PG,20,MEM,33,1,405,36,115,3,22,33,93,31,37,11,35,46,61,18,7,39,40,106
26,Leandro Barbosa,SG,34,PHO,67,0,963,172,392,35,98,137,294,40,45,15,89,104,81,31,8,48,82,419
27,J.J. Barea,PG,32,DAL,35,6,771,142,343,53,148,89,195,44,51,9,75,84,193,14,1,63,30,381
28,Harrison Barnes,PF,24,DAL,79,79,2803,599,1280,78,222,521,1058,242,281,93,301,394,116,65,15,102,128,1518
29,Matt Barnes,SF,36,TOT,74,18,1777,185,473,87,263,98,210,70,89,70,314,384,195,48,26,107,185,527
30,Will Barton,SG,26,DEN,60,19,1705,295,666,87,235,208,431,143,190,58,201,259,206,48,28,97,110,820
31,Brandon Bass,PF,31,LAC,52,0,577,107,186,1,3,106,183,77,88,43,86,129,21,14,11,29,45,292
32,Nicolas Batum,SG,28,CHO,77,77,2617,393,975,135,405,258,570,243,284,46,435,481,456,86,29,194,109,1164
33,Jerryd Bayless,PG,28,PHI,3,1,71,11,32,2,5,9,27,9,10,3,9,12,13,0,0,9,4,33
34,Aron Baynes,C,30,DET,75,2,1163,143,279,0,0,143,279,79,94,111,222,333,32,17,39,50,166,365
35,Kent Bazemore,SF,27,ATL,73,64,1963,295,721,92,266,203,455,119,168,45,186,231,177,91,52,125,165,801
36,Bradley Beal,SG,23,WAS,77,77,2684,637,1322,223,552,414,770,282,342,53,187,240,267,83,21,156,169,1779
37,Malik Beasley,SG,20,DEN,22,1,165,33,73,9,28,24,45,8,10,5,12,17,11,7,0,8,10,83
38,Michael Beasley,PF,28,MIL,56,6,935,216,406,18,43,198,363,78,105,40,153,193,53,27,27,66,92,528
39,Marco Belinelli,SG,30,CHO,74,0,1778,264,615,102,283,162,332,150,168,14,164,178,147,44,9,70,90,780
40,DeAndre' Bembry,SF,22,ATL,38,1,371,47,98,1,18,46,80,6,16,14,45,59,28,8,5,16,21,101
41,Dragan Bender,PF,19,PHO,43,0,574,57,161,28,101,29,60,4,11,23,80,103,23,10,22,32,74,146
42,Anthony Bennett,PF,23,BRK,23,1,264,38,92,13,48,25,44,26,36,25,53,78,12,5,3,12,18,115
43,Ben Bentil,PF,21,DAL,3,0,10,0,3,0,1,0,2,0,0,0,2,2,0,0,0,1,1,0
44,Dāvis Bertāns,PF,24,SAS,67,6,808,103,234,69,173,34,61,28,34,22,76,98,46,20,28,32,75,303
45,Patrick Beverley,SG,28,HOU,67,67,2058,228,543,110,288,118,255,73,95,95,298,393,281,99,25,100,222,639
46,Bismack Biyombo,C,24,ORL,81,27,1793,179,339,0,0,179,339,125,234,157,410,567,74,25,91,95,202,483
47,Nemanja Bjelica,PF,28,MIN,65,1,1190,151,356,56,177,95,179,45,61,57,187,244,79,40,20,59,154,403
48,Tarik Black,C,25,LAL,67,16,1091,150,294,1,2,149,292,82,109,144,199,343,39,29,44,58,173,383
49,Eric Bledsoe,PG,27,PHO,66,66,2176,449,1034,104,310,345,724,388,458,52,268,320,418,91,31,224,164,1390
50,Bojan Bogdanović,SF,27,TOT,81,54,2083,376,845,144,392,232,453,217,243,37,240,277,111,34,7,131,146,1113
51,Andrew Bogut,C,32,TOT,27,21,583,38,81,0,1,38,80,3,11,56,162,218,49,13,25,43,86,79
52,Joel Bolomboy,PF,23,UTA,12,0,53,9,16,1,4,8,12,3,6,4,13,17,2,1,2,2,1,22
53,Devin Booker,SG,20,PHO,78,78,2730,606,1431,147,405,459,1026,367,441,46,203,249,268,72,21,241,242,1726
54,Trevor Booker,PF,29,BRK,71,43,1754,305,591,25,78,280,513,74,110,143,428,571,138,75,28,127,152,709
55,Avery Bradley,SG,26,BOS,55,55,1835,359,775,108,277,251,498,68,93,65,269,334,122,68,11,88,141,894
56,Corey Brewer,SF,30,TOT,82,11,1281,147,348,27,118,120,230,50,68,32,134,166,97,61,20,55,133,371
57,Malcolm Brogdon,SG,24,MIL,75,28,1982,290,635,78,193,212,442,109,126,47,166,213,317,84,12,113,140,767
58,Aaron Brooks,PG,32,IND,65,0,894,121,300,48,128,73,172,32,40,18,51,69,125,25,9,66,93,322
59,Anthony Brown,SF,24,TOT,11,0,159,18,50,7,27,11,23,0,0,8,25,33,8,5,1,6,15,43
60,Bobby Brown,PG,32,HOU,25,0,123,23,60,14,35,9,25,2,2,0,6,6,14,1,0,5,5,62
61,Jaylen Brown,SF,20,BOS,78,20,1341,192,423,46,135,146,288,85,124,45,175,220,64,35,18,68,142,515
62,Nicolás Brussino,SG,23,DAL,54,2,521,52,141,29,95,23,46,17,22,26,69,95,47,17,8,26,43,150
63,Reggie Bullock,SF,25,DET,31,5,467,54,128,28,73,26,55,5,7,13,51,64,29,18,3,10,22,141
64,Trey Burke,PG,24,WAS,57,0,703,116,255,31,70,85,185,22,29,7,40,47,100,11,5,48,54,285
65,Alec Burks,SG,25,UTA,42,0,653,99,248,25,76,74,172,60,78,17,103,120,30,18,5,35,50,283
66,Jimmy Butler,SF,27,CHI,76,75,2809,570,1252,91,248,479,1004,585,676,129,341,470,417,143,32,159,112,1816
67,Bruno Caboclo,SF,21,TOR,9,0,40,6,16,2,6,4,10,0,0,5,5,10,4,2,1,2,4,14
68,José Calderón,PG,35,TOT,41,13,539,55,134,20,64,35,70,11,12,15,59,74,88,11,1,41,36,141
69,Kentavious Caldwell-Pope,SG,23,DET,76,75,2529,370,928,153,437,217,491,154,185,55,193,248,193,89,12,86,118,1047
70,Isaiah Canaan,SG,25,CHI,39,0,592,63,173,25,94,38,79,30,33,6,44,50,37,22,1,21,35,181
71,Clint Capela,C,22,HOU,65,59,1551,362,563,0,0,362,563,94,177,178,348,526,63,34,79,87,179,818
72,DeMarre Carroll,SF,30,TOR,72,72,1882,220,550,109,320,111,230,89,117,63,212,275,74,81,27,54,143,638
73,Vince Carter,SF,40,MEM,73,15,1799,193,490,112,296,81,194,88,115,36,191,227,133,60,36,50,163,586
74,Michael Carter-Williams,PG,25,CHI,45,19,846,112,306,15,64,97,242,58,77,24,129,153,113,38,23,66,102,297
75,Omri Casspi,PF,28,TOT,36,2,643,77,164,15,43,62,121,17,29,27,85,112,37,23,3,29,50,186
76,Willie Cauley-Stein,C,23,SAC,75,21,1421,255,481,0,2,255,479,101,151,85,254,339,80,53,44,69,147,611
77,Tyson Chandler,C,34,PHO,47,46,1298,153,228,0,0,153,228,91,124,153,386,539,30,33,24,65,126,397
78,Wilson Chandler,SF,29,DEN,71,33,2197,433,939,110,326,323,613,141,194,103,357,460,141,51,30,114,172,1117
79,Marquese Chriss,PF,19,PHO,82,75,1743,284,632,72,224,212,408,113,181,96,252,348,60,67,70,108,263,753
80,Rakeem Christmas,PF,25,IND,29,0,219,19,43,0,0,19,43,21,29,26,30,56,4,3,6,8,37,59
81,Semaj Christon,PG,24,OKC,64,1,973,77,223,12,63,65,160,17,31,19,68,87,130,28,7,43,79,183
82,Ian Clark,SG,25,GSW,77,0,1137,211,433,61,163,150,270,44,58,22,99,121,90,39,8,55,77,527
83,Jordan Clarkson,SG,24,LAL,82,19,2397,477,1071,117,356,360,715,134,168,49,197,246,213,88,8,164,150,1205
84,Norris Cole,PG,28,OKC,13,0,125,16,52,3,13,13,39,8,10,0,11,11,14,8,0,7,18,43
85,Darren Collison,PG,29,SAC,68,64,2063,340,714,73,175,267,539,147,171,23,129,152,312,67,9,114,119,900
86,Nick Collison,PF,36,OKC,20,0,128,14,23,0,1,14,22,5,8,9,22,31,12,2,2,4,17,33
87,Mike Conley,PG,29,MEM,69,68,2292,464,1009,171,419,293,590,316,368,31,210,241,433,92,19,156,126,1415
88,Pat Connaughton,SG,24,POR,39,1,316,37,72,17,33,20,39,7,9,10,42,52,28,6,2,17,23,98
89,Quinn Cook,PG,23,TOT,14,0,188,33,66,11,26,22,40,2,5,1,6,7,26,4,0,13,13,79
90,DeMarcus Cousins,C,26,TOT,72,72,2465,647,1432,131,363,516,1069,517,670,152,642,794,332,100,93,269,278,1942
91,Robert Covington,SF,26,PHI,67,67,2119,292,732,137,412,155,320,143,174,92,344,436,102,127,69,131,203,864
92,Allen Crabbe,SG,24,POR,79,7,2254,303,647,134,302,169,345,105,124,19,207,226,94,54,20,62,171,845
93,Jamal Crawford,SG,36,LAC,82,1,2157,359,870,116,322,243,548,174,203,17,112,129,214,61,14,134,115,1008
94,Jordan Crawford,SG,28,NOP,19,0,442,105,218,37,95,68,123,20,26,4,30,34,57,11,2,25,30,267
95,Jae Crowder,SF,26,BOS,72,72,2335,333,720,157,394,176,326,176,217,48,367,415,155,73,23,80,161,999
96,Dante Cunningham,PF,29,NOP,66,35,1649,174,359,71,181,103,178,16,27,56,221,277,37,39,28,28,100,435
97,Seth Curry,PG,26,DAL,70,42,2029,338,703,137,322,201,381,85,100,25,154,179,189,79,7,92,126,898
98,Stephen Curry,PG,28,GSW,79,79,2638,675,1443,324,789,351,654,325,362,61,292,353,524,142,17,239,183,1999
99,Troy Daniels,SG,25,MEM,67,3,1183,185,495,138,355,47,140,43,54,22,78,100,46,20,4,45,90,551
100,Anthony Davis,C,23,NOP,75,75,2708,770,1526,40,134,730,1392,519,647,172,712,884,157,94,167,181,168,2099
101,Deyonta Davis,C,20,MEM,36,0,238,24,47,0,0,24,47,10,18,20,40,60,2,3,17,8,40,58
102,Ed Davis,PF,27,POR,46,12,789,75,142,0,0,75,142,50,81,96,148,244,26,15,22,37,137,200
103,Dewayne Dedmon,C,27,SAS,76,37,1330,161,259,0,0,161,259,65,93,129,367,496,44,37,61,61,180,387
104,Sam Dekker,PF,22,HOU,77,2,1419,203,429,60,187,143,242,38,68,94,190,284,76,38,21,41,83,504
105,Malcolm Delaney,PG,27,ATL,73,2,1248,145,388,26,110,119,278,75,93,10,113,123,193,39,1,95,112,391
106,Matthew Dellavedova,PG,26,MIL,76,54,1986,208,534,79,215,129,319,82,96,24,123,147,357,53,0,133,153,577
107,Luol Deng,SF,31,LAL,56,49,1486,164,424,51,165,113,259,46,63,63,232,295,74,48,20,43,61,425
108,DeMar DeRozan,SG,27,TOR,74,74,2620,721,1545,33,124,688,1421,545,647,70,316,386,290,78,13,180,134,2020
109,Cheick Diallo,PF,20,NOP,17,0,199,36,76,0,0,36,76,15,21,23,50,73,4,4,7,7,17,87
110,Boris Diaw,PF,34,UTA,73,33,1283,146,327,20,81,126,246,26,35,46,112,158,170,18,9,87,83,338
111,Gorgui Dieng,PF,27,MIN,82,82,2653,332,661,16,43,316,618,136,167,188,459,647,158,88,95,107,254,816
112,Spencer Dinwiddie,PG,23,BRK,59,18,1334,134,302,38,101,96,201,126,159,27,137,164,185,44,23,66,119,432
113,Toney Douglas,PG,30,MEM,24,0,394,43,117,7,42,36,75,24,29,13,48,61,56,18,5,21,50,117
114,Goran Dragić,PG,30,MIA,73,73,2459,534,1124,117,289,417,835,298,377,62,217,279,423,89,13,212,199,1483
115,Andre Drummond,C,23,DET,81,81,2409,483,911,2,7,481,904,137,355,345,770,1115,90,124,89,152,237,1105
116,Jared Dudley,PF,31,PHO,64,7,1362,157,346,77,203,80,143,43,65,31,194,225,121,42,16,73,154,434
117,Mike Dunleavy,SF,36,TOT,53,2,841,93,220,53,134,40,86,36,45,18,97,115,50,15,7,28,67,275
118,Kris Dunn,PG,22,MIN,78,7,1333,118,313,21,73,97,240,36,59,24,142,166,188,78,36,89,178,293
119,Kevin Durant,PF,28,GSW,62,62,2070,551,1026,117,312,434,714,336,384,39,474,513,300,66,99,138,117,1555
120,Jarell Eddie,SF,25,PHO,5,0,62,6,19,4,16,2,3,8,9,1,6,7,0,1,0,1,1,24
121,Henry Ellenson,PF,20,DET,19,2,146,23,64,10,35,13,29,4,8,8,33,41,7,1,1,14,6,60
122,Wayne Ellington,SG,29,MIA,62,13,1500,231,555,149,394,82,161,37,43,18,114,132,70,35,4,30,70,648
123,Monta Ellis,SG,31,IND,74,33,1998,247,557,43,135,204,422,93,128,19,185,204,236,78,27,135,149,630
124,Joel Embiid,C,22,PHI,31,31,786,200,429,36,98,164,331,191,244,61,182,243,66,27,76,117,112,627
125,James Ennis,SF,26,MEM,64,28,1501,146,321,51,137,95,184,86,110,69,190,259,64,46,19,59,165,429
126,Tyler Ennis,PG,22,TOT,53,2,588,90,208,27,70,63,138,21,25,9,36,45,86,25,2,45,58,228
127,Tyreke Evans,SF,27,TOT,40,6,788,150,370,42,118,108,252,69,92,13,124,137,124,35,9,61,60,411
128,Dante Exum,PG,21,UTA,66,26,1228,155,363,44,149,111,214,58,73,30,102,132,111,21,12,80,146,412
129,Kenneth Faried,PF,27,DEN,61,34,1296,228,416,0,6,228,410,131,189,183,279,462,55,43,40,59,124,587
130,Jordan Farmar,PG,30,SAC,2,0,35,4,12,4,9,0,3,0,0,1,2,3,9,2,0,3,1,12
131,Derrick Favors,PF,25,UTA,50,39,1186,203,417,3,10,200,407,67,109,92,213,305,56,45,40,60,103,476
132,Kay Felder,PG,21,CLE,42,0,386,62,158,7,22,55,136,35,49,3,38,41,58,18,7,30,38,166
133,Cristiano Felício,C,24,CHI,66,0,1040,128,221,0,0,128,221,60,93,124,187,311,40,25,17,33,110,316
134,Raymond Felton,PG,32,LAC,80,11,1700,221,514,46,144,175,370,50,64,33,185,218,191,66,22,83,125,538
135,Yogi Ferrell,PG,23,TOT,46,29,1197,160,394,68,176,92,218,74,89,20,91,111,172,42,9,70,90,462
136,Dorian Finney-Smith,PF,23,DAL,81,35,1642,124,333,56,191,68,142,46,61,55,167,222,67,52,25,45,125,350
137,Bryn Forbes,SG,23,SAS,36,0,285,36,99,17,53,19,46,5,6,2,21,23,23,1,0,11,20,94
138,Evan Fournier,SG,24,ORL,68,66,2234,408,930,128,360,280,570,223,277,44,165,209,202,66,4,141,180,1167
139,Randy Foye,SG,33,BRK,69,40,1284,118,325,67,203,51,122,54,63,9,146,155,135,35,9,80,99,357
140,Tim Frazier,PG,26,NOP,65,35,1525,163,404,40,128,123,276,98,129,34,139,173,335,56,6,101,133,464
141,Channing Frye,C,33,CLE,74,15,1398,238,520,137,335,101,185,63,74,37,253,290,45,33,37,53,138,676
142,Danilo Gallinari,SF,28,DEN,63,63,2134,335,750,126,324,209,426,349,387,39,286,325,135,40,15,82,93,1145
143,Langston Galloway,PG,25,TOT,74,2,1495,207,545,120,308,87,237,51,64,27,129,156,93,46,6,46,96,585
144,Patricio Garino,SG,23,ORL,5,0,43,0,7,0,5,0,2,0,0,1,6,7,0,0,0,3,4,0
145,Marc Gasol,C,32,MEM,74,74,2531,532,1160,104,268,428,892,278,332,60,404,464,338,67,99,166,171,1446
146,Pau Gasol,C,36,SAS,64,39,1627,303,604,56,104,247,500,130,184,107,394,501,150,24,70,81,110,792
147,Rudy Gay,SF,30,SAC,30,30,1013,201,442,42,113,159,329,118,138,35,155,190,83,44,26,74,79,562
148,Michael Gbinije,SG,24,DET,9,0,32,1,10,0,4,1,6,2,2,2,1,3,2,0,0,0,2,4
149,Alonzo Gee,SF,29,DEN,13,0,89,3,14,0,3,3,11,5,9,4,11,15,6,5,1,4,14,11
150,Paul George,SF,26,IND,75,75,2689,622,1348,195,496,427,852,336,374,58,434,492,251,119,27,220,206,1775
151,Marcus Georges-Hunt,SG,22,ORL,5,0,48,2,7,1,2,1,5,9,10,1,8,9,3,1,0,2,5,14
152,Jonathan Gibson,PG,29,DAL,17,0,231,35,95,15,45,20,50,21,29,1,21,22,26,8,0,21,21,106
153,Taj Gibson,PF,31,TOT,78,71,1989,365,709,3,13,362,696,113,158,158,327,485,73,41,65,105,163,846
154,Manu Ginóbili,SG,39,SAS,69,0,1291,171,439,89,227,82,212,86,107,28,129,157,183,82,16,96,119,517
155,Rudy Gobert,C,24,UTA,81,81,2744,413,625,0,1,413,624,311,476,314,721,1035,97,49,214,147,246,1137
156,Archie Goodwin,SG,22,TOT,15,0,214,36,66,5,15,31,51,33,42,7,21,28,24,4,5,14,8,110
157,Aaron Gordon,SF,21,ORL,80,72,2298,393,865,77,267,316,598,156,217,116,289,405,150,65,40,89,172,1019
158,Eric Gordon,SG,28,HOU,75,15,2323,412,1016,246,661,166,355,147,175,29,172,201,188,48,41,121,150,1217
159,Marcin Gortat,C,32,WAS,82,82,2556,390,674,0,2,390,672,103,159,238,611,849,121,40,61,119,213,883
160,Treveon Graham,SG,23,CHO,27,1,189,19,40,9,15,10,25,10,15,5,17,22,6,6,1,3,18,57
161,Jerami Grant,PF,22,TOT,80,4,1531,152,328,43,116,109,212,90,147,38,167,205,46,33,79,44,149,437
162,Jerian Grant,PG,24,CHI,63,28,1028,128,301,49,134,79,167,65,73,17,94,111,121,47,8,44,93,370
163,Danny Green,SG,29,SAS,68,68,1807,176,449,118,311,58,138,27,32,31,193,224,124,70,57,76,120,497
164,Draymond Green,PF,26,GSW,76,76,2471,272,650,81,263,191,387,151,213,98,501,599,533,154,106,184,217,776
165,Gerald Green,SF,31,BOS,47,0,538,95,232,39,111,56,121,33,41,16,68,84,33,9,7,25,48,262
166,JaMychal Green,PF,26,MEM,77,75,2101,250,500,55,145,195,355,134,167,167,377,544,84,47,34,94,248,689
167,Jeff Green,PF,30,ORL,69,11,1534,220,558,53,193,167,365,145,168,39,175,214,81,37,13,75,103,638
168,Blake Griffin,PF,27,LAC,61,61,2076,479,971,38,113,441,858,320,421,112,385,497,300,57,22,142,157,1316
169,Justin Hamilton,C,26,BRK,64,7,1177,174,379,55,180,119,199,39,52,71,191,262,55,29,43,43,91,442
170,A.J. Hammons,C,24,DAL,22,0,163,17,42,5,10,12,32,9,20,8,28,36,4,1,13,10,21,48
171,Tim Hardaway,SG,24,ATL,79,30,2154,415,912,149,417,266,495,164,214,35,189,224,182,55,15,106,103,1143
172,James Harden,PG,27,HOU,81,81,2947,674,1533,262,756,412,777,746,881,95,564,659,907,121,38,464,215,2356
173,Maurice Harkless,SF,23,POR,77,69,2223,314,624,68,194,246,430,77,124,125,216,341,88,85,70,86,214,773
174,Justin Harper,PF,27,PHI,3,0,31,5,12,2,7,3,5,0,0,2,3,5,2,0,0,4,2,12
175,Montrezl Harrell,C,23,HOU,58,14,1064,225,345,1,7,224,338,76,121,81,138,219,64,20,42,44,126,527
176,Devin Harris,PG,33,DAL,65,0,1087,136,341,58,177,78,164,107,129,11,116,127,136,43,7,57,101,437
177,Gary Harris,SG,22,DEN,57,56,1782,320,637,107,255,213,382,104,134,48,130,178,164,71,8,76,92,851
178,Joe Harris,SG,25,BRK,52,11,1138,154,362,85,221,69,141,35,49,16,131,147,54,30,8,55,121,428
179,Manny Harris,SG,27,DAL,4,0,25,3,15,0,2,3,13,2,4,3,6,9,2,0,0,2,1,8
180,Tobias Harris,PF,24,DET,82,48,2567,511,1063,109,314,402,749,190,226,63,353,416,142,60,39,96,133,1321
181,Aaron Harrison,SG,22,CHO,5,0,17,0,4,0,2,0,2,1,2,0,3,3,3,0,0,0,2,1
182,Andrew Harrison,PG,22,MEM,72,18,1474,117,360,43,156,74,204,148,194,23,113,136,198,53,21,85,194,425
183,Udonis Haslem,C,36,MIA,16,0,130,11,23,0,3,11,20,9,15,8,28,36,6,6,1,8,22,31
184,Spencer Hawes,PF,28,TOT,54,1,797,134,277,25,81,109,196,44,52,38,153,191,81,15,30,49,77,337
185,Gordon Hayward,SF,26,UTA,73,73,2516,545,1156,149,374,396,782,362,429,49,345,394,252,73,20,140,117,1601
186,Gerald Henderson,SG,29,PHI,72,41,1667,234,553,61,173,173,380,133,165,34,151,185,112,40,15,62,129,662
187,John Henson,C,26,MIL,58,39,1123,159,309,0,1,159,308,74,107,92,203,295,57,29,78,52,151,392
188,Juan Hernangómez,PF,21,DEN,62,9,842,101,224,46,113,55,111,57,76,43,144,187,29,30,12,31,62,305
189,Willy Hernangómez,C,22,NYK,72,22,1324,246,465,4,15,242,450,91,125,170,332,502,96,41,36,100,150,587
190,Mario Hezonja,SF,21,ORL,65,2,960,117,330,43,144,74,186,40,50,20,126,146,62,30,15,58,74,317
191,Roy Hibbert,C,30,TOT,48,13,682,80,147,0,0,80,147,61,75,54,98,152,21,8,46,32,100,221
192,Buddy Hield,SG,24,TOT,82,55,1888,327,767,148,379,179,388,64,76,35,234,269,121,38,9,101,115,866
193,Nenê Hilário,C,34,HOU,67,8,1198,245,397,3,9,242,388,116,197,95,187,282,65,56,39,73,163,609
194,George Hill,PG,30,UTA,49,49,1544,289,606,94,233,195,373,157,196,23,144,167,204,50,11,85,114,829
195,Jordan Hill,C,29,MIN,7,0,47,5,13,0,0,5,13,2,2,8,6,14,0,1,0,4,9,12
196,Solomon Hill,SF,25,NOP,80,71,2374,183,478,94,270,89,208,103,128,51,256,307,141,72,32,82,182,563
197,Darrun Hilliard,SG,23,DET,39,1,381,47,126,12,46,35,80,21,28,2,31,33,33,11,2,28,39,127
198,Jrue Holiday,PG,26,NOP,67,61,2190,405,893,100,281,305,612,119,168,46,218,264,488,100,44,194,133,1029
199,Justin Holiday,SG,27,NYK,82,4,1639,233,538,97,273,136,265,66,80,27,198,225,102,65,31,66,109,629
200,Rondae Hollis-Jefferson,SF,22,BRK,78,50,1761,235,542,15,67,220,475,190,253,96,356,452,154,82,44,116,177,675
201,Richaun Holmes,C,23,PHI,57,17,1193,230,412,27,77,203,335,72,103,94,217,311,58,42,55,55,136,559
202,Rodney Hood,SG,24,UTA,59,55,1593,272,666,114,307,158,359,90,115,16,186,202,96,38,11,65,132,748
203,Al Horford,C,30,BOS,68,68,2193,379,801,86,242,293,559,108,135,95,370,465,337,52,86,115,138,952
204,Danuel House,SG,23,WAS,1,0,1,0,0,0,0,0,0,0,0,0,1,1,0,0,0,0,0,0
205,Dwight Howard,C,31,ATL,74,74,2199,388,613,0,2,388,611,226,424,296,644,940,104,64,92,170,203,1002
206,Marcelo Huertas,PG,33,LAL,23,1,237,25,68,4,19,21,49,9,17,2,22,24,52,10,2,19,16,63
207,Josh Huestis,PF,25,OKC,2,0,31,6,11,2,4,4,7,0,1,4,5,9,3,0,3,0,0,14
208,Kris Humphries,PF,31,ATL,56,4,689,87,214,19,54,68,160,64,82,60,146,206,29,15,21,28,69,257
209,R.J. Hunter,SG,23,CHI,3,0,9,0,1,0,1,0,0,0,0,0,1,1,0,0,0,0,0,0
210,Serge Ibaka,PF,27,TOT,79,79,2422,471,982,124,317,347,665,107,125,129,409,538,75,41,124,105,215,1173
211,Andre Iguodala,SF,33,GSW,76,0,1998,219,415,64,177,155,238,72,102,51,253,304,261,76,39,58,97,574
212,Ersan İlyasova,PF,29,TOT,82,52,2142,384,890,142,402,242,488,161,207,115,366,481,141,58,23,116,211,1071
213,Joe Ingles,SF,29,UTA,82,26,1972,204,451,123,279,81,172,50,68,23,238,261,225,96,8,107,163,581
214,Brandon Ingram,SF,19,LAL,79,40,2279,276,686,55,187,221,499,133,214,60,256,316,166,50,36,116,158,740
215,Kyrie Irving,PG,24,CLE,72,72,2525,671,1420,177,441,494,979,297,328,52,178,230,418,83,24,180,157,1816
216,Jarrett Jack,PG,33,NOP,2,0,33,2,3,0,1,2,2,2,2,0,0,0,5,2,0,3,4,6
217,Demetrius Jackson,PG,22,BOS,5,0,17,3,4,1,1,2,3,3,6,2,2,4,3,0,0,0,0,10
218,Pierre Jackson,PG,25,DAL,8,1,84,13,39,3,11,10,28,6,7,1,8,9,19,2,0,3,5,35
219,Reggie Jackson,PG,26,DET,52,50,1424,284,677,66,184,218,493,118,136,21,93,114,270,35,5,114,129,752
220,LeBron James,SF,32,CLE,74,74,2794,736,1344,124,342,612,1002,358,531,97,542,639,646,92,44,303,134,1954
221,Al Jefferson,C,32,IND,66,1,931,235,471,0,1,235,470,65,85,75,203,278,57,19,16,33,125,535
222,Richard Jefferson,SF,36,CLE,79,13,1614,153,343,62,186,91,157,80,108,28,175,203,78,26,10,52,153,448
223,John Jenkins,SG,25,PHO,4,0,13,2,5,1,2,1,3,2,2,0,1,1,1,0,0,0,0,7
224,Brandon Jennings,PG,27,TOT,81,13,1802,192,535,79,252,113,283,114,152,29,167,196,395,70,4,128,116,577
225,Jonas Jerebko,PF,29,BOS,78,6,1232,114,262,45,130,69,132,26,37,59,213,272,71,25,17,39,122,299
226,Amir Johnson,PF,29,BOS,80,77,1608,213,370,27,66,186,304,67,100,118,248,366,140,51,62,77,211,520
227,Brice Johnson,PF,22,LAC,3,0,9,2,7,0,0,2,7,0,0,1,2,3,1,2,1,1,0,4
228,James Johnson,PF,29,MIA,76,5,2085,368,769,87,256,281,513,152,215,66,310,376,276,76,86,171,197,975
229,Joe Johnson,SF,35,UTA,78,14,1843,273,626,106,258,167,368,63,77,33,210,243,144,36,18,69,93,715
230,Stanley Johnson,SF,20,DET,77,1,1371,129,365,45,154,84,211,36,53,36,153,189,105,56,24,71,121,339
231,Tyler Johnson,PG,24,MIA,73,0,2178,357,824,93,250,264,574,195,254,50,243,293,233,84,44,90,176,1002
232,Wesley Johnson,SF,29,LAC,68,3,810,73,200,29,118,44,82,11,17,26,155,181,23,29,30,18,83,186
233,Nikola Jokić,C,21,DEN,73,59,2038,494,854,45,139,449,715,188,228,212,506,718,359,61,55,171,214,1221
234,Dahntay Jones,SF,36,CLE,1,0,12,3,8,0,2,3,6,3,4,1,1,2,1,0,0,1,1,9
235,Damian Jones,C,21,GSW,10,0,85,8,16,0,0,8,16,3,10,9,14,23,0,1,4,6,15,19
236,Derrick Jones,SF,19,PHO,32,8,545,68,121,3,11,65,110,29,41,39,40,79,12,14,13,13,63,168
237,James Jones,SF,36,CLE,48,2,381,44,92,31,66,13,26,13,20,3,34,37,14,6,10,10,37,132
238,Terrence Jones,PF,25,TOT,54,12,1270,231,492,19,75,212,417,103,170,65,241,306,59,40,54,48,67,584
239,Tyus Jones,PG,20,MIN,60,0,774,75,181,26,73,49,108,33,43,10,57,67,156,48,5,38,50,209
240,DeAndre Jordan,C,28,LAC,81,81,2570,412,577,0,2,412,575,205,425,298,816,1114,96,51,134,115,212,1029
241,Cory Joseph,PG,25,TOR,80,22,2003,299,661,48,135,251,526,94,122,51,184,235,265,66,13,108,140,740
242,Frank Kaminsky,C,23,CHO,75,16,1954,320,802,116,354,204,448,118,156,57,279,336,162,46,34,76,139,874
243,Enes Kanter,C,24,OKC,72,0,1533,402,737,5,38,397,699,224,285,195,287,482,67,32,38,123,154,1033
244,Ryan Kelly,PF,25,ATL,16,0,110,8,28,4,10,4,18,5,6,1,17,18,8,4,5,4,5,25
245,Michael Kidd-Gilchrist,SF,23,CHO,81,81,2349,295,618,1,9,294,609,152,194,156,409,565,114,81,77,56,187,743
246,Sean Kilpatrick,SG,27,BRK,70,24,1754,305,735,105,308,200,427,204,242,22,258,280,157,45,6,135,118,919
247,Brandon Knight,SG,25,PHO,54,5,1140,209,525,45,139,164,386,132,154,25,93,118,130,27,5,88,87,595
248,Kyle Korver,SG,35,TOT,67,22,1753,239,515,162,359,77,156,38,42,7,179,186,110,34,21,69,107,678
249,Kosta Koufos,C,27,SAC,71,62,1419,216,392,0,1,216,391,38,62,118,285,403,47,36,48,61,172,470
250,Mindaugas Kuzminskas,SF,27,NYK,68,5,1016,158,369,54,168,104,201,55,68,47,79,126,69,29,11,51,79,425
251,Skal Labissière,PF,20,SAC,33,12,612,117,218,3,8,114,210,52,74,51,111,162,27,16,13,37,64,289
252,Jeremy Lamb,SG,24,CHO,62,5,1143,226,491,41,146,185,345,110,129,30,234,264,75,27,23,40,98,603
253,Nicolás Laprovíttola,PG,27,SAS,18,3,174,20,47,10,27,10,20,9,9,1,9,10,28,4,1,19,19,59
255,Zach LaVine,SG,21,MIN,47,47,1749,326,710,120,310,206,400,117,140,19,141,160,139,41,10,85,104,889
256,Ty Lawson,PG,29,SAC,69,24,1732,237,522,34,118,203,404,173,217,44,135,179,334,74,6,129,119,681
257,Jake Layman,SF,22,POR,35,1,249,26,89,13,51,13,38,13,17,6,18,24,11,9,3,11,22,78
258,Courtney Lee,SG,31,NYK,77,74,2459,321,704,108,269,213,435,85,98,53,206,259,179,81,24,69,141,835
259,David Lee,PF,33,SAS,79,10,1477,248,420,0,0,248,420,80,113,149,292,441,124,31,40,82,125,576
260,Alex Len,C,23,PHO,77,34,1560,230,463,3,12,227,451,150,208,156,354,510,44,38,98,102,242,613
261,Kawhi Leonard,SF,25,SAS,74,74,2474,636,1312,147,387,489,925,469,533,80,350,430,260,133,55,154,122,1888
262,Meyers Leonard,PF,24,POR,74,12,1222,146,378,74,213,72,165,35,40,27,210,237,71,13,28,35,172,401
263,Jon Leuer,PF,27,DET,75,34,1944,310,646,49,167,261,479,98,113,102,300,402,111,31,26,66,145,767
264,Caris LeVert,SF,22,BRK,57,26,1237,171,380,59,184,112,196,67,93,23,165,188,110,49,8,59,91,468
265,DeAndre Liggins,SG,28,TOT,62,19,777,55,142,17,46,38,96,25,40,20,88,108,54,47,14,42,81,152
266,Damian Lillard,PG,26,POR,75,75,2694,661,1488,214,579,447,909,488,545,46,322,368,440,68,20,197,152,2024
267,Jeremy Lin,PG,28,BRK,36,33,883,175,400,58,156,117,244,115,141,11,124,135,184,42,14,86,79,523
268,Shaun Livingston,PG,31,GSW,76,3,1345,173,316,1,3,172,313,42,60,28,123,151,139,38,20,62,120,389
269,Shawn Long,C,24,PHI,18,0,234,61,109,7,19,54,90,19,35,41,44,85,13,9,9,13,49,148
270,Kevon Looney,C,20,GSW,53,4,447,56,107,2,9,54,98,21,34,44,80,124,29,15,17,17,64,135
271,Brook Lopez,C,28,BRK,75,75,2222,555,1172,134,387,421,785,295,364,121,282,403,176,38,124,184,192,1539
272,Robin Lopez,C,28,CHI,81,81,2271,382,775,0,2,382,773,75,104,244,276,520,80,18,117,91,151,839
273,Kevin Love,PF,28,CLE,60,60,1885,370,867,145,389,225,478,257,295,148,518,666,116,53,21,122,125,1142
274,Kyle Lowry,PG,30,TOR,60,60,2244,426,918,193,468,233,450,299,365,48,238,286,417,88,19,173,170,1344
275,John Lucas III,PG,34,MIN,5,0,11,1,4,0,1,1,3,0,0,0,0,0,1,2,0,0,0,2
276,Timothé Luwawu-Cabarrot,SF,21,PHI,69,19,1190,145,361,50,161,95,200,105,123,25,124,149,75,32,10,73,154,445
277,Trey Lyles,PF,21,UTA,71,4,1158,159,439,65,204,94,235,57,79,48,187,235,69,26,20,64,97,440
278,Sheldon Mac,SG,24,WAS,30,3,287,30,75,7,30,23,45,23,27,4,30,34,15,8,2,5,17,90
279,Shelvin Mack,PG,26,UTA,55,9,1205,170,381,37,120,133,261,53,77,20,105,125,154,42,3,90,100,430
280,Ian Mahinmi,C,30,WAS,31,0,555,65,111,0,0,65,111,43,75,47,103,150,19,33,24,34,90,173
281,Thon Maker,C,19,MIL,57,34,562,83,181,28,74,55,107,32,49,40,74,114,23,10,26,17,84,226
282,Boban Marjanović,C,28,DET,35,0,293,72,132,0,0,72,132,47,58,46,84,130,9,6,12,10,25,191
283,Jarell Martin,PF,22,MEM,42,3,558,58,151,9,25,49,126,40,50,42,120,162,8,17,9,28,91,165
284,Wesley Matthews,SG,30,DAL,73,73,2495,333,847,174,479,159,368,146,179,18,241,259,210,77,15,102,161,986
285,Luc Mbah a Moute,SF,30,LAC,80,76,1787,191,378,43,110,148,268,59,87,44,126,170,39,81,35,46,122,484
286,James Michael McAdoo,PF,24,GSW,52,2,457,62,117,2,8,60,109,21,42,34,57,91,18,18,29,19,47,147
287,Patrick McCaw,SG,21,GSW,71,20,1074,106,245,41,123,65,122,29,37,21,79,100,77,32,15,36,62,282
288,CJ McCollum,SG,25,POR,80,80,2796,692,1441,185,439,507,1002,268,294,60,229,289,285,72,42,172,202,1837
289,T.J. McConnell,PG,24,PHI,81,51,2133,236,512,11,55,225,457,73,90,39,212,251,534,134,10,159,139,556
290,Chris McCullough,PF,21,TOT,16,0,80,16,32,1,7,15,25,3,5,9,10,19,2,2,2,3,7,36
291,K.J. McDaniels,SF,23,TOT,49,0,505,77,169,20,66,57,103,32,38,15,67,82,13,19,18,29,49,206
292,Doug McDermott,SF,25,TOT,66,5,1508,222,497,77,208,145,289,71,84,20,159,179,58,13,5,38,79,592
293,JaVale McGee,C,29,GSW,77,10,739,208,319,0,3,208,316,56,111,100,144,244,17,19,67,40,109,472
294,Rodney McGruder,SG,25,MIA,78,65,1966,190,460,73,220,117,240,44,71,94,162,256,124,46,18,56,140,497
295,Ben McLemore,SG,23,SAC,61,26,1176,180,419,65,170,115,249,70,93,19,110,129,51,29,6,62,108,495
296,Jordan McRae,SG,25,CLE,37,4,384,58,150,18,51,40,99,27,34,6,35,41,19,8,6,14,31,161
297,Josh McRoberts,PF,29,MIA,22,14,381,44,118,13,31,31,87,6,9,23,51,74,50,10,4,23,31,107
298,Jodie Meeks,SG,29,ORL,36,10,738,103,256,56,137,47,119,65,74,5,72,77,45,34,4,36,41,327
299,Salah Mejri,C,30,DAL,73,11,905,88,137,1,3,87,134,36,61,97,211,308,14,32,61,40,152,213
300,Jordan Mickey,PF,22,BOS,25,1,141,15,34,0,1,15,33,8,14,13,21,34,7,3,6,9,12,38
301,Khris Middleton,SF,25,MIL,29,23,889,150,333,45,104,105,229,81,92,11,112,123,99,41,7,65,79,426
302,C.J. Miles,SF,29,IND,76,29,1776,281,647,169,409,112,238,84,93,30,199,229,48,46,25,40,151,815
303,Mike Miller,SF,36,DEN,20,0,151,9,23,8,20,1,3,2,2,2,36,38,22,2,0,13,9,28
304,Patty Mills,PG,28,SAS,80,8,1754,273,621,147,355,126,266,66,80,24,117,141,280,65,3,101,109,759
305,Elijah Millsap,SG,29,PHO,2,0,23,1,7,0,2,1,5,1,2,3,3,6,1,0,0,2,2,3
306,Paul Millsap,PF,31,ATL,69,67,2343,430,972,75,241,355,731,311,405,111,422,533,252,90,62,158,186,1246
307,Nikola Mirotić,PF,25,CHI,70,15,1679,258,625,129,377,129,248,99,128,61,323,384,75,53,55,80,128,744
308,Greg Monroe,C,26,MIL,81,0,1823,387,726,0,4,387,722,177,239,167,365,532,187,92,38,140,168,951
309,E'Twaun Moore,SG,27,NOP,73,22,1820,283,619,77,208,206,411,57,74,33,119,152,164,50,32,62,131,700
310,Marcus Morris,SF,27,DET,79,79,2565,421,1007,118,357,303,650,145,185,77,289,366,160,52,25,87,168,1105
311,Markieff Morris,PF,27,WAS,76,76,2374,406,889,71,196,335,693,180,215,107,386,493,126,82,42,129,254,1063
312,Anthony Morrow,SG,31,TOT,49,7,714,98,252,41,133,57,119,34,37,12,19,31,25,24,2,6,44,271
313,Donatas Motiejūnas,PF,26,NOP,34,0,479,57,138,11,47,46,91,25,49,26,75,101,32,18,11,31,55,150
314,Timofey Mozgov,C,30,LAL,54,52,1104,169,328,0,1,169,327,63,78,104,160,264,43,16,31,72,133,401
315,Emmanuel Mudiay,PG,20,DEN,55,41,1406,208,551,56,178,152,373,131,167,29,149,178,217,41,13,123,95,603
316,Shabazz Muhammad,SF,24,MIN,78,1,1516,288,598,49,145,239,453,147,190,84,136,220,35,22,6,56,86,772
317,Dejounte Murray,PG,20,SAS,38,8,322,50,116,9,23,41,93,21,30,6,36,42,48,8,6,38,29,130
318,Jamal Murray,SG,19,DEN,82,10,1764,295,730,115,344,180,386,106,120,41,173,214,170,51,24,113,124,811
319,Mike Muscala,C,25,ATL,70,3,1237,170,337,46,110,124,227,49,64,76,164,240,95,30,41,55,97,435
320,Larry Nance,PF,24,LAL,63,7,1442,190,361,10,36,180,325,59,80,120,249,369,96,82,39,56,149,449
321,Shabazz Napier,PG,25,POR,53,2,512,73,183,34,92,39,91,38,49,8,53,61,67,32,2,41,38,218
322,Maurice Ndour,PF,24,NYK,32,4,331,39,86,1,7,38,79,19,26,22,42,64,8,15,8,12,30,98
323,Gary Neal,SG,32,ATL,2,0,18,0,7,0,2,0,5,4,4,0,1,1,1,0,0,0,1,4
324,Jameer Nelson,PG,34,DEN,75,39,2045,268,604,106,273,162,331,45,63,28,164,192,385,54,8,128,197,687
325,Raul Neto,PG,24,UTA,40,0,346,41,91,10,31,31,60,8,9,4,26,30,34,21,5,15,48,100
326,Georges Niang,PF,23,IND,23,0,93,9,36,1,12,8,24,2,2,2,15,17,5,3,0,5,6,21
327,Andrew Nicholson,PF,27,TOT,38,0,342,43,111,5,27,38,84,9,14,15,46,61,10,16,6,17,55,100
328,Joakim Noah,C,31,NYK,46,46,1015,99,202,0,1,99,201,34,78,162,241,403,103,30,37,58,127,232
329,Nerlens Noel,C,22,TOT,51,19,1047,184,309,0,1,184,308,77,111,93,201,294,50,65,50,51,126,445
330,Lucas Nogueira,C,24,TOR,57,6,1088,103,156,3,12,100,144,44,67,82,162,244,42,52,89,46,137,253
331,Steve Novak,PF,33,MIL,8,0,22,2,7,1,6,1,1,0,0,0,3,3,0,0,0,0,1,5
332,Dirk Nowitzki,PF,38,DAL,54,54,1424,296,678,79,209,217,469,98,112,23,330,353,82,30,38,51,113,769
333,Jusuf Nurkić,C,22,TOT,65,48,1391,271,534,0,1,271,533,120,210,154,313,467,123,50,74,143,161,662
334,David Nwaba,SG,24,LAL,20,2,397,47,81,1,5,46,76,25,39,17,46,63,14,13,7,11,36,120
335,Johnny O'Bryant,PF,23,TOT,11,0,80,15,30,3,6,12,24,5,6,9,10,19,6,0,1,6,10,38
336,Kyle O'Quinn,C,26,NYK,79,8,1229,215,413,2,17,213,396,64,83,157,282,439,117,36,104,76,174,496
337,Daniel Ochefu,C,23,WAS,19,0,75,12,27,0,0,12,27,0,2,5,17,22,3,2,0,3,17,24
338,Jahlil Okafor,C,21,PHI,50,33,1134,242,471,0,0,242,471,106,158,81,159,240,58,20,49,91,122,590
339,Victor Oladipo,SG,24,OKC,67,67,2222,412,932,127,352,285,580,116,154,39,252,291,176,78,21,119,155,1067
340,Kelly Olynyk,C,25,BOS,75,6,1538,260,508,68,192,192,316,90,123,73,288,361,148,43,29,96,207,678
341,Arinze Onuaku,C,29,ORL,8,0,28,2,4,0,0,2,4,0,0,2,4,6,2,0,1,2,3,4
342,Chinanu Onuaku,C,20,HOU,5,1,52,5,7,0,0,5,7,4,4,2,8,10,3,3,1,4,6,14
343,Kelly Oubre,SF,21,WAS,79,5,1605,186,442,54,188,132,254,75,99,61,200,261,47,58,17,50,195,501
344,Zaza Pachulia,C,32,GSW,70,70,1268,164,307,0,2,164,305,98,126,140,270,410,132,59,33,87,166,426
345,Georgios Papagiannis,C,19,SAC,22,0,355,56,102,0,2,56,100,12,14,24,62,86,20,3,17,24,44,124
346,Jabari Parker,PF,21,MIL,51,50,1728,399,814,65,178,334,636,162,218,79,235,314,142,50,22,93,111,1025
347,Tony Parker,PG,34,SAS,63,63,1587,265,569,23,69,242,500,85,117,9,104,113,285,34,2,89,92,638
348,Chandler Parsons,SF,28,MEM,34,34,675,75,222,25,93,50,129,35,43,6,78,84,55,20,5,24,52,210
349,Lamar Patterson,SG,25,ATL,5,0,40,3,15,1,6,2,9,2,3,1,6,7,6,1,0,4,6,9
350,Patrick Patterson,PF,27,TOR,65,8,1599,154,384,94,253,60,131,43,60,62,231,293,76,40,23,38,120,445
351,Chris Paul,PG,31,LAC,61,61,1921,374,785,124,302,250,483,232,260,40,264,304,563,119,8,147,146,1104
352,Adreian Payne,PF,25,MIN,18,0,135,23,54,3,15,20,39,14,19,9,24,33,7,8,7,8,32,63
353,Cameron Payne,PG,22,TOT,31,0,462,64,193,27,86,37,107,5,8,3,45,48,55,14,4,29,52,160
354,Elfrid Payton,PG,22,ORL,82,58,2412,430,912,40,146,390,766,146,211,89,298,387,529,88,40,178,177,1046
355,Gary Payton,PG,24,MIL,6,0,99,8,22,1,9,7,13,3,5,0,12,12,13,3,4,10,9,20
356,Paul Pierce,SF,39,LAC,25,7,277,28,70,15,43,13,27,10,13,1,47,48,10,4,5,16,40,81
357,Marshall Plumlee,C,24,NYK,21,1,170,16,30,0,0,16,30,8,19,23,28,51,10,4,4,12,23,40
358,Mason Plumlee,C,26,TOT,81,64,2148,334,623,0,6,334,617,174,300,170,435,605,284,69,92,134,226,842
359,Miles Plumlee,C,28,TOT,45,12,484,44,92,0,0,44,92,25,39,38,57,95,21,18,13,30,73,113
360,Jakob Pöltl,C,21,TOR,54,4,626,67,115,0,0,67,115,31,57,78,87,165,12,17,20,29,113,165
361,Otto Porter,SF,23,WAS,80,80,2605,414,803,148,341,266,462,99,119,118,396,514,121,116,42,44,193,1075
362,Bobby Portis,PF,21,CHI,64,13,1000,183,375,32,96,151,279,39,59,75,221,296,35,16,11,37,94,437
363,Kristaps Porziņģis,PF,21,NYK,66,65,2164,443,985,112,314,331,671,198,252,111,364,475,97,47,129,118,244,1196
364,Dwight Powell,C,25,DAL,77,3,1333,194,377,21,74,173,303,107,141,93,213,306,49,61,39,34,135,516
365,Norman Powell,SG,23,TOR,76,18,1368,227,506,56,173,171,333,126,159,26,143,169,82,52,14,70,127,636
366,Alex Poythress,PF,23,PHI,6,1,157,25,54,6,19,19,35,8,10,11,18,29,5,3,2,3,14,64
367,Ronnie Price,PG,33,PHO,14,0,134,4,24,3,17,1,7,3,4,3,8,11,18,11,1,3,14,14
368,Tim Quarterman,SG,22,POR,16,0,80,13,29,5,13,8,16,0,3,4,10,14,11,2,3,11,6,31
369,Chasson Randle,PG,23,TOT,26,0,299,40,98,16,47,24,51,41,43,6,26,32,34,9,2,19,39,137
370,Julius Randle,PF,22,LAL,74,73,2132,377,773,17,63,360,710,204,282,150,486,636,264,49,37,173,248,975
371,Zach Randolph,PF,35,MEM,73,5,1786,433,964,21,94,412,870,141,193,182,416,598,122,38,10,99,136,1028
372,J.J. Redick,SG,32,LAC,78,78,2198,396,890,201,468,195,422,180,202,11,160,171,110,54,13,98,125,1173
373,Willie Reed,C,26,MIA,71,5,1031,162,285,1,4,161,281,49,88,129,203,332,26,18,47,31,137,374
374,Josh Richardson,SG,23,MIA,53,34,1614,202,513,75,227,127,286,60,77,35,133,168,140,60,39,65,132,539
375,Malachi Richardson,SG,21,SAC,22,0,198,28,68,8,28,20,40,15,19,3,20,23,11,5,1,8,23,79
376,Austin Rivers,SG,24,LAC,74,29,2054,323,731,111,299,212,432,132,191,20,141,161,204,48,10,115,187,889
377,Andre Roberson,SF,25,OKC,79,79,2376,215,463,45,184,170,279,47,111,98,305,403,79,94,79,51,204,522
378,Brian Roberts,PG,31,CHO,41,2,416,46,122,17,44,29,78,33,39,5,34,39,52,9,1,26,18,142
379,Glenn Robinson,SF,23,IND,69,27,1427,158,338,49,125,109,213,54,76,57,189,246,47,41,20,37,63,419
380,Thomas Robinson,PF,25,LAL,48,1,560,105,196,0,1,105,195,31,66,84,139,223,31,26,9,46,76,241
381,Sergio Rodríguez,PG,30,PHI,68,30,1518,210,536,92,252,118,284,18,27,21,136,157,344,49,4,128,95,530
382,Rajon Rondo,PG,30,CHI,69,42,1843,229,561,50,133,179,428,30,50,73,282,355,461,99,11,169,144,538
383,Derrick Rose,PG,28,NYK,64,64,2082,460,977,13,60,447,917,221,253,66,180,246,283,44,17,147,84,1154
384,Terrence Ross,SF,25,TOT,78,24,1955,326,746,142,391,184,355,64,77,18,188,206,88,87,33,68,143,858
385,Terry Rozier,PG,22,BOS,74,0,1263,151,411,57,179,94,232,51,66,40,187,227,131,46,11,47,69,410
386,Ricky Rubio,PG,26,MIN,75,75,2469,261,650,60,196,201,454,254,285,68,237,305,682,128,10,195,202,836
387,Damjan Rudež,SF,30,ORL,45,0,314,31,88,20,64,11,24,0,0,5,20,25,20,12,1,9,31,82
388,Brandon Rush,SG,31,MIN,47,33,1030,70,187,44,114,26,73,13,18,16,83,99,45,22,23,28,42,197
389,D'Angelo Russell,PG,20,LAL,63,60,1811,351,867,135,384,216,483,147,188,31,190,221,303,87,16,176,130,984
390,Domantas Sabonis,PF,20,OKC,81,66,1632,192,481,51,159,141,322,44,67,46,242,288,82,39,32,83,200,479
391,Larry Sanders,C,28,CLE,5,0,13,1,4,0,0,1,4,2,2,3,1,4,0,1,1,2,5,4
392,Dario Šarić,PF,22,PHI,81,36,2129,381,927,106,341,275,586,172,220,112,401,513,182,57,30,183,162,1040
393,Tomáš Satoranský,SG,25,WAS,57,3,719,61,147,9,37,52,110,23,33,25,58,83,92,26,6,38,60,154
394,Dennis Schröder,PG,23,ATL,79,78,2485,548,1214,100,294,448,920,218,255,42,206,248,499,74,16,258,149,1414
395,Luis Scola,PF,36,BRK,36,1,461,71,151,17,50,54,101,25,37,51,88,139,37,14,4,34,63,184
396,Mike Scott,PF,28,ATL,18,0,195,17,59,4,27,13,32,7,8,10,27,37,17,4,3,8,12,45
397,Thabo Sefolosha,SF,32,ATL,62,42,1596,174,395,41,120,133,275,55,75,54,216,270,107,96,31,58,97,444
398,Wayne Selden,SG,22,TOT,14,5,236,25,58,7,28,18,30,14,22,1,15,16,13,6,1,12,18,71
399,Kevin Séraphin,PF,27,IND,49,3,559,109,198,0,2,109,196,14,22,41,101,142,23,7,20,29,66,232
400,Ramon Sessions,PG,30,CHO,50,1,811,100,263,21,62,79,201,91,118,11,62,73,129,27,3,46,43,312
401,Iman Shumpert,SG,26,CLE,76,31,1937,201,489,94,261,107,228,71,90,39,179,218,109,62,27,78,150,567
402,Pascal Siakam,PF,22,TOR,55,38,859,103,205,1,7,102,198,22,32,64,121,185,17,26,45,33,109,229
403,Jonathon Simmons,SG,27,SAS,78,8,1392,177,421,30,102,147,319,99,132,20,140,160,126,47,25,76,146,483
404,Kyle Singler,SF,28,OKC,32,2,385,34,83,7,37,27,46,13,17,8,40,48,9,7,5,11,29,88
405,Marcus Smart,SG,22,BOS,79,24,2399,269,749,94,332,175,417,203,250,78,227,305,364,125,34,159,192,835
406,Ish Smith,PG,28,DET,81,32,1955,329,749,28,105,301,644,72,102,21,214,235,418,61,33,112,127,758
407,J.R. Smith,SG,31,CLE,41,35,1187,123,356,95,271,28,85,10,15,17,96,113,62,40,11,26,77,351
408,Jason Smith,C,30,WAS,74,3,1068,174,329,37,78,137,251,35,51,64,194,258,37,21,54,58,168,420
409,Tony Snell,SG,25,MIL,80,80,2336,246,541,144,355,102,186,47,58,22,226,248,96,55,14,55,125,683
410,Marreese Speights,C,29,LAC,82,2,1286,244,548,103,277,141,271,120,137,88,285,373,65,23,41,69,229,711
411,Tiago Splitter,C,32,PHI,8,0,76,14,31,2,6,12,25,9,11,8,14,22,4,1,1,6,8,39
412,Nik Stauskas,SG,23,PHI,80,27,2188,251,634,132,359,119,275,122,150,21,205,226,188,45,32,128,144,756
413,Lance Stephenson,SG,26,TOT,18,0,361,54,120,6,20,48,100,8,13,4,48,52,59,5,3,26,32,122
414,Jarnell Stokes,C,23,DEN,2,0,7,1,1,0,0,1,1,1,2,1,1,2,2,1,0,0,3,3
415,Diamond Stone,C,19,LAC,7,0,24,3,13,0,0,3,13,4,4,1,5,6,0,0,1,2,5,10
416,Rodney Stuckey,PG,30,IND,39,0,696,91,244,19,60,72,184,80,107,6,78,84,84,16,0,53,44,281
417,Jared Sullinger,PF,24,TOR,11,1,118,15,47,3,18,12,29,4,8,10,17,27,3,4,1,4,17,37
418,Edy Tavares,C,24,TOT,2,0,28,4,5,0,0,4,5,0,3,4,7,11,1,0,6,2,3,8
419,Isaiah Taylor,PG,22,HOU,4,0,52,1,7,0,2,1,5,1,2,1,2,3,3,1,1,0,6,3
420,Jeff Teague,PG,28,IND,82,82,2657,402,909,90,252,312,657,360,415,33,297,330,639,100,32,216,165,1254
421,Mirza Teletović,PF,31,MIL,70,2,1133,156,418,104,305,52,113,35,45,11,151,162,48,12,13,37,109,451
422,Garrett Temple,SG,30,SAC,65,21,1728,183,432,82,220,101,212,58,74,32,152,184,168,84,28,78,141,506
423,Jason Terry,SG,39,MIL,74,0,1365,105,243,73,171,32,72,24,29,15,91,106,98,46,20,36,95,307
424,Isaiah Thomas,PG,27,BOS,76,76,2569,682,1473,245,646,437,827,590,649,43,162,205,448,70,13,210,167,2199
425,Lance Thomas,PF,28,NYK,46,15,968,97,244,38,85,59,159,43,51,32,110,142,35,21,5,25,85,275
426,Hollis Thompson,SG,25,TOT,40,9,752,77,200,32,95,45,105,19,29,19,93,112,35,20,6,11,69,205
427,Klay Thompson,SG,26,GSW,78,78,2649,644,1376,268,647,376,729,186,218,49,236,285,160,66,40,128,139,1742
428,Tristan Thompson,C,25,CLE,78,78,2336,262,437,0,3,262,434,106,213,286,429,715,77,39,84,64,176,630
429,Marcus Thornton,SG,29,WAS,33,1,575,84,210,28,80,56,130,23,27,22,54,76,41,19,3,25,48,219
430,Mike Tobey,C,22,CHO,2,0,25,1,4,0,0,1,4,0,0,2,1,3,1,0,0,1,2,2
431,Anthony Tolliver,PF,31,SAC,65,9,1477,155,351,90,230,65,121,61,82,51,186,237,77,34,20,56,109,461
432,Axel Toupane,SF,24,TOT,4,0,47,5,9,1,4,4,5,0,0,0,1,1,0,1,1,0,6,11
433,Karl-Anthony Towns,C,21,MIN,82,82,3030,802,1480,101,275,701,1205,356,428,296,711,1007,220,56,103,212,241,2061
434,P.J. Tucker,SF,31,TOT,81,21,2236,199,482,70,196,129,286,72,93,117,354,471,99,116,19,66,196,540
435,Evan Turner,SF,28,POR,65,12,1658,235,552,31,118,204,434,85,103,36,211,247,205,53,24,100,121,586
436,Myles Turner,C,20,IND,81,81,2541,444,869,40,115,404,754,245,303,139,450,589,106,74,172,105,262,1173
437,Beno Udrih,PG,34,DET,39,0,560,92,197,11,32,81,165,32,34,6,51,57,131,13,0,36,29,227
438,Tyler Ulis,PG,21,PHO,61,15,1123,184,437,21,79,163,358,55,71,20,75,95,226,48,5,77,73,444
439,Jarrod Uthoff,PF,23,DAL,9,0,115,16,38,3,9,13,29,5,7,8,14,22,9,2,4,3,8,40
440,Jonas Valančiūnas,C,24,TOR,80,80,2066,391,702,1,2,390,700,176,217,226,533,759,57,37,63,106,216,959
441,Denzel Valentine,SG,23,CHI,57,0,976,102,288,73,208,29,80,14,18,11,140,151,63,30,7,49,86,291
442,Fred VanVleet,PG,22,TOR,37,0,294,39,111,11,29,28,82,18,22,4,38,42,35,16,3,15,36,107
443,Anderson Varejão,C,34,GSW,14,1,92,5,14,0,0,5,14,8,11,12,15,27,10,3,3,8,16,18
444,Greivis Vásquez,PG,30,BRK,3,0,39,2,8,1,3,1,5,2,3,0,2,2,5,1,1,1,6,7
445,Rashad Vaughn,SG,20,MIL,41,2,458,57,156,26,81,31,75,2,5,4,45,49,23,19,10,14,32,142
446,Noah Vonleh,PF,21,POR,74,41,1265,130,270,7,20,123,250,60,94,131,256,387,31,30,27,64,154,327
447,Nikola Vučević,C,26,ORL,75,55,2163,483,1031,23,75,460,956,107,160,176,603,779,208,76,74,117,180,1096
448,Sasha Vujačić,SG,32,NYK,42,4,408,42,136,23,74,19,62,17,24,12,47,59,52,13,2,16,38,124
449,Dwyane Wade,SG,35,CHI,60,59,1792,414,955,45,145,369,810,223,281,63,207,270,228,86,41,138,112,1096
450,Dion Waiters,SG,25,MIA,46,43,1384,281,663,85,215,196,448,82,127,18,135,153,200,42,20,103,95,729
451,Kemba Walker,PG,26,CHO,79,79,2739,643,1449,240,602,403,847,304,359,45,263,308,434,85,22,168,119,1830
452,John Wall,PG,26,WAS,78,78,2836,647,1435,89,272,558,1163,422,527,59,267,326,831,157,49,322,151,1805
453,Taurean Waller-Prince,SF,22,ATL,59,10,981,114,285,33,102,81,183,74,94,25,132,157,55,43,27,61,96,335
454,T.J. Warren,SF,23,PHO,66,59,2048,403,814,26,98,377,716,119,154,125,214,339,75,76,39,57,175,951
455,C.J. Watson,PG,32,ORL,62,9,1012,96,248,32,105,64,143,57,66,16,73,89,114,43,2,47,84,281
456,Briante Weber,PG,24,TOT,20,0,205,25,60,1,10,24,50,11,16,8,18,26,21,12,1,8,16,62
457,David West,C,36,GSW,68,0,854,135,252,3,8,132,244,43,56,47,156,203,151,42,48,78,105,316
458,Russell Westbrook,PG,28,OKC,81,81,2802,824,1941,200,583,624,1358,710,840,137,727,864,840,132,31,438,190,2558
459,Okaro White,PF,24,MIA,35,0,471,33,87,12,34,21,53,20,22,25,57,82,21,10,10,18,52,98
460,Isaiah Whitehead,PG,21,BRK,73,26,1643,204,508,44,149,160,359,91,113,32,152,184,192,42,36,142,175,543
461,Hassan Whiteside,C,27,MIA,77,77,2513,542,973,0,0,542,973,225,358,293,795,1088,57,57,161,154,226,1309
462,Andrew Wiggins,SF,21,MIN,82,82,3048,709,1570,103,289,606,1281,412,542,102,226,328,189,82,30,187,183,1933
463,C.J. Wilcox,SG,26,ORL,22,0,108,8,31,3,15,5,16,2,2,4,8,12,12,2,1,6,8,21
464,Alan Williams,C,24,PHO,47,0,708,138,267,0,1,138,266,70,112,94,198,292,23,27,32,37,125,346
465,Deron Williams,PG,32,TOT,64,44,1657,263,600,85,234,178,366,90,109,14,133,147,360,31,8,138,138,701
466,Derrick Williams,PF,25,TOT,50,11,804,108,244,30,97,78,147,58,89,19,111,130,28,14,7,28,60,304
467,Lou Williams,SG,30,TOT,81,1,1994,428,998,163,446,265,552,402,457,26,176,202,239,80,20,160,92,1421
468,Marvin Williams,PF,30,CHO,76,76,2295,297,704,124,354,173,350,131,150,89,411,500,106,58,53,60,134,849
469,Reggie Williams,SF,30,NOP,6,0,79,8,23,5,11,3,12,6,7,2,4,6,4,3,0,0,2,27
470,Troy Williams,SF,22,TOT,30,16,557,73,167,18,62,55,105,21,32,15,54,69,25,27,10,32,60,185
471,Kyle Wiltjer,PF,24,HOU,14,0,44,4,14,4,13,0,1,1,2,4,6,10,2,3,1,5,4,13
472,Justise Winslow,SF,20,MIA,18,15,625,80,225,7,35,73,190,29,47,23,71,94,66,26,6,33,52,196
473,Jeff Withey,C,26,UTA,51,1,432,55,103,0,1,55,102,36,48,52,69,121,7,16,32,14,52,146
474,Christian Wood,PF,21,CHO,13,0,107,12,23,0,5,12,18,11,15,14,15,29,2,3,6,7,11,35
475,Metta World Peace,SF,37,LAL,25,2,160,19,68,9,38,10,30,10,16,5,15,20,11,10,2,7,18,57
476,Brandan Wright,PF,29,MEM,28,5,447,83,135,0,1,83,134,23,35,31,47,78,15,11,20,10,42,189
477,Delon Wright,PG,24,TOR,27,0,446,49,116,10,30,39,86,42,55,16,32,48,57,27,11,25,31,150
478,James Young,SG,21,BOS,29,0,220,25,58,12,35,13,23,6,9,6,20,26,4,10,2,4,15,68
479,Joe Young,PG,24,IND,33,0,135,26,72,5,23,21,49,11,15,1,16,17,15,4,0,5,5,68
480,Nick Young,SG,31,LAL,60,60,1556,272,633,170,421,102,212,77,90,25,113,138,58,37,14,36,137,791
481,Thaddeus Young,PF,28,IND,74,74,2237,362,687,45,118,317,569,45,86,131,317,448,122,113,29,95,135,814
482,Cody Zeller,C,24,CHO,62,58,1725,253,443,0,1,253,442,133,196,135,270,405,99,62,58,65,189,639
483,Tyler Zeller,C,27,BOS,51,5,525,78,158,0,1,78,157,22,39,43,81,124,42,7,21,20,61,178
484,Stephen Zimmerman,C,20,ORL,19,0,108,10,31,0,0,10,31,3,5,11,24,35,4,2,5,3,17,23
485,Paul Zipser,SF,22,CHI,44,18,843,88,221,33,99,55,122,31,40,15,110,125,36,15,16,40,78,240
486,Ivica Zubac,C,19,LAL,38,11,609,126,238,0,3,126,235,32,49,41,118,159,30,14,33,30,66,284
1,Álex Abrines,SG,24,OKC,75,8,1134,115,291,84,221,31,70,39,46,26,88,114,28,38,8,25,124,353
2,Quincy Acy,PF,27,BRK,70,8,1359,130,365,102,292,28,73,49,60,40,217,257,57,33,29,60,149,411
3,Steven Adams,C,24,OKC,76,76,2487,448,712,0,2,448,710,160,286,384,301,685,88,92,78,128,215,1056
4,Bam Adebayo,C,20,MIA,69,19,1368,174,340,0,7,174,333,129,179,118,263,381,101,32,41,66,138,477
5,Arron Afflalo,SG,32,ORL,53,3,682,65,162,27,70,38,92,22,26,4,62,66,30,4,9,21,56,179
6,Cole Aldrich,C,29,MIN,21,0,49,5,15,0,0,5,15,2,6,3,12,15,3,2,1,1,11,12
7,LaMarcus Aldridge,C,32,SAS,75,75,2509,687,1347,27,92,660,1255,334,399,246,389,635,152,43,90,111,161,1735
8,Jarrett Allen,C,19,BRK,72,31,1441,234,397,5,15,229,382,114,147,144,244,388,49,28,88,82,147,587
9,Kadeem Allen,PG,25,BOS,18,1,107,6,22,0,11,6,11,7,9,4,7,11,12,3,2,9,15,19
10,Tony Allen,SF,36,NOP,22,0,273,44,91,4,12,40,79,11,21,20,27,47,9,11,3,19,49,103
11,Al-Farouq Aminu,PF,27,POR,69,67,2072,230,582,125,339,105,243,59,80,97,428,525,84,79,40,79,136,644
12,Justin Anderson,SF,24,PHI,38,0,519,87,202,34,103,53,99,28,38,25,68,93,25,15,7,16,54,236
13,Kyle Anderson,SF,24,SAS,74,67,1978,231,438,19,57,212,381,104,146,84,312,396,202,115,60,94,114,585
14,Ryan Anderson,PF,29,HOU,66,50,1725,207,480,131,339,76,141,72,93,94,237,331,60,24,21,42,126,617
15,Ike Anigbogu,C,19,IND,11,0,30,4,9,0,0,4,9,5,6,5,4,9,0,1,3,2,1,13
16,Giannis Antetokounmpo,PF,23,MIL,75,75,2756,742,1402,43,140,699,1262,487,641,156,597,753,361,109,106,223,231,2014
17,Carmelo Anthony,PF,33,OKC,78,78,2501,472,1168,169,474,303,694,148,193,67,386,453,103,47,49,99,197,1261
18,OG Anunoby,SF,20,TOR,74,62,1481,163,346,73,197,90,149,39,62,44,140,184,55,52,14,45,130,438
19,Ryan Arcidiacono,PG,23,CHI,24,0,304,17,41,9,31,8,10,5,6,1,24,25,35,13,0,13,18,48
20,Trevor Ariza,SF,32,HOU,67,67,2269,268,651,170,462,98,189,76,89,33,261,294,105,98,13,52,132,782
21,Darrell Arthur,PF,29,DEN,19,1,141,22,47,8,23,14,24,2,3,3,12,15,9,8,3,15,22,54
22,Jamel Artis,SG,25,ORL,15,1,279,31,79,8,29,23,50,7,12,4,34,38,18,2,3,8,11,77
23,Ömer Aşık,C,31,TOT,18,0,182,9,22,0,0,9,22,4,13,9,38,47,3,2,4,9,20,22
24,D.J. Augustin,PG,30,ORL,75,36,1760,244,540,114,272,130,268,164,189,30,130,160,287,54,0,123,94,766
25,Luke Babbitt,SF,28,TOT,50,14,715,91,215,60,156,31,59,17,22,7,89,96,31,8,7,19,54,259
26,Dwayne Bacon,SG,22,CHO,53,6,713,72,192,11,43,61,149,20,25,4,120,124,38,16,2,23,46,175
27,Ron Baker,SG,24,NYK,29,1,385,20,59,11,33,9,26,20,26,5,25,30,47,26,6,18,33,71
28,Wade Baldwin,PG,21,POR,7,0,80,14,21,4,5,10,16,6,10,1,7,8,5,2,1,4,12,38
29,Lonzo Ball,PG,20,LAL,52,50,1780,203,564,90,295,113,269,32,71,69,291,360,376,88,43,136,117,528
30,J.J. Barea,PG,33,DAL,69,10,1603,303,690,115,313,188,377,80,102,15,186,201,434,35,3,143,83,801
31,Harrison Barnes,PF,25,DAL,77,77,2634,537,1208,119,333,418,875,259,313,77,391,468,152,49,14,118,94,1452
32,Will Barton,SG,27,DEN,81,40,2683,465,1028,156,422,309,606,182,226,70,339,409,331,82,52,149,168,1268
33,Nicolas Batum,SG,29,CHO,64,64,1981,270,650,92,274,178,376,108,130,57,249,306,349,65,23,131,72,740
34,Jerryd Bayless,SG,29,PHI,39,11,925,109,262,54,146,55,116,35,44,15,65,80,54,23,6,46,91,307
35,Aron Baynes,C,31,BOS,81,67,1485,210,446,3,21,207,425,59,78,130,304,434,93,22,51,80,200,482
36,Kent Bazemore,SG,28,ATL,65,65,1789,284,676,108,274,176,402,160,201,25,223,248,228,100,45,157,147,836
37,Bradley Beal,SG,24,WAS,82,82,2977,683,1484,199,530,484,954,292,369,61,302,363,373,96,36,214,160,1857
38,Malik Beasley,SG,21,DEN,62,0,583,73,178,28,82,45,96,22,33,14,57,71,31,15,7,24,36,196
39,Michael Beasley,PF,29,NYK,74,30,1653,409,807,34,86,375,721,124,159,97,317,414,123,36,43,143,145,976
40,Marco Belinelli,SG,31,TOT,80,2,1947,337,764,149,395,188,369,148,163,20,131,151,148,66,12,94,91,971
41,Jordan Bell,C,23,GSW,57,13,809,116,185,0,4,116,181,30,44,60,147,207,102,35,56,51,92,262
42,DeAndre' Bembry,SF,23,ATL,26,3,455,53,128,11,30,42,98,19,33,8,64,72,49,21,12,47,38,136
43,Dragan Bender,PF,20,PHO,82,37,2069,187,484,118,322,69,162,39,51,40,321,361,130,22,53,112,166,531
44,Dāvis Bertāns,PF,25,SAS,77,10,1086,161,366,94,252,67,114,40,49,18,135,153,74,26,28,36,93,456
45,Patrick Beverley,SG,29,LAC,11,11,334,48,119,24,60,24,59,14,17,16,29,45,32,19,5,25,34,134
46,Khem Birch,C,25,ORL,42,0,578,68,126,0,0,68,126,42,61,70,110,180,34,15,21,21,56,178
47,Jabari Bird,SG,23,BOS,13,1,115,15,26,3,7,12,19,6,13,6,13,19,8,3,1,8,7,39
48,Bismack Biyombo,C,25,ORL,82,25,1495,183,352,0,1,183,351,102,157,144,324,468,66,21,95,84,158,468
49,Nemanja Bjelica,PF,29,MIN,67,21,1371,171,371,76,183,95,188,36,45,53,221,274,86,50,16,52,141,454
50,Tarik Black,C,26,HOU,51,2,536,75,127,1,11,74,116,29,63,63,100,163,13,21,30,35,107,180
51,Antonio Blakeney,SG,21,CHI,19,0,314,53,143,15,52,38,91,30,39,4,29,33,20,7,1,11,19,151
52,Eric Bledsoe,PG,28,TOT,74,74,2322,468,989,125,360,343,629,252,317,51,233,284,370,149,42,216,185,1313
53,Vander Blue,SG,25,LAL,5,0,45,1,5,0,2,1,3,1,2,0,1,1,3,1,0,3,2,3
54,Bogdan Bogdanović,SG,25,SAC,78,53,2175,344,772,129,329,215,443,100,119,31,192,223,258,72,16,125,172,917
55,Bojan Bogdanović,SF,28,IND,80,80,2464,404,852,155,386,249,466,178,205,30,240,270,119,55,8,106,129,1141
56,Andrew Bogut,C,33,LAL,24,5,216,17,25,0,0,17,25,2,2,26,52,78,15,4,13,19,40,36
57,Joel Bolomboy,PF,24,MIL,6,0,38,3,6,0,1,3,5,3,6,6,4,10,0,2,0,2,3,9
58,Devin Booker,SG,21,PHO,54,54,1865,455,1054,147,384,308,670,289,329,26,218,244,253,47,14,194,168,1346
59,Trevor Booker,PF,30,TOT,68,7,1158,177,343,8,33,169,310,66,93,117,201,318,82,28,21,59,119,428
60,Chris Boucher,PF,25,GSW,1,0,1,0,1,0,1,0,0,0,0,0,1,1,0,0,0,0,0,0
61,Avery Bradley,SG,27,TOT,46,46,1433,259,625,75,203,184,422,63,82,22,94,116,94,51,8,101,92,656
62,Tony Bradley,C,20,UTA,9,0,29,3,11,0,1,3,10,2,2,4,7,11,1,0,0,0,1,8
64,Malcolm Brogdon,PG,25,MIL,48,20,1436,244,503,62,161,182,342,75,85,23,133,156,152,41,13,66,128,625
65,Aaron Brooks,PG,33,MIN,32,1,189,28,69,11,31,17,38,8,11,7,10,17,20,6,0,11,28,75
66,Dillon Brooks,SF,22,MEM,82,74,2350,340,772,94,264,246,508,124,166,49,208,257,135,73,17,124,233,898
67,MarShon Brooks,SG,29,MEM,7,1,193,51,102,19,32,32,70,20,23,8,13,21,25,11,3,16,6,141
68,Anthony Brown,SF,25,MIN,1,0,4,1,1,1,1,0,0,0,0,0,0,0,1,0,0,0,0,3
69,Bobby Brown,PG,33,HOU,20,0,115,19,58,11,40,8,18,1,2,0,7,7,11,4,0,9,6,50
70,Jaylen Brown,SG,21,BOS,70,70,2152,373,803,121,306,252,497,150,233,66,280,346,114,70,26,124,181,1017
71,Lorenzo Brown,PG,27,TOR,14,0,139,14,34,2,12,12,22,2,2,1,14,15,13,5,0,3,7,32
72,Markel Brown,SG,26,HOU,4,0,31,2,7,1,5,1,2,0,0,1,4,5,2,0,0,2,6,5
73,Sterling Brown,SG,22,MIL,54,4,776,82,205,32,91,50,114,21,24,27,116,143,25,31,13,25,80,217
74,Nicolás Brussino,SF,24,ATL,4,0,10,0,2,0,2,0,0,0,0,0,3,3,0,0,0,0,0,0
75,Thomas Bryant,C,20,LAL,15,0,72,8,21,1,10,7,11,5,9,3,14,17,6,1,2,2,6,22
76,Reggie Bullock,SF,26,DET,62,52,1732,267,546,125,281,142,265,39,49,27,127,154,95,47,13,47,70,698
77,Trey Burke,PG,25,NYK,36,9,785,193,384,38,105,155,279,37,57,13,58,71,170,24,4,43,43,461
78,Alec Burks,SG,26,UTA,64,1,1059,170,414,47,142,123,272,107,124,19,173,192,67,37,8,60,75,494
79,Jimmy Butler,SG,28,MIN,59,59,2164,437,921,70,200,367,721,363,425,79,235,314,288,116,24,108,78,1307
80,Dwight Buycks,PG,28,DET,29,0,427,82,198,15,45,67,153,36,41,12,29,41,59,19,2,39,39,215
81,Bruno Caboclo,SF,22,TOT,12,0,107,9,31,3,17,6,14,5,6,7,15,22,4,3,4,4,8,26
82,José Calderón,PG,36,CLE,57,32,914,93,185,45,97,48,88,24,30,14,70,84,117,27,2,41,81,255
83,Kentavious Caldwell-Pope,SG,24,LAL,74,74,2458,340,798,159,415,181,383,153,194,60,327,387,162,106,16,97,145,992
85,Clint Capela,C,23,HOU,74,74,2034,441,676,0,1,441,675,144,257,241,561,802,68,58,137,103,185,1026
86,DeMarre Carroll,PF,31,BRK,73,73,2180,325,785,145,391,180,394,188,246,105,374,479,147,59,30,103,165,983
87,Vince Carter,SF,41,SAC,58,5,1026,114,283,57,165,57,118,28,37,18,130,148,69,42,26,36,96,313
88,Michael Carter-Williams,PG,26,CHO,52,2,835,76,229,14,59,62,170,73,89,37,101,138,116,44,23,52,99,239
89,Alex Caruso,PG,23,LAL,37,7,562,50,116,13,43,37,73,21,30,15,50,65,75,23,10,42,52,134
90,Omri Casspi,SF,29,GSW,53,7,740,120,207,10,22,110,185,50,69,30,170,200,51,18,19,37,71,300
91,Willie Cauley-Stein,C,24,SAC,73,58,2044,388,773,3,12,385,761,153,247,131,379,510,172,77,67,109,185,932
92,Tyler Cavanaugh,PF,23,ATL,39,1,518,67,152,32,89,35,63,17,21,45,82,127,27,9,4,14,61,183
93,Mario Chalmers,PG,31,MEM,66,10,1421,168,443,53,191,115,252,118,138,13,144,157,197,79,14,117,179,507
94,Tyson Chandler,C,35,PHO,46,46,1151,121,187,0,0,121,187,58,93,134,284,418,53,16,27,59,106,300
95,Wilson Chandler,SF,30,DEN,74,71,2346,281,631,88,246,193,385,88,114,102,296,398,159,43,39,92,156,738
96,Marquese Chriss,PF,20,PHO,72,49,1527,202,477,56,190,146,287,96,158,76,319,395,83,51,70,107,205,556
97,Ian Clark,SG,26,NOP,74,2,1455,222,495,62,195,160,300,45,59,10,117,127,110,33,10,57,120,551
98,Jordan Clarkson,SG,25,TOT,81,2,1888,430,954,112,318,318,636,152,190,57,160,217,221,58,6,127,107,1124
99,Gian Clavell,SG,24,DAL,7,0,64,6,18,6,15,0,3,2,2,1,6,7,3,2,0,2,8,20
100,Antonius Cleveland,SG,23,TOT,17,0,123,8,21,3,4,5,17,4,6,3,11,14,2,7,5,7,23,23
101,John Collins,PF,20,ATL,74,26,1785,314,545,16,47,298,498,133,186,176,365,541,98,47,80,105,215,777
102,Zach Collins,C,20,POR,66,1,1045,115,289,35,113,80,176,27,42,45,176,221,52,17,31,58,133,292
103,Kyle Collinsworth,SF,26,DAL,32,2,480,38,99,4,17,34,82,21,40,32,75,107,56,17,9,24,44,101
104,Darren Collison,PG,30,IND,69,64,2018,316,638,96,205,220,433,127,144,37,141,178,368,92,15,86,122,855
105,Nick Collison,PF,37,OKC,15,0,75,13,19,0,0,13,19,5,13,7,13,20,4,0,0,7,7,31
106,Mike Conley,PG,30,MEM,12,12,373,64,168,24,77,40,91,53,66,0,27,27,49,12,3,18,24,205
107,Pat Connaughton,SG,25,POR,82,5,1488,165,390,74,210,91,180,37,44,36,125,161,91,23,22,43,120,441
108,Quinn Cook,PG,24,GSW,33,18,740,122,252,46,104,76,148,22,25,10,72,82,89,12,1,32,59,312
109,Charles Cooke,SG,23,NOP,13,0,38,2,14,1,8,1,6,1,2,0,2,2,1,1,0,1,0,6
110,Jack Cooley,PF,26,SAC,7,0,87,13,27,0,0,13,27,14,19,14,16,30,6,1,0,3,13,40
111,Matt Costello,C,24,SAS,4,0,32,2,4,0,0,2,4,0,0,1,8,9,2,2,2,1,7,4
112,DeMarcus Cousins,C,27,NOP,48,48,1737,406,864,104,294,302,570,294,394,105,512,617,257,79,76,242,183,1210
113,Robert Covington,SF,27,PHI,80,80,2532,345,836,203,550,142,286,116,136,55,378,433,156,137,72,126,238,1009
114,Allen Crabbe,SG,25,BRK,75,68,2197,337,827,201,532,136,295,115,135,28,296,324,117,47,35,78,168,990
115,Torrey Craig,SF,27,DEN,39,5,629,62,137,17,58,45,79,22,35,40,87,127,25,12,15,20,63,163
116,Jamal Crawford,SG,37,MIN,80,0,1653,308,742,104,314,204,428,102,113,21,78,99,185,40,9,95,85,822
117,Jordan Crawford,SG,29,NOP,5,0,53,12,27,8,14,4,13,1,1,2,2,4,13,1,1,5,7,33
118,Jae Crowder,SF,27,TOT,80,47,2090,271,671,110,341,161,330,121,148,59,216,275,99,64,21,74,187,773
119,Dante Cunningham,SF,30,TOT,73,25,1562,164,364,58,168,106,196,31,52,78,220,298,48,39,30,33,111,417
120,Stephen Curry,PG,29,GSW,51,51,1631,428,864,212,501,216,363,278,302,36,225,261,310,80,8,153,114,1346
121,Troy Daniels,SG,26,PHO,79,15,1622,232,575,183,458,49,117,56,64,12,115,127,48,26,5,56,137,703
122,Anthony Davis,PF,24,NOP,75,75,2727,780,1462,55,162,725,1300,495,598,187,645,832,174,115,193,162,159,2110
123,Deyonta Davis,C,21,MEM,62,6,943,161,265,0,0,161,265,38,57,75,175,250,40,15,39,32,125,360
124,Ed Davis,C,28,POR,78,0,1471,170,292,0,1,170,291,74,111,183,392,575,40,32,52,66,188,414
125,Dewayne Dedmon,C,28,ATL,62,46,1542,250,477,50,141,200,336,67,86,100,389,489,90,40,51,86,162,617
126,Sam Dekker,PF,23,LAC,73,1,883,128,259,10,60,118,199,37,56,44,130,174,38,24,9,33,71,303
127,Malcolm Delaney,PG,28,ATL,54,3,1014,109,285,46,124,63,161,74,92,9,91,100,163,35,6,66,82,338
128,Matthew Dellavedova,PG,27,MIL,38,3,712,55,152,29,78,26,74,25,27,14,50,64,145,14,0,49,67,164
129,Luol Deng,SF,32,LAL,1,1,13,1,2,0,0,1,2,0,0,0,0,0,1,1,0,1,0,2
130,DeMar DeRozan,SG,28,TOR,80,80,2711,645,1413,89,287,556,1126,461,559,59,256,315,417,85,22,175,151,1840
131,Cheick Diallo,PF,21,NOP,52,0,581,102,176,0,0,102,176,50,66,47,164,211,19,11,21,28,82,254
132,Gorgui Dieng,C,28,MIN,79,0,1333,186,388,19,61,167,327,79,102,106,254,360,71,45,39,59,147,470
133,Spencer Dinwiddie,PG,24,BRK,80,58,2306,324,838,141,433,183,405,218,268,40,219,259,524,68,23,128,186,1007
134,Tyler Dorsey,SG,21,ATL,56,5,974,144,382,72,199,72,183,45,63,17,113,130,79,17,5,37,63,405
135,Damyean Dotson,SG,23,NYK,44,2,474,72,161,22,68,50,93,16,23,9,75,84,31,12,2,17,34,182
136,Milton Doyle,SG,24,BRK,10,0,125,13,47,4,23,9,24,4,8,3,15,18,10,6,2,2,13,34
137,PJ Dozier,PG,21,OKC,2,0,3,1,2,0,0,1,2,0,0,0,1,1,0,0,0,1,1,2
138,Goran Dragić,PG,31,MIA,75,75,2378,484,1075,111,300,373,775,217,271,54,253,307,359,63,12,166,180,1296
139,Larry Drew,PG,27,TOT,10,0,70,7,24,3,9,4,15,0,0,3,0,3,10,0,0,3,6,17
140,Andre Drummond,C,24,DET,78,78,2625,466,881,0,11,466,870,239,395,399,848,1247,237,114,127,200,250,1171
141,Jared Dudley,PF,32,PHO,48,0,686,48,122,29,80,19,42,27,35,8,86,94,78,24,11,28,85,152
142,Kris Dunn,PG,23,CHI,52,43,1525,286,666,43,134,243,532,84,114,24,197,221,310,104,27,150,174,699
143,Kevin Durant,SF,29,GSW,68,68,2325,630,1222,173,413,457,809,359,404,31,433,464,366,50,119,207,133,1792
144,Jarell Eddie,SF,26,TOT,3,0,9,0,2,0,2,0,0,0,0,0,1,1,0,1,0,0,0,0
145,Henry Ellenson,PF,21,DET,38,0,329,53,146,20,60,33,86,25,29,10,71,81,20,5,0,18,22,151
146,Wayne Ellington,SG,30,MIA,77,2,2041,285,700,227,579,58,121,67,78,23,195,218,79,53,8,52,94,864
147,Joel Embiid,C,23,PHI,63,63,1912,510,1056,66,214,444,842,359,467,143,547,690,199,40,111,234,209,1445
148,James Ennis,SF,27,TOT,72,22,1604,182,384,51,153,131,231,97,116,73,151,224,71,47,18,56,134,512
149,Tyler Ennis,PG,23,LAL,54,11,683,94,224,14,56,80,168,22,29,19,76,95,105,30,10,38,75,224
150,Jawun Evans,PG,21,LAC,48,4,778,89,253,15,54,74,199,38,49,9,75,84,100,36,6,44,97,231
151,Jeremy Evans,SF,30,ATL,1,0,5,1,1,0,0,1,1,0,0,1,0,1,0,0,0,1,1,2
152,Tyreke Evans,PG,28,MEM,52,32,1607,366,809,114,286,252,523,164,209,44,221,265,269,57,17,117,96,1010
153,Dante Exum,PG,22,UTA,14,0,235,42,87,5,18,37,69,25,31,4,22,26,43,8,3,20,20,114
154,Kenneth Faried,PF,28,DEN,32,7,461,76,148,0,1,76,147,36,51,68,85,153,18,12,13,23,51,188
155,Derrick Favors,C,26,UTA,77,77,2153,395,702,14,63,381,639,140,215,198,354,552,102,54,82,88,164,944
156,Kay Felder,PG,22,TOT,16,0,140,21,70,4,19,17,51,11,12,3,15,18,20,3,1,16,11,57
157,Cristiano Felício,C,25,CHI,55,16,977,127,215,0,2,127,213,54,81,83,150,233,55,16,11,54,104,308
158,Raymond Felton,PG,33,OKC,82,2,1365,224,552,81,230,143,322,36,44,25,131,156,203,49,16,76,91,565
159,Terrance Ferguson,SG,19,OKC,61,12,763,70,169,40,120,30,49,9,10,19,28,47,19,24,10,11,83,189
160,Yogi Ferrell,SG,24,DAL,82,21,2282,311,730,134,359,177,371,82,103,26,223,249,201,64,9,78,153,838
161,Dorian Finney-Smith,PF,24,DAL,21,13,448,46,121,20,67,26,54,11,15,22,53,75,26,10,4,21,43,123
162,Bryn Forbes,SG,24,SAS,80,12,1517,209,497,89,228,120,269,48,72,12,98,110,80,28,2,37,108,555
163,Evan Fournier,SF,25,ORL,57,57,1837,368,802,127,335,241,467,150,173,23,157,180,165,47,16,95,138,1013
164,De'Aaron Fox,PG,20,SAC,73,60,2026,328,797,47,153,281,644,141,195,33,171,204,320,70,20,173,163,844
165,Tim Frazier,PG,27,WAS,59,11,838,68,172,17,56,51,116,23,30,18,97,115,194,47,7,57,97,176
166,Channing Frye,C,34,TOT,53,1,695,104,212,39,115,65,97,17,19,12,123,135,38,18,13,21,69,264
167,Markelle Fultz,SG,19,PHI,14,0,253,45,111,0,1,45,110,10,21,11,32,43,53,12,4,17,22,100
168,Danilo Gallinari,SF,29,LAC,21,21,671,102,256,36,111,66,145,81,87,9,92,101,41,12,10,26,30,321
169,Langston Galloway,SG,26,DET,58,2,863,126,340,75,218,51,122,33,41,13,79,92,58,35,5,18,39,360
170,Marc Gasol,C,33,MEM,73,73,2408,434,1033,109,320,325,713,281,337,78,514,592,305,54,101,194,185,1258
171,Pau Gasol,C,37,SAS,77,63,1812,287,627,43,120,244,507,158,209,129,490,619,238,24,79,108,121,775
172,Rudy Gay,PF,31,SAS,57,6,1231,253,537,37,118,216,419,112,145,76,215,291,73,46,38,78,98,655
173,Paul George,SF,27,OKC,79,79,2891,576,1340,244,609,332,731,338,411,72,375,447,263,161,39,212,233,1734
174,Marcus Georges-Hunt,SG,23,MIN,42,0,224,21,48,4,15,17,33,13,21,7,9,16,7,6,0,3,32,59
175,Jonathan Gibson,PG,30,BOS,4,0,40,14,23,6,12,8,11,0,0,0,3,3,4,0,0,3,5,34
176,Taj Gibson,PF,32,MIN,82,82,2726,425,737,7,35,418,702,142,185,194,390,584,99,62,59,89,218,999
177,Manu Ginóbili,SG,40,SAS,65,0,1299,201,463,64,192,137,271,110,131,19,123,142,163,43,16,105,126,576
178,Rudy Gobert,C,25,UTA,56,56,1816,276,444,0,0,276,444,204,299,165,436,601,80,44,129,107,153,756
179,Aaron Gordon,PF,22,ORL,58,57,1909,375,865,115,342,260,523,157,225,87,370,457,136,59,45,107,111,1022
180,Eric Gordon,SG,29,HOU,69,30,2154,415,970,218,608,197,362,195,241,25,145,170,154,44,27,130,116,1243
181,Marcin Gortat,C,33,WAS,82,82,2075,290,560,0,0,290,560,110,163,181,442,623,151,40,61,99,175,690
182,Treveon Graham,SG,24,CHO,63,2,1050,96,221,40,97,56,124,41,59,42,79,121,59,33,2,27,109,273
183,Jerami Grant,PF,23,OKC,81,1,1647,244,456,32,110,212,346,162,240,86,233,319,57,31,77,54,155,682
184,Jerian Grant,PG,25,CHI,74,26,1686,209,503,61,187,148,316,140,188,31,141,172,342,63,8,89,132,619
185,Josh Gray,PG,24,PHO,5,0,86,11,41,3,13,8,28,7,11,2,8,10,12,8,2,7,8,32
186,Danny Green,SG,30,SAS,70,60,1791,217,561,116,320,101,241,50,65,41,208,249,110,63,80,74,122,600
187,Draymond Green,PF,27,GSW,70,70,2287,281,619,77,256,204,363,134,173,75,460,535,508,95,91,202,185,773
188,Gerald Green,SG,32,HOU,41,2,929,168,413,110,298,58,115,51,60,15,118,133,25,24,15,31,87,497
189,JaMychal Green,PF,27,MEM,55,54,1542,223,488,43,127,180,361,80,111,147,317,464,79,32,25,76,153,569
190,Jeff Green,PF,31,CLE,78,13,1828,295,618,53,170,242,448,203,234,60,186,246,99,41,34,75,149,846
191,Blake Griffin,PF,28,TOT,58,58,1970,436,996,111,322,325,674,259,330,73,355,428,334,41,18,165,139,1242
192,Daniel Hamilton,SG,22,OKC,6,0,28,5,11,2,5,3,6,0,0,0,5,5,8,1,0,2,2,12
193,Tim Hardaway,SG,25,NYK,57,54,1885,360,856,130,410,230,446,146,179,32,192,224,155,62,10,92,123,996
194,James Harden,SG,28,HOU,72,72,2551,651,1449,265,722,386,727,624,727,41,348,389,630,126,50,315,169,2191
195,Maurice Harkless,SF,24,POR,59,36,1264,147,297,49,118,98,179,42,59,46,116,162,53,48,43,40,103,385
196,Montrezl Harrell,C,24,LAC,76,3,1293,348,548,1,7,347,541,139,222,103,203,306,74,36,52,68,143,836
197,Devin Harris,PG,34,TOT,71,1,1340,187,454,79,227,108,227,142,170,12,115,127,152,47,12,76,158,595
198,Gary Harris,SG,23,DEN,67,65,2304,440,908,156,394,284,514,134,162,37,139,176,194,122,15,119,119,1170
199,Joe Harris,SG,26,BRK,78,14,1975,305,621,150,358,155,263,86,104,51,209,260,128,35,20,91,153,846
200,Tobias Harris,PF,25,TOT,80,80,2668,562,1221,183,445,379,776,179,216,58,379,437,192,71,35,105,164,1486
201,Aaron Harrison,SG,23,DAL,9,3,233,19,69,9,43,10,26,13,17,4,20,24,11,9,2,3,27,60
202,Andrew Harrison,PG,23,MEM,56,46,1326,181,429,47,142,134,287,124,159,23,108,131,177,38,26,81,138,533
203,Shaquille Harrison,PG,24,PHO,23,2,384,59,124,6,26,53,98,28,38,9,52,61,55,26,7,22,42,152
204,Josh Hart,SG,22,LAL,63,23,1461,176,375,78,197,98,178,66,94,42,221,263,80,47,16,47,107,496
205,Udonis Haslem,C,37,MIA,14,0,72,3,15,1,8,2,7,1,2,3,7,10,5,0,2,2,3,8
206,Nigel Hayes,SF,23,TOT,9,0,122,11,33,4,16,7,17,1,3,4,18,22,6,2,3,2,8,27
207,Gordon Hayward,SF,27,BOS,1,1,5,1,2,0,1,1,1,0,0,0,1,1,0,0,0,0,1,2
208,Reggie Hearn,SG,26,DET,3,0,7,1,2,1,2,0,0,0,0,0,0,0,0,0,0,0,0,3
209,Myke Henry,SF,25,MEM,20,0,378,41,109,19,58,22,51,6,10,10,28,38,22,31,6,19,28,107
210,John Henson,C,27,MIL,76,69,1970,287,502,1,7,286,495,90,158,150,363,513,114,45,109,84,202,665
211,Juan Hernangómez,PF,22,DEN,25,3,277,29,75,14,50,15,25,10,12,18,36,54,12,6,3,9,25,82
212,Willy Hernangómez,C,23,TOT,48,1,495,91,164,5,12,86,152,59,90,61,122,183,33,18,16,35,64,246
213,Mario Hezonja,SF,22,ORL,75,30,1657,273,617,90,267,183,350,86,105,41,240,281,106,81,31,86,134,722
214,Isaiah Hicks,PF,23,NYK,18,0,240,33,72,2,9,31,63,12,18,10,31,41,16,2,4,16,45,80
215,Buddy Hield,SG,25,SAC,80,12,2024,416,933,176,408,240,525,71,81,55,252,307,155,85,22,124,148,1079
216,Nenê Hilário,C,35,HOU,52,4,758,136,239,0,2,136,237,68,107,54,122,176,45,28,14,38,123,340
217,George Hill,PG,31,TOT,67,60,1812,236,513,85,205,151,308,110,140,42,139,181,186,61,27,88,128,667
218,Solomon Hill,SF,26,NOP,12,1,187,11,41,4,21,7,20,3,6,9,27,36,22,7,1,9,22,29
219,Darrun Hilliard,SG,24,SAS,14,0,95,5,19,0,6,5,13,6,7,0,7,7,11,2,0,4,7,16
220,Jrue Holiday,SG,27,NOP,81,81,2927,615,1244,120,356,495,888,187,238,62,303,365,486,123,64,213,201,1537
221,Justin Holiday,SG,28,CHI,72,72,2265,290,782,161,449,129,333,135,164,31,260,291,153,80,31,93,134,876
222,John Holland,SF,29,CLE,24,0,174,17,59,11,36,6,23,9,13,6,18,24,5,7,2,8,10,54
223,Rondae Hollis-Jefferson,SF,23,BRK,68,59,1920,342,724,13,54,329,670,249,316,101,358,459,167,65,48,121,145,946
224,Richaun Holmes,C,24,PHI,48,2,746,135,241,4,31,131,210,37,56,57,154,211,61,20,29,25,97,311
225,Rodney Hood,SG,25,TOT,60,23,1616,322,751,127,333,195,418,111,129,22,143,165,95,45,12,70,105,882
226,Scotty Hopson,SG,28,DAL,1,0,8,0,1,0,0,0,1,1,2,0,0,0,1,0,0,1,0,1
227,Al Horford,C,31,BOS,72,72,2277,368,753,97,226,271,527,94,120,103,427,530,339,43,78,132,138,927
228,Danuel House,SG,24,PHO,23,3,403,56,129,15,58,41,71,25,31,13,63,76,25,7,6,11,23,152
229,Dwight Howard,C,32,CHO,81,81,2463,506,911,1,7,505,904,334,582,255,757,1012,105,48,131,208,249,1347
230,Josh Huestis,PF,26,OKC,69,10,982,60,182,33,115,27,67,6,20,42,119,161,20,15,43,26,82,159
231,R.J. Hunter,SG,24,HOU,5,1,45,7,20,3,14,4,6,2,2,0,5,5,3,3,0,2,7,19
232,Vince Hunter,PF,23,MEM,4,0,7,3,5,0,0,3,5,0,0,2,1,3,0,0,1,1,0,6
233,Serge Ibaka,PF,28,TOR,76,76,2093,379,784,107,297,272,487,94,118,78,400,478,62,29,99,90,209,959
234,Andre Iguodala,SF,34,GSW,64,7,1622,148,320,33,117,115,203,55,87,50,196,246,210,54,38,67,99,384
235,Ersan İlyasova,PF,30,TOT,69,43,1729,277,613,91,253,186,360,105,135,118,287,405,90,61,26,72,157,750
236,Joe Ingles,SF,30,UTA,82,81,2578,335,718,204,464,131,254,66,83,24,320,344,392,90,20,159,178,940
237,Andre Ingram,SG,32,LAL,2,0,64,8,17,5,9,3,8,3,3,1,5,6,7,3,3,3,3,24
238,Brandon Ingram,SF,20,LAL,59,59,1975,358,761,41,105,317,656,192,282,57,257,314,230,45,43,149,163,949
239,Kyrie Irving,PG,25,BOS,60,60,1931,534,1087,166,407,368,680,232,261,33,194,227,306,65,17,140,122,1466
240,Jonathan Isaac,PF,20,ORL,27,10,536,55,145,16,46,39,99,19,25,16,83,99,18,33,30,27,48,145
241,Wesley Iwundu,SF,23,ORL,62,12,1020,93,218,9,46,84,172,34,47,36,101,137,57,33,12,30,81,229
242,Jarrett Jack,PG,34,NYK,62,56,1548,189,443,25,86,164,357,63,75,22,169,191,348,35,4,115,98,466
243,Aaron Jackson,PG,31,HOU,1,0,35,3,9,1,4,2,5,1,2,2,1,3,1,0,0,1,4,8
244,Demetrius Jackson,PG,23,TOT,15,0,80,7,18,1,7,6,11,1,2,5,7,12,9,5,1,10,7,16
245,Josh Jackson,SF,20,PHO,77,35,1959,389,932,57,217,332,715,177,279,95,256,351,119,80,35,146,218,1012
246,Justin Jackson,SF,22,SAC,68,41,1506,185,419,57,185,128,234,26,36,27,160,187,74,28,13,40,81,453
247,Reggie Jackson,PG,27,DET,45,45,1201,246,577,52,169,194,408,112,134,29,96,125,238,27,4,99,87,656
248,LeBron James,PF,33,CLE,82,82,3026,857,1580,149,406,708,1174,388,531,97,612,709,747,116,71,347,136,2251
249,Mike James,PG,27,TOT,36,10,687,123,321,26,98,97,223,64,84,13,77,90,126,28,7,49,48,336
250,Al Jefferson,C,33,IND,36,1,484,111,208,0,3,111,205,30,36,30,113,143,30,16,23,21,66,252
251,Richard Jefferson,SF,37,DEN,20,0,163,12,27,2,7,10,20,4,7,2,15,17,15,2,1,5,11,30
252,Brandon Jennings,PG,28,MIL,14,0,205,27,72,9,33,18,39,10,10,5,26,31,44,6,4,18,11,73
253,Jonas Jerebko,PF,30,UTA,74,19,1134,159,341,65,157,94,184,46,57,53,193,246,42,24,12,27,127,429
254,Amir Johnson,C,30,PHI,74,18,1171,140,260,10,32,130,228,52,85,123,207,330,118,45,44,55,192,342
255,Brice Johnson,PF,23,TOT,18,0,98,20,42,0,1,20,41,3,5,9,22,31,2,9,6,5,13,43
256,Dakari Johnson,C,22,OKC,31,6,161,22,39,0,0,22,39,11,20,16,18,34,8,6,8,3,27,55
257,James Johnson,PF,30,MIA,73,41,1943,309,614,57,185,252,429,113,162,61,297,358,280,70,51,141,192,788
258,Joe Johnson,SF,36,TOT,55,4,1205,146,360,40,145,106,215,40,45,14,158,172,83,18,7,49,67,372
259,Omari Johnson,PF,28,MEM,4,0,75,9,21,4,12,5,9,0,0,4,7,11,7,2,0,3,6,22
260,Stanley Johnson,SF,21,DET,69,50,1894,210,560,67,234,143,326,112,145,33,219,252,112,95,14,77,169,599
261,Tyler Johnson,PG,25,MIA,72,39,2052,309,711,119,324,190,387,106,129,34,214,248,165,60,34,81,148,843
262,Wesley Johnson,SF,30,LAC,74,40,1486,150,368,60,177,90,191,43,58,29,187,216,61,76,62,55,146,403
263,Nikola Jokić,C,22,DEN,75,73,2443,504,1010,111,280,393,730,266,313,195,608,803,458,90,61,210,212,1385
264,Damian Jones,C,22,GSW,15,0,89,11,22,0,0,11,22,3,5,5,9,14,2,1,3,4,14,25
265,Derrick Jones,SF,20,TOT,20,8,245,21,53,3,18,18,35,16,24,21,17,38,9,4,13,7,24,61
266,Jalen Jones,SF,24,TOT,16,0,181,26,68,10,26,16,42,12,19,13,25,38,4,5,1,7,22,74
267,Tyus Jones,PG,21,MIN,82,11,1467,150,328,45,129,105,199,71,81,16,116,132,232,95,6,59,110,416
268,DeAndre Jordan,C,29,LAC,77,77,2424,373,578,0,0,373,578,181,312,329,842,1171,117,39,71,137,203,927
269,Cory Joseph,PG,26,IND,82,17,2210,256,604,67,190,189,414,70,94,39,224,263,260,80,18,87,141,649
270,Frank Kaminsky,PF,24,CHO,79,4,1835,307,716,104,274,203,442,155,194,46,242,288,129,36,19,66,95,873
271,Enes Kanter,C,25,NYK,71,71,1830,422,713,0,2,422,711,156,184,273,507,780,105,36,37,122,187,1000
272,Luke Kennard,SG,21,DET,73,9,1463,206,465,81,195,125,270,65,76,21,155,176,124,44,13,69,86,558
273,Michael Kidd-Gilchrist,SF,24,CHO,74,74,1850,282,560,0,2,282,558,117,171,84,218,302,71,51,32,53,143,681
274,Sean Kilpatrick,SG,28,TOT,52,1,640,110,294,46,144,64,150,64,72,5,82,87,46,13,5,38,33,330
275,Maxi Kleber,PF,26,DAL,72,36,1206,151,309,40,128,111,181,44,59,71,163,234,51,26,47,30,114,386
276,Furkan Korkmaz,SG,20,PHI,14,0,80,8,28,5,17,3,11,2,4,2,9,11,4,2,1,2,12,23
277,Luke Kornet,PF,22,NYK,20,1,326,49,125,28,79,21,46,8,11,11,53,64,26,6,16,12,28,134
278,Kyle Korver,SG,36,CLE,73,4,1574,222,484,164,376,58,108,64,72,9,156,165,88,31,27,55,130,672
279,Kosta Koufos,C,28,SAC,71,13,1391,222,389,0,0,222,389,33,74,149,323,472,87,47,32,49,146,477
280,Kyle Kuzma,PF,22,LAL,77,37,2401,468,1039,159,434,309,605,147,208,88,395,483,141,49,34,140,160,1242
281,Mindaugas Kuzminskas,SF,28,NYK,1,0,2,0,2,0,0,0,2,0,0,0,0,0,0,0,0,0,0,0
282,Skal Labissière,PF,21,SAC,60,28,1240,205,458,18,51,187,407,95,118,99,189,288,72,25,49,73,132,523
283,Jeremy Lamb,SG,25,CHO,80,18,1967,380,832,94,254,286,578,179,208,49,275,324,186,61,32,93,138,1033
284,Shane Larkin,PG,25,BOS,54,2,775,84,219,31,86,53,133,32,37,15,77,92,98,29,2,33,58,231
285,Joffrey Lauvergne,C,26,SAS,55,1,534,98,190,0,5,98,185,30,47,63,108,171,41,9,3,33,45,226
286,Zach LaVine,SG,22,CHI,24,24,656,136,355,42,123,94,232,87,107,9,85,94,72,24,4,43,55,401
287,Jake Layman,SF,23,POR,35,1,160,14,47,4,20,10,27,2,3,4,12,16,11,6,4,5,13,34
288,T.J. Leaf,PF,20,IND,53,0,459,64,136,18,42,46,94,10,16,29,53,82,9,5,4,10,45,156
289,Courtney Lee,SG,32,NYK,76,69,2310,343,755,113,278,230,477,114,124,30,194,224,180,80,17,84,109,913
290,Damion Lee,SG,25,ATL,15,11,404,62,152,15,60,47,92,22,29,11,60,71,29,19,1,14,25,161
291,Walt Lemon,PG,25,NOP,5,0,35,7,16,1,1,6,15,2,3,0,2,2,5,0,1,4,5,17
292,Alex Len,C,24,PHO,69,13,1395,214,378,1,3,213,375,158,231,175,343,518,82,27,61,78,158,587
293,Kawhi Leonard,SF,26,SAS,9,9,210,52,111,11,35,41,76,31,38,6,36,42,21,18,9,16,9,146
294,Meyers Leonard,C,25,POR,33,2,254,46,78,11,26,35,52,9,11,12,58,70,17,7,0,10,36,112
295,Jon Leuer,PF,28,DET,8,0,136,15,36,0,3,15,33,13,15,7,25,32,5,1,3,7,16,43
296,Caris LeVert,SF,23,BRK,71,10,1864,320,735,85,245,235,490,133,187,53,207,260,299,82,22,153,159,858
297,DeAndre Liggins,SG,29,TOT,58,4,724,40,106,19,53,21,53,2,5,7,68,75,48,37,14,20,81,101
298,Damian Lillard,PG,27,POR,73,73,2670,621,1415,227,629,394,786,493,538,62,263,325,481,77,27,206,117,1962
299,Jeremy Lin,PG,29,BRK,1,1,25,5,12,1,2,4,10,7,7,0,0,0,4,0,0,3,3,18
300,Shaun Livingston,PG,32,GSW,71,7,1129,172,343,0,5,172,338,50,61,32,99,131,140,35,21,58,117,394
301,Kevon Looney,C,21,GSW,66,4,910,112,193,1,5,111,188,42,77,83,132,215,42,34,56,31,106,267
302,Brook Lopez,C,29,LAL,74,72,1735,369,793,112,325,257,468,111,158,74,220,294,126,30,98,98,195,961
303,Robin Lopez,C,29,CHI,64,64,1690,342,645,4,14,338,631,68,90,134,156,290,124,14,53,107,109,756
304,Kevin Love,C,29,CLE,59,59,1651,334,729,137,330,197,399,234,266,101,445,546,103,43,24,90,120,1039
305,Kyle Lowry,PG,31,TOR,78,78,2510,403,944,238,596,165,348,223,261,66,368,434,537,85,19,183,192,1267
306,Timothé Luwawu-Cabarrot,SF,22,PHI,52,7,807,100,267,53,158,47,109,46,58,14,58,72,54,12,5,38,97,299
307,Tyler Lydon,PF,21,DEN,1,0,2,0,0,0,0,0,0,0,0,0,0,0,0,0,0,0,0,0
308,Trey Lyles,PF,22,DEN,73,2,1391,270,550,83,218,187,332,101,143,55,292,347,91,30,34,61,111,724
309,Shelvin Mack,PG,27,ORL,69,3,1365,178,414,48,139,130,275,69,97,23,143,166,272,54,8,89,91,473
310,Josh Magette,PG,28,ATL,18,0,216,15,46,8,22,7,24,8,8,2,17,19,57,8,1,9,16,46
311,Ian Mahinmi,C,31,WAS,77,0,1145,138,248,0,2,138,246,90,128,135,177,312,53,38,42,100,230,366
312,Thon Maker,C,20,MIL,74,12,1238,130,316,31,104,99,212,65,93,75,150,225,46,38,53,44,162,356
313,Boban Marjanović,C,29,TOT,39,1,337,79,148,0,0,79,148,77,97,48,96,144,22,10,11,36,51,235
314,Lauri Markkanen,PF,20,CHI,68,68,2020,374,862,145,401,229,461,140,166,79,429,508,79,39,40,83,103,1033
315,Jarell Martin,PF,23,MEM,73,36,1661,221,496,34,98,187,398,89,116,97,221,318,73,39,49,86,211,565
316,Frank Mason,PG,23,SAC,52,2,984,144,380,31,86,113,294,94,115,30,100,130,147,34,10,65,72,413
317,Mangok Mathiang,C,25,CHO,4,0,20,4,7,0,0,4,7,0,1,3,7,10,0,1,0,0,5,8
318,Wesley Matthews,SF,31,DAL,63,62,2131,283,697,153,402,130,295,83,101,28,170,198,172,76,16,83,140,802
319,Luc Mbah a Moute,PF,31,HOU,61,15,1564,166,345,63,173,103,172,65,95,22,164,186,55,72,25,68,100,460
320,James Michael McAdoo,PF,25,PHI,3,0,18,2,7,2,7,0,0,2,2,0,2,2,0,0,1,1,1,8
321,Patrick McCaw,SG,22,GSW,57,10,961,92,225,19,80,73,145,26,34,16,66,82,81,43,10,41,67,229
322,CJ McCollum,SG,26,POR,81,81,2923,667,1505,189,476,478,1029,209,250,53,268,321,272,77,35,151,168,1732
323,T.J. McConnell,PG,25,PHI,76,1,1706,210,421,27,62,183,359,31,39,37,189,226,303,92,13,112,122,478
324,Erik McCree,SF,24,UTA,4,0,8,0,2,0,1,0,1,0,0,0,1,1,0,1,0,1,0,0
325,Chris McCullough,PF,22,WAS,19,0,90,18,42,1,8,17,34,9,14,7,18,25,4,0,5,2,8,46
326,Doug McDermott,SF,26,TOT,81,4,1768,237,508,92,216,145,292,64,81,40,160,200,79,19,16,56,122,630
327,JaVale McGee,C,30,GSW,65,17,615,136,219,0,6,136,213,38,52,59,110,169,33,21,57,27,91,310
328,Rodney McGruder,SG,26,MIA,18,2,299,36,73,15,35,21,38,4,8,11,21,32,17,8,3,4,21,91
329,Trey McKinney-Jones,SG,27,IND,1,0,1,0,0,0,0,0,0,0,0,0,0,0,0,0,0,0,0,0
330,Alfonzo McKinnie,SF,25,TOR,14,0,53,8,15,3,9,5,6,2,3,1,6,7,1,1,1,3,8,21
331,Ben McLemore,SG,24,MEM,56,17,1091,157,373,55,159,102,214,53,64,34,105,139,51,38,15,61,139,422
332,Josh McRoberts,PF,30,DAL,2,0,6,0,1,0,1,0,0,0,0,0,0,0,0,0,0,0,2,0
333,Jodie Meeks,SG,30,WAS,77,0,1119,157,393,72,210,85,183,101,117,15,111,126,70,29,4,37,55,487
334,Salah Mejri,C,31,DAL,61,1,729,88,137,0,3,88,134,38,66,85,161,246,35,22,67,39,121,214
335,Jordan Mickey,PF,23,MIA,23,3,284,39,82,2,16,37,66,13,19,18,63,81,9,6,10,18,36,93
336,Khris Middleton,SF,26,MIL,82,82,2982,593,1272,146,407,447,865,320,362,45,384,429,328,119,21,191,270,1652
337,C.J. Miles,SF,30,TOR,70,3,1337,227,599,164,454,63,145,81,97,18,134,152,55,37,21,39,134,699
338,Darius Miller,SF,27,NOP,82,3,1944,216,487,147,358,69,129,58,67,18,146,164,111,28,17,58,160,637
339,Malcolm Miller,SF,24,TOR,15,4,126,13,28,8,21,5,7,4,4,4,11,15,3,1,2,5,10,38
340,Patty Mills,PG,29,SAS,82,36,2107,280,682,154,414,126,268,105,118,26,128,154,229,55,11,106,128,819
341,Paul Millsap,PF,32,DEN,38,37,1143,202,435,39,113,163,322,112,161,65,180,245,105,39,44,73,99,555
342,Nikola Mirotić,PF,26,TOT,55,14,1494,306,684,135,358,171,326,112,137,59,346,405,80,44,39,62,108,859
343,Donovan Mitchell,SG,21,UTA,79,71,2638,595,1362,187,550,408,812,239,297,52,244,296,291,118,27,215,213,1616
344,Naz Mitrou-Long,SG,24,UTA,1,0,1,1,1,1,1,0,0,0,0,0,0,0,0,0,0,0,0,3
345,Malik Monk,SG,19,CHO,63,0,854,153,425,83,243,70,182,32,38,8,58,66,91,20,9,49,60,421
346,Greg Monroe,C,27,TOT,51,14,1040,218,386,0,0,218,386,88,119,109,241,350,114,44,23,94,95,524
347,Luis Montero,SG,24,DET,2,0,8,0,1,0,0,0,1,0,0,0,2,2,0,0,0,2,0,0
348,Ben Moore,PF,22,IND,2,0,9,0,0,0,0,0,0,0,0,0,1,1,1,0,0,0,4,0
349,E'Twaun Moore,SG,28,NOP,82,80,2586,423,832,128,301,295,531,48,68,57,181,238,187,79,12,102,182,1022
350,Eric Moreland,PF,26,DET,67,3,805,66,122,0,0,66,122,11,29,81,197,278,78,31,51,42,116,143
351,Jaylen Morris,SG,22,ATL,6,0,98,13,32,2,10,11,22,0,0,2,14,16,7,2,1,6,2,28
352,Marcus Morris,PF,28,BOS,54,21,1447,262,611,86,234,176,377,124,154,43,246,289,72,35,12,65,100,734
353,Markieff Morris,PF,28,WAS,73,73,1968,330,687,76,207,254,480,105,128,75,334,409,142,56,38,127,216,841
354,Monte Morris,PG,22,DEN,3,0,25,4,6,0,1,4,5,2,2,0,2,2,7,3,0,1,1,10
355,Johnathan Motley,PF,22,DAL,11,4,176,40,75,1,6,39,69,15,28,14,35,49,7,3,2,9,18,96
356,Timofey Mozgov,C,31,BRK,31,13,359,52,93,4,18,48,75,23,30,32,66,98,11,5,13,33,39,131
357,Emmanuel Mudiay,PG,21,TOT,64,14,1245,204,526,47,148,157,378,98,129,26,126,152,206,41,11,113,80,553
359,Xavier Munford,SG,25,MIL,6,0,21,1,6,0,2,1,4,1,2,1,0,1,4,1,0,2,4,3
360,Dejounte Murray,PG,21,SAS,81,48,1743,270,609,9,34,261,575,105,148,110,349,459,231,97,31,134,151,654
361,Jamal Murray,PG,20,DEN,81,80,2565,479,1062,165,436,314,626,229,253,82,215,297,274,79,28,172,173,1352
362,Mike Muscala,C,26,ATL,53,7,1060,143,312,62,167,81,145,57,62,56,174,230,51,31,27,42,80,405
363,Abdel Nader,SF,24,BOS,48,1,522,50,149,23,65,27,84,23,39,13,58,71,26,15,10,34,45,146
364,Larry Nance,C,25,TOT,66,27,1421,240,413,2,12,238,401,91,137,161,291,452,82,88,38,51,172,573
365,Shabazz Napier,PG,26,POR,74,10,1535,223,531,82,218,141,313,116,138,26,144,170,150,81,14,90,84,644
366,Jameer Nelson,PG,35,TOT,50,0,1013,95,244,41,124,54,120,16,20,13,91,104,179,27,4,67,81,247
367,Raul Neto,PG,25,UTA,41,0,498,69,151,19,47,50,104,26,35,7,42,49,75,13,4,36,38,183
368,Georges Niang,PF,24,UTA,9,0,32,4,11,0,4,4,7,1,2,3,6,9,3,2,0,3,1,9
369,Joakim Noah,C,32,NYK,7,0,40,5,10,0,0,5,10,2,4,6,8,14,4,2,2,4,5,12
370,Nerlens Noel,C,23,DAL,30,6,472,55,105,0,1,55,104,21,28,48,120,168,20,31,22,26,59,131
371,Lucas Nogueira,C,25,TOR,49,3,418,49,80,5,19,44,61,19,28,18,69,87,22,23,43,16,49,122
372,Dirk Nowitzki,C,39,DAL,77,77,1900,346,758,138,337,208,421,97,108,22,416,438,120,43,45,51,146,927
373,Frank Ntilikina,PG,19,NYK,78,9,1706,182,500,50,157,132,343,49,68,37,140,177,250,65,18,131,181,463
374,Jusuf Nurkić,C,23,POR,79,79,2088,480,951,0,7,480,944,172,273,189,519,708,143,64,111,183,247,1132
375,David Nwaba,SG,25,CHI,70,21,1646,202,423,18,52,184,371,133,203,89,237,326,104,59,29,77,158,555
376,Johnny O'Bryant,PF,24,CHO,36,0,379,68,171,14,43,54,128,21,25,29,64,93,14,9,6,15,45,171
377,Royce O'Neale,SF,24,UTA,69,4,1150,120,284,42,118,78,166,61,76,25,211,236,95,36,16,55,105,343
378,Kyle O'Quinn,C,27,NYK,77,10,1387,224,384,4,17,220,367,98,127,121,349,470,158,36,98,100,192,550
379,Semi Ojeleye,PF,23,BOS,73,0,1150,65,188,40,125,25,63,25,41,37,124,161,20,21,4,25,91,195
380,Emeka Okafor,C,35,NOP,26,19,353,48,95,0,0,48,95,18,22,47,73,120,8,8,25,13,30,114
381,Jahlil Okafor,C,22,TOT,28,0,353,77,138,1,4,76,134,21,29,21,64,85,12,3,18,21,51,176
382,Victor Oladipo,SG,25,IND,75,75,2552,640,1342,161,434,479,908,294,368,47,343,390,323,177,57,219,175,1735
383,Kelly Olynyk,PF,26,MIA,76,22,1779,316,636,106,280,210,356,134,174,89,342,431,207,62,35,147,222,872
384,Chinanu Onuaku,C,21,HOU,1,0,22,2,5,0,0,2,5,0,0,1,3,4,1,0,0,3,4,4
385,Cedi Osman,SF,22,CLE,61,12,672,90,186,32,87,58,99,26,46,19,101,120,41,22,3,32,78,238
386,Kelly Oubre,SF,22,WAS,81,11,2231,318,790,126,369,192,421,191,233,59,304,363,98,80,35,90,234,953
387,Zaza Pachulia,C,33,GSW,69,57,972,149,264,0,1,149,263,75,93,89,232,321,109,38,17,72,122,373
388,Marcus Paige,PG,24,CHO,5,0,28,4,14,2,8,2,6,2,2,0,4,4,3,0,0,0,0,12
389,Georgios Papagiannis,C,20,TOT,17,0,122,18,42,0,0,18,42,0,0,13,24,37,9,4,6,8,12,36
390,Jabari Parker,PF,22,MIL,31,3,743,160,332,31,81,129,251,40,54,42,109,151,59,25,10,45,50,391
391,Tony Parker,PG,35,SAS,55,21,1071,178,388,10,37,168,351,55,78,7,88,95,195,28,1,68,52,421
392,Chandler Parsons,SF,29,MEM,36,8,691,108,234,51,121,57,113,17,27,14,76,90,69,18,11,35,53,284
393,Patrick Patterson,PF,28,OKC,82,3,1270,106,266,66,171,40,95,40,46,32,161,193,57,48,23,33,87,318
394,Justin Patton,C,20,MIN,1,0,4,1,2,0,0,1,2,0,0,0,0,0,0,1,0,0,1,2
395,Brandon Paul,SG,26,SAS,64,2,576,55,127,15,54,40,73,22,43,6,62,68,37,25,7,29,58,147
396,Chris Paul,PG,32,HOU,58,58,1847,367,798,144,379,223,419,203,221,37,276,313,457,96,14,128,141,1081
397,Adreian Payne,PF,26,ORL,5,0,43,7,10,2,3,5,7,5,6,2,7,9,0,2,0,2,6,21
398,Cameron Payne,PG,23,CHI,25,14,582,87,215,35,91,52,124,12,16,18,51,69,113,26,9,36,44,221
399,Elfrid Payton,PG,23,TOT,63,63,1808,329,667,30,92,299,575,109,168,64,210,274,393,83,22,168,147,797
400,Gary Payton,PG,25,TOT,23,6,221,30,74,6,25,24,49,3,9,13,31,44,21,7,3,7,30,69
401,Kendrick Perkins,C,33,CLE,1,0,15,1,2,0,0,1,2,1,2,0,1,1,2,1,0,1,1,3
402,London Perrantes,PG,23,CLE,14,0,66,2,13,0,3,2,10,3,5,1,3,4,5,2,1,1,6,7
403,Alec Peters,PF,22,PHO,20,0,225,28,74,18,58,10,16,8,10,8,29,37,12,2,2,4,13,82
404,Marshall Plumlee,C,25,MIL,8,0,52,1,3,0,0,1,3,12,16,4,13,17,2,0,1,3,10,14
405,Mason Plumlee,C,27,DEN,74,26,1439,221,368,0,1,221,367,82,179,132,268,400,142,49,81,103,184,524
406,Miles Plumlee,C,29,ATL,55,35,918,105,180,0,0,105,180,27,60,77,151,228,45,17,30,63,79,237
407,Jakob Pöltl,C,22,TOR,82,0,1524,253,384,1,2,252,382,60,101,165,228,393,57,39,100,85,212,567
408,Quincy Pondexter,SF,29,CHI,23,1,196,14,49,3,22,11,27,14,17,8,19,27,9,8,2,11,24,45
409,Otto Porter,SF,24,WAS,77,77,2432,445,885,138,313,307,572,106,128,103,389,492,157,116,41,75,151,1134
410,Bobby Portis,PF,22,CHI,73,4,1643,382,811,80,223,302,588,120,156,159,339,498,123,50,23,103,130,964
411,Kristaps Porziņģis,PF,22,NYK,48,48,1553,390,889,90,228,300,661,218,275,62,254,316,57,36,115,93,141,1088
412,Dwight Powell,C,26,DAL,79,25,1672,255,430,28,84,227,346,133,185,135,309,444,91,67,32,59,186,671
413,Norman Powell,SG,24,TOR,70,18,1062,150,374,53,186,97,188,32,39,14,105,119,89,37,16,66,111,385
414,Alex Poythress,PF,24,IND,25,0,104,11,26,4,11,7,15,0,0,7,10,17,2,3,1,2,16,26
415,Jacob Pullen,PG,28,PHI,3,0,6,1,2,0,1,1,1,0,0,0,0,0,0,0,0,1,0,2
416,Rodney Purvis,SG,23,ORL,16,2,290,35,107,13,52,22,55,13,15,1,26,27,17,3,3,10,26,96
417,Zhou Qi,C,22,HOU,18,0,124,6,32,2,19,4,13,8,12,6,16,22,2,2,14,10,14,22
418,Tim Quarterman,SG,23,HOU,3,0,13,1,3,0,2,1,1,2,2,0,3,3,1,0,0,2,1,4
419,Ivan Rabb,PF,20,MEM,36,5,516,86,152,0,0,86,152,29,36,53,105,158,32,12,13,35,55,201
420,Julius Randle,C,23,LAL,82,49,2190,504,904,10,45,494,859,305,425,181,473,654,210,43,45,213,274,1323
421,Zach Randolph,PF,36,SAC,59,57,1508,361,763,51,147,310,616,84,107,97,300,397,127,42,10,116,119,857
422,Xavier Rathan-Mayes,SG,23,MEM,5,0,118,12,42,1,14,11,28,4,9,0,5,5,18,6,3,11,18,29
423,J.J. Redick,SG,33,PHI,70,70,2116,404,879,193,460,211,419,197,218,9,169,178,210,35,6,103,123,1198
424,Davon Reed,SG,22,PHO,21,1,242,22,76,11,38,11,38,8,12,2,37,39,13,10,2,10,17,63
425,Willie Reed,C,27,TOT,42,5,428,81,121,1,2,80,119,32,55,35,86,121,10,9,22,19,56,195
426,Josh Richardson,SF,24,MIA,81,81,2689,399,885,127,336,272,549,120,142,69,216,285,231,121,75,140,199,1045
427,Malachi Richardson,SG,22,TOT,26,4,324,30,90,12,40,18,50,17,22,5,29,34,13,10,1,10,27,89
428,Austin Rivers,SG,25,LAC,61,59,2057,341,805,136,360,205,445,102,159,27,118,145,242,74,16,109,152,920
429,Andre Roberson,SG,26,OKC,39,39,1037,87,162,8,36,79,126,12,38,75,110,185,46,45,35,30,89,194
430,Devin Robinson,SF,22,WAS,1,0,13,1,3,0,0,1,3,0,0,2,3,5,0,1,0,0,2,2
431,Glenn Robinson,SF,24,IND,23,1,338,36,85,14,34,22,51,9,11,11,26,37,17,13,1,5,14,95
432,Rajon Rondo,PG,31,NOP,65,63,1705,231,494,50,150,181,344,25,46,31,232,263,533,70,10,151,119,537
433,Derrick Rose,PG,29,TOT,25,7,420,81,186,7,30,74,156,40,46,13,22,35,37,7,4,35,16,209
434,Terrence Ross,SG,26,ORL,24,20,600,76,191,30,93,46,98,27,36,10,63,73,38,27,11,29,45,209
435,Terry Rozier,PG,23,BOS,80,16,2068,316,800,153,402,163,398,115,149,63,313,376,232,80,19,80,123,900
436,Ricky Rubio,PG,27,UTA,77,77,2254,346,827,96,273,250,554,220,254,44,307,351,410,121,11,207,206,1008
437,D'Angelo Russell,PG,21,BRK,48,35,1234,278,672,90,278,188,394,97,131,30,159,189,249,36,17,147,93,743
438,Domantas Sabonis,C,21,IND,74,19,1810,340,661,13,37,327,624,168,224,165,407,572,151,40,32,137,220,861
439,JaKarr Sampson,SF,24,SAC,22,6,344,44,81,5,10,39,71,10,16,21,57,78,9,8,22,8,48,103
440,Dario Šarić,PF,23,PHI,78,73,2310,403,890,157,399,246,491,178,207,154,366,520,202,51,20,148,160,1141
441,Tomáš Satoranský,SG,26,WAS,73,30,1643,201,384,47,101,154,283,75,96,72,161,233,286,52,15,83,131,524
442,Dennis Schröder,PG,24,ATL,67,67,2078,500,1146,76,262,424,884,225,265,44,164,208,417,72,6,183,147,1301
443,Mike Scott,PF,29,WAS,76,1,1406,276,524,66,163,210,361,50,76,50,197,247,80,23,10,79,148,668
444,Thabo Sefolosha,SF,33,UTA,38,6,806,118,240,32,84,86,156,44,54,29,132,161,33,52,12,30,59,312
445,Wayne Selden,SG,23,MEM,35,9,692,116,269,49,122,67,147,44,59,16,40,56,66,18,5,54,59,325
446,Ramon Sessions,PG,31,TOT,28,3,392,42,117,8,26,34,91,44,57,6,32,38,77,14,2,30,29,136
447,Iman Shumpert,SG,27,CLE,14,6,276,22,58,7,26,15,32,11,15,7,34,41,17,9,4,16,22,62
448,Pascal Siakam,PF,23,TOR,81,5,1679,253,498,29,132,224,366,54,87,79,285,364,159,62,42,67,166,589
449,Xavier Silas,SG,30,BOS,2,0,7,0,3,0,2,0,1,0,0,1,1,2,0,1,0,0,1,0
450,Ben Simmons,PG,21,PHI,81,81,2732,544,998,0,11,544,987,191,341,145,514,659,661,140,70,278,211,1279
451,Jonathon Simmons,SG,28,ORL,69,50,2029,354,761,69,204,285,557,185,241,61,178,239,171,58,16,146,175,962
452,Kobi Simmons,PG,20,MEM,32,12,643,80,189,11,39,69,150,25,25,14,36,50,68,18,5,44,61,196
453,Kyle Singler,SF,29,OKC,12,0,59,7,21,2,5,5,16,7,13,1,9,10,2,1,0,3,4,23
454,Marcus Smart,SG,23,BOS,54,11,1614,189,515,75,249,114,266,97,133,43,146,189,259,71,23,129,133,550
455,Dennis Smith,PG,20,DAL,69,69,2049,404,1024,106,339,298,685,134,193,50,210,260,358,71,18,194,152,1048
456,Ish Smith,PG,29,DET,82,35,2043,389,801,35,101,354,700,81,116,27,197,224,360,64,20,108,140,894
457,J.R. Smith,SG,32,CLE,80,61,2244,240,595,143,381,97,214,39,56,29,206,235,141,68,11,81,161,662
458,Jason Smith,C,31,WAS,33,2,285,45,115,4,32,41,83,19,21,18,35,53,14,3,13,16,44,113
459,Josh Smith,PF,32,NOP,3,0,12,1,4,0,0,1,4,0,0,3,1,4,0,0,0,0,3,2
460,Tony Snell,SG,26,MIL,75,59,2053,185,425,108,268,77,157,38,48,9,132,141,98,47,28,36,115,516
461,Marreese Speights,C,30,ORL,52,3,675,138,349,86,233,52,116,40,55,21,112,133,40,8,22,40,106,402
462,Nik Stauskas,SG,24,TOT,41,0,523,60,154,40,100,20,54,21,29,4,60,64,39,9,4,26,24,181
463,Lance Stephenson,SG,27,IND,82,7,1850,303,709,67,232,236,477,84,127,62,362,424,235,46,17,131,177,757
464,David Stockton,PG,26,UTA,3,0,9,2,3,2,3,0,0,4,4,0,0,0,0,0,0,1,3,10
465,Julyan Stone,SG,29,CHO,23,0,175,6,13,6,13,0,0,1,2,1,28,29,26,4,2,7,21,19
466,Edmond Sumner,PG,22,IND,1,0,2,1,1,0,0,1,1,0,0,0,1,1,0,0,0,0,1,2
467,Caleb Swanigan,PF,20,POR,27,3,189,24,60,1,8,23,52,12,18,15,39,54,14,5,3,18,37,61
468,Jayson Tatum,SF,19,BOS,80,80,2438,397,835,105,242,292,593,213,258,50,352,402,128,83,58,114,170,1112
469,Isaiah Taylor,PG,23,ATL,67,9,1167,163,390,20,80,143,310,99,141,22,72,94,206,34,10,84,116,445
470,Jeff Teague,PG,29,MIN,70,70,2311,354,794,84,228,270,566,202,239,24,185,209,492,102,23,177,171,994
471,Marquis Teague,PG,24,MEM,3,0,74,4,16,1,4,3,12,2,5,1,5,6,13,4,0,3,5,11
472,Mirza Teletović,PF,32,MIL,10,0,159,25,57,21,45,4,12,0,0,3,20,23,10,4,1,7,14,71
473,Garrett Temple,SG,31,SAC,65,35,1615,199,476,89,227,110,249,60,78,22,130,152,124,57,27,79,135,547
474,Miloš Teodosić,PG,30,LAC,45,36,1134,151,360,88,232,63,128,39,46,16,110,126,209,23,5,97,103,429
475,Jason Terry,SG,40,MIL,51,4,814,59,154,40,115,19,39,8,9,5,43,48,59,42,13,25,52,166
476,Daniel Theis,C,25,BOS,63,3,936,126,233,18,58,108,175,61,81,90,184,274,56,30,48,56,157,331
477,Isaiah Thomas,PG,28,TOT,32,15,862,157,421,55,188,102,233,117,131,17,50,67,153,15,3,95,58,486
478,Lance Thomas,PF,29,NYK,73,31,1353,102,267,50,124,52,143,44,53,44,131,175,44,30,14,40,134,298
479,Klay Thompson,SG,27,GSW,73,73,2506,575,1179,229,521,346,658,82,98,31,246,277,185,55,34,128,117,1461
480,Tristan Thompson,C,26,CLE,53,22,1072,132,235,0,0,132,235,43,79,126,226,352,33,16,17,36,102,307
481,Sindarius Thornwell,SG,23,LAC,73,17,1156,100,233,23,61,77,172,59,88,33,107,140,68,48,25,53,125,282
482,Anthony Tolliver,PF,32,DET,79,14,1757,219,472,159,365,60,107,106,133,50,191,241,90,32,21,58,144,703
483,Karl-Anthony Towns,C,22,MIN,82,82,2918,639,1172,120,285,519,887,345,402,238,774,1012,199,64,115,159,285,1743
484,P.J. Tucker,PF,32,HOU,82,34,2281,172,441,115,310,57,131,43,60,93,364,457,77,78,26,74,205,502
485,Evan Turner,SF,29,POR,79,40,2034,258,577,42,132,216,445,91,107,30,214,244,173,47,29,99,163,649
486,Myles Turner,C,21,IND,65,62,1836,306,639,56,157,250,482,160,206,93,324,417,87,38,118,96,186,828
487,Ekpe Udoh,C,30,UTA,63,3,810,60,120,0,1,60,119,42,56,68,82,150,53,43,74,20,105,162
488,Tyler Ulis,PG,22,PHO,71,43,1658,214,551,42,146,172,405,84,101,24,104,128,311,70,7,127,120,554
489,Jonas Valančiūnas,C,25,TOR,77,77,1727,390,687,30,74,360,613,170,211,183,477,660,81,29,69,115,192,980
490,Denzel Valentine,SG,24,CHI,77,37,2095,301,721,143,370,158,351,38,51,48,345,393,244,65,11,99,185,783
491,Fred VanVleet,PG,23,TOR,76,0,1520,232,545,108,261,124,284,84,101,25,159,184,243,68,19,74,130,656
492,Rashad Vaughn,SG,21,TOT,28,0,212,23,56,14,37,9,19,4,6,3,18,21,13,5,3,6,15,64
493,Noah Vonleh,PF,22,TOT,54,16,875,104,234,20,66,84,168,36,58,70,241,311,34,19,17,31,68,264
494,Nikola Vučević,C,27,ORL,57,57,1683,399,840,64,204,335,636,77,94,101,422,523,191,56,62,109,144,939
495,Dwyane Wade,SG,36,TOT,67,3,1536,299,682,32,111,267,571,135,189,50,202,252,228,61,47,140,124,765
496,Dion Waiters,SG,26,MIA,30,30,918,163,410,52,170,111,240,51,69,8,69,77,113,23,9,70,61,429
497,Kemba Walker,PG,27,CHO,80,80,2736,588,1363,231,601,357,762,363,420,32,216,248,444,91,24,179,98,1770
498,John Wall,PG,27,WAS,41,41,1410,280,667,62,167,218,500,175,241,22,128,150,393,57,45,158,80,797
499,Tyrone Wallace,PG,23,LAC,30,19,851,110,247,10,40,100,207,61,78,21,84,105,71,27,13,46,83,291
500,Taurean Waller-Prince,SF,23,ATL,82,82,2464,415,975,176,457,239,518,152,180,50,339,389,214,85,42,191,168,1158
501,Derrick Walton,PG,22,MIA,16,0,147,8,25,7,17,1,8,6,6,2,14,16,16,7,3,2,7,29
502,Jameel Warney,PF,24,DAL,3,0,27,7,12,0,0,7,12,3,5,4,5,9,0,0,0,1,2,17
503,T.J. Warren,SF,24,PHO,65,65,2142,529,1063,20,90,509,973,193,255,125,208,333,85,65,41,85,149,1271
504,Travis Wear,SF,27,LAL,17,0,228,25,72,17,47,8,25,8,8,0,38,38,7,4,5,6,30,75
505,James Webb,SF,24,BRK,10,0,120,6,24,4,19,2,5,0,0,8,16,24,4,1,0,4,10,16
506,Briante Weber,PG,25,TOT,18,0,237,19,43,4,11,15,32,8,10,8,27,35,22,18,5,15,28,50
507,David West,C,37,GSW,73,0,999,216,378,3,8,213,370,60,79,64,174,238,138,47,75,80,120,495
508,Russell Westbrook,PG,29,OKC,80,80,2914,757,1687,97,326,660,1361,417,566,152,652,804,820,147,20,381,200,2028
509,Andrew White,SF,24,ATL,15,0,209,25,73,18,49,7,24,1,4,4,30,34,6,3,1,8,12,69
510,Derrick White,PG,23,SAS,17,0,139,16,33,8,13,8,20,14,20,5,21,26,9,4,3,6,8,54
511,Okaro White,PF,25,MIA,6,4,80,7,16,4,11,3,5,2,3,3,8,11,2,1,1,1,6,20
512,Isaiah Whitehead,PG,22,BRK,16,0,180,40,86,7,18,33,68,13,19,4,22,26,20,8,2,24,23,100
513,Hassan Whiteside,C,28,MIA,54,54,1364,312,578,2,2,310,576,128,182,174,444,618,54,37,94,92,131,754
514,Andrew Wiggins,SF,22,MIN,82,82,2979,569,1300,112,338,457,962,202,314,82,276,358,160,91,51,138,163,1452
515,Jacob Wiley,PF,23,BRK,5,0,33,1,4,1,2,0,2,1,2,2,9,11,2,1,0,0,4,4
516,Damien Wilkins,SF,38,IND,19,1,152,13,39,4,18,9,21,3,4,5,11,16,9,2,1,5,7,33
517,Alan Williams,PF,25,PHO,5,0,70,7,18,0,0,7,18,6,9,3,19,22,8,5,1,7,13,20
518,C.J. Williams,SG,27,LAC,38,17,707,87,197,22,78,65,119,13,16,12,44,56,43,31,13,20,63,209
519,Derrick Williams,PF,26,LAL,2,0,9,1,4,0,2,1,2,0,0,0,1,1,0,0,0,0,0,2
520,Lou Williams,SG,31,LAC,79,19,2589,582,1337,186,518,396,819,432,491,40,158,198,417,85,19,234,106,1782
521,Marvin Williams,PF,31,CHO,78,78,2006,258,563,126,305,132,258,102,123,74,296,370,96,56,38,66,116,744
522,Matt Williams,SG,24,MIA,3,0,11,2,6,1,5,1,1,0,0,0,1,1,0,0,0,1,1,5
523,Troy Williams,SF,23,TOT,21,1,307,51,109,11,38,40,71,20,30,22,41,63,16,20,4,19,34,133
524,D.J. Wilson,PF,21,MIL,22,0,71,9,16,2,5,7,11,1,2,2,8,10,3,3,1,4,7,21
525,Jamil Wilson,SF,27,LAC,15,10,274,38,81,27,63,11,18,2,4,3,29,32,10,5,8,8,34,105
526,Justise Winslow,PF,21,MIA,68,25,1680,207,488,49,129,158,359,66,104,64,306,370,148,54,33,77,140,529
527,Jeff Withey,C,27,DAL,9,0,39,6,16,2,10,4,6,1,2,1,9,10,0,0,3,2,3,15
528,Nate Wolters,PG,26,UTA,5,0,19,1,6,0,0,1,6,0,0,1,1,2,1,0,0,0,1,2
529,Brandan Wright,PF,30,TOT,28,1,381,59,102,0,0,59,102,21,33,33,62,95,13,13,26,8,32,139
530,Delon Wright,PG,25,TOR,69,4,1433,201,432,56,153,145,279,97,117,45,153,198,200,72,33,78,81,555
531,Guerschon Yabusele,PF,22,BOS,33,4,235,26,61,12,37,14,24,15,22,17,35,52,16,4,5,12,23,79
532,James Young,SG,22,PHI,6,0,61,5,14,3,10,2,4,4,6,0,2,2,2,0,0,1,4,17
533,Joe Young,PG,25,IND,53,1,558,80,186,25,66,55,120,22,29,12,51,63,39,14,1,26,39,207
534,Nick Young,SG,32,GSW,80,8,1393,201,488,123,326,78,162,56,65,20,105,125,36,38,7,39,100,581
535,Thaddeus Young,PF,29,IND,81,81,2607,421,864,58,181,363,683,55,92,184,328,512,152,135,36,105,175,955
536,Cody Zeller,C,25,CHO,33,0,627,85,156,2,3,83,153,61,85,67,110,177,31,14,21,33,81,233
537,Tyler Zeller,C,28,TOT,66,34,1109,187,334,10,28,177,306,57,79,110,195,305,47,15,35,47,126,441
538,Paul Zipser,SF,23,CHI,54,12,824,81,234,37,110,44,124,19,25,13,118,131,46,20,15,43,86,218
539,Ante Žižić,C,21,CLE,32,2,214,49,67,0,0,49,67,21,29,24,36,60,5,2,13,11,30,119
540,Ivica Zubac,C,20,LAL,43,0,410,61,122,0,1,61,121,39,51,45,78,123,25,8,15,26,47,161
1,Álex Abrines,SG,25,OKC,31,2,588,56,157,41,127,15,30,12,13,5,43,48,20,17,6,14,53,165
2,Quincy Acy,PF,28,PHO,10,0,123,4,18,2,15,2,3,7,10,3,22,25,8,1,4,4,24,17
3,Jaylen Adams,PG,22,ATL,34,1,428,38,110,25,74,13,36,7,9,11,49,60,65,14,5,28,45,108
4,Steven Adams,C,25,OKC,80,80,2669,481,809,0,2,481,807,146,292,391,369,760,124,117,76,135,204,1108
5,Bam Adebayo,C,21,MIA,82,28,1913,280,486,3,15,277,471,166,226,165,432,597,184,71,65,121,203,729
6,Deng Adel,SF,21,CLE,19,3,194,11,36,6,23,5,13,4,4,3,16,19,5,1,4,6,13,32
7,DeVaughn Akoon-Purcell,SG,25,DEN,7,0,22,3,10,0,4,3,6,1,2,1,3,4,6,2,0,2,4,7
8,LaMarcus Aldridge,C,33,SAS,81,81,2687,684,1319,10,42,674,1277,349,412,251,493,744,194,43,107,144,179,1727
9,Rawle Alkins,SG,21,CHI,10,1,120,13,39,3,12,10,27,8,12,11,15,26,13,1,0,8,7,37
10,Grayson Allen,SG,23,UTA,38,2,416,67,178,32,99,35,79,45,60,3,20,23,25,6,6,33,47,211
11,Jarrett Allen,C,20,BRK,80,80,2096,335,568,6,45,329,523,197,278,191,481,672,110,43,120,103,184,873
12,Kadeem Allen,SG,26,NYK,19,1,416,65,141,17,36,48,105,42,54,8,43,51,76,16,4,26,46,189
13,Al-Farouq Aminu,PF,28,POR,81,81,2292,257,593,96,280,161,313,150,173,112,498,610,104,68,33,72,143,760
14,Justin Anderson,SF,25,ATL,48,4,463,64,157,24,77,40,80,26,35,24,60,84,23,22,13,23,48,178
15,Kyle Anderson,SF,25,MEM,43,40,1281,150,276,9,34,141,242,37,64,48,203,251,128,54,37,58,112,346
16,Ryan Anderson,PF,30,TOT,25,8,322,21,69,9,40,12,29,12,16,18,36,54,19,4,1,14,25,63
17,Ike Anigbogu,C,20,IND,3,0,6,0,3,0,0,0,3,0,0,1,2,3,1,0,1,1,0,0
18,Giannis Antetokounmpo,PF,24,MIL,72,72,2358,721,1247,52,203,669,1044,500,686,159,739,898,424,92,110,268,232,1994
19,Kostas Antetokounmpo,PF,21,DAL,2,0,11,0,3,0,0,0,3,2,4,0,1,1,0,2,0,1,0,2
20,Carmelo Anthony,PF,34,HOU,10,2,294,49,121,21,64,28,57,15,22,9,45,54,5,4,7,8,32,134
21,OG Anunoby,SF,21,TOR,67,6,1352,183,404,67,202,116,202,36,62,58,139,197,47,46,22,55,140,469
22,Ryan Arcidiacono,PG,24,CHI,81,32,1961,187,418,81,217,106,201,89,102,27,192,219,269,65,4,63,171,544
23,Trevor Ariza,SF,33,TOT,69,69,2349,294,736,145,434,149,302,130,164,50,321,371,252,91,21,106,130,863
24,D.J. Augustin,PG,31,ORL,81,81,2269,318,677,131,311,187,366,181,209,41,162,203,426,52,4,128,115,948
25,Deandre Ayton,C,20,PHO,71,70,2183,509,870,0,4,509,866,141,189,223,506,729,125,61,67,126,209,1159
26,Dwayne Bacon,SG,23,CHO,43,13,759,122,257,38,87,84,170,34,46,8,81,89,47,12,5,18,72,316
27,Marvin Bagley,PF,19,SAC,62,4,1567,356,706,30,96,326,610,181,262,162,309,471,62,33,59,98,120,923
28,Ron Baker,SG,25,TOT,15,0,152,4,20,1,13,3,7,5,6,1,10,11,15,6,1,5,18,14
29,Wade Baldwin,PG,22,POR,16,0,94,10,33,2,9,8,24,8,11,2,13,15,12,1,2,14,11,30
30,Lonzo Ball,PG,21,LAL,47,45,1423,185,456,75,228,110,228,20,48,54,197,251,255,69,19,103,114,465
31,Mo Bamba,C,20,ORL,47,1,766,117,243,21,70,96,173,37,63,64,169,233,39,13,64,43,102,292
32,J.J. Barea,PG,34,DAL,38,0,752,161,385,38,128,123,257,55,78,13,82,95,211,22,1,72,50,415
34,Will Barton,SG,28,DEN,43,38,1189,185,460,67,196,118,264,57,74,32,167,199,124,18,22,65,82,494
35,Keita Bates-Diop,SF,23,MIN,30,3,503,60,142,13,52,47,90,18,28,16,67,83,17,18,14,14,29,151
36,Nicolas Batum,SF,30,CHO,75,72,2354,253,562,116,298,137,264,77,89,71,319,390,247,71,43,117,140,699
37,Jerryd Bayless,PG,30,MIN,34,6,657,82,230,29,98,53,132,16,28,11,51,62,119,18,2,32,56,209
38,Aron Baynes,C,32,BOS,51,18,821,105,223,21,61,84,162,53,62,88,152,240,57,12,34,40,125,284
39,Kent Bazemore,SG,29,ATL,67,35,1643,278,691,96,300,182,391,127,175,37,224,261,152,89,42,121,170,779
40,Bradley Beal,SG,25,WAS,82,82,3028,764,1609,209,596,555,1013,362,448,89,322,411,448,121,58,224,226,2099
41,Malik Beasley,SG,22,DEN,81,18,1879,349,737,163,405,186,332,56,66,35,165,200,97,55,10,55,116,917
42,Michael Beasley,PF,30,LAL,26,2,277,75,153,3,17,72,136,28,39,13,47,60,25,9,10,27,42,181
43,Marco Belinelli,SG,32,SAS,79,1,1815,285,690,147,395,138,295,112,124,16,182,198,132,35,8,72,121,829
44,Jordan Bell,C,24,GSW,68,3,788,99,192,0,2,99,190,25,41,55,129,184,76,20,51,42,80,223
45,DeAndre' Bembry,SG,24,ATL,82,15,1931,275,616,50,173,225,443,87,136,54,304,358,202,105,41,142,190,687
46,Dragan Bender,PF,21,PHO,46,27,826,88,197,22,101,66,96,32,54,34,149,183,56,18,22,37,90,230
47,Dairis Bertāns,SG,29,NOP,12,0,167,12,47,10,34,2,13,0,0,2,7,9,10,1,0,2,7,34
48,Dāvis Bertāns,PF,26,SAS,76,12,1632,204,453,145,338,59,115,53,60,23,241,264,100,35,33,43,133,606
49,Patrick Beverley,PG,30,LAC,78,49,2137,194,477,112,282,82,195,96,123,76,312,388,300,67,43,85,265,596
50,Khem Birch,C,26,ORL,50,1,643,91,151,0,1,91,150,58,83,79,111,190,38,18,29,20,72,240
51,Bismack Biyombo,C,26,CHO,54,32,783,89,156,0,0,89,156,58,91,81,166,247,33,11,41,34,103,236
52,Nemanja Bjelica,PF,30,SAC,77,70,1788,284,593,103,257,181,336,70,92,125,319,444,147,54,56,82,197,741
53,Antonio Blakeney,SG,22,CHI,57,3,829,166,396,36,91,130,305,50,76,7,99,106,42,12,9,35,41,418
54,Eric Bledsoe,PG,29,MIL,78,78,2272,470,971,124,377,346,594,177,236,82,280,362,430,116,29,165,156,1241
55,Jaron Blossomgame,SF,25,CLE,27,4,439,47,106,10,39,37,67,10,13,26,72,98,13,7,8,11,20,114
56,Bogdan Bogdanović,SG,26,SAC,70,17,1947,361,863,134,372,227,491,134,162,40,203,243,267,72,15,117,142,990
57,Bojan Bogdanović,SF,29,IND,81,81,2573,522,1051,164,386,358,665,246,305,33,300,333,161,69,1,134,138,1454
58,Andrew Bogut,C,34,GSW,11,5,134,18,36,0,0,18,36,3,3,12,43,55,11,3,8,8,22,39
59,Jonah Bolden,PF,23,PHI,44,10,639,80,162,34,96,46,66,13,27,47,118,165,40,17,39,36,99,207
60,Isaac Bonga,PG,19,LAL,22,0,120,5,33,0,8,5,25,9,15,9,16,25,15,9,4,6,9,19
61,Devin Booker,SG,22,PHO,64,64,2242,586,1255,135,414,451,841,393,454,39,226,265,433,56,13,264,200,1700
62,Chris Boucher,PF,26,TOR,28,0,163,34,76,12,37,22,39,13,15,16,40,56,2,6,24,7,31,93
63,Avery Bradley,SG,28,TOT,63,63,1905,248,608,86,245,162,363,43,50,43,132,175,152,41,16,89,167,625
64,Tony Bradley,C,21,UTA,3,0,36,8,16,0,0,8,16,1,2,9,6,15,1,2,2,3,6,17
65,Corey Brewer,SF,32,TOT,31,3,492,53,123,14,44,39,79,31,43,26,50,76,39,32,7,19,63,151
66,Mikal Bridges,SF,22,PHO,82,56,2417,242,563,105,313,137,250,95,118,56,208,264,173,129,38,70,201,684
67,Miles Bridges,SF,20,CHO,80,25,1696,237,511,65,200,172,311,58,77,67,256,323,95,55,49,50,111,597
68,Isaiah Briscoe,PG,22,ORL,39,0,559,55,138,11,34,44,104,15,26,5,69,74,87,11,2,31,66,136
69,Ryan Broekhoff,SG,28,DAL,42,0,453,57,126,38,93,19,33,15,19,8,55,63,22,6,4,16,35,167
70,Malcolm Brogdon,SG,26,MIL,64,64,1832,378,748,104,244,274,504,141,152,65,223,288,205,46,13,91,102,1001
71,Dillon Brooks,SF,23,MEM,18,0,330,49,122,15,40,34,82,22,30,9,22,31,16,10,4,19,50,135
72,MarShon Brooks,SG,30,MEM,29,0,387,76,169,15,54,61,115,23,33,12,33,45,25,9,4,21,33,190
73,Bruce Brown,SG,22,DET,74,56,1449,125,314,24,93,101,221,45,60,48,137,185,91,40,36,46,178,319
74,Jaylen Brown,SG,22,BOS,74,25,1913,368,792,95,276,273,516,133,202,65,248,313,100,69,32,99,186,964
75,Lorenzo Brown,PG,28,TOR,26,0,212,23,71,6,28,17,43,3,3,5,26,31,28,12,5,16,22,55
76,Sterling Brown,SG,23,MIL,58,7,1034,145,312,53,147,92,165,29,42,29,155,184,84,25,8,46,88,372
77,Troy Brown,SF,19,WAS,52,10,730,97,234,22,69,75,165,32,47,35,110,145,80,21,5,30,56,248
78,Jalen Brunson,PG,22,DAL,73,38,1591,264,565,63,181,201,384,87,120,25,144,169,230,37,4,88,127,678
79,Thomas Bryant,C,21,WAS,72,53,1496,309,502,33,99,276,403,107,137,113,341,454,92,25,67,60,126,758
80,Reggie Bullock,SG,27,TOT,63,60,1879,245,594,148,393,97,201,73,85,22,151,173,129,40,12,65,109,711
81,Trey Burke,PG,26,TOT,58,8,1125,236,548,56,159,180,389,103,124,28,71,99,159,33,7,49,58,631
82,Alec Burks,SG,27,TOT,64,24,1375,192,474,61,168,131,306,116,141,30,205,235,128,39,21,65,91,561
83,Deonte Burton,SG,25,OKC,32,0,240,33,82,8,27,25,55,8,12,4,24,28,9,6,8,9,31,82
85,Bruno Caboclo,SF,23,MEM,34,19,800,96,225,48,130,48,95,42,50,42,116,158,50,14,33,38,81,282
86,José Calderón,PG,37,DET,49,0,632,45,120,14,57,31,63,9,11,11,49,60,115,16,3,35,64,113
87,Kentavious Caldwell-Pope,SG,25,LAL,82,23,2035,325,756,151,435,174,321,137,158,48,190,238,110,73,13,65,137,938
88,Isaiah Canaan,PG,27,TOT,30,16,629,64,164,34,96,30,68,19,24,6,52,58,84,14,2,35,52,181
89,Clint Capela,C,24,HOU,67,67,2249,474,732,0,0,474,732,166,261,298,550,848,96,44,102,94,168,1114
90,DeMarre Carroll,PF,32,BRK,67,8,1703,227,575,106,310,121,265,184,242,68,281,349,85,31,10,73,114,744
91,Jevon Carter,PG,23,MEM,39,3,577,56,185,34,102,22,83,26,32,14,52,66,69,26,11,33,55,172
92,Vince Carter,PF,42,ATL,76,9,1330,196,468,123,316,73,152,47,66,31,163,194,87,44,27,48,141,562
93,Wendell Carter,C,19,CHI,44,44,1110,180,371,6,32,174,339,89,112,87,220,307,78,26,58,65,152,455
94,Michael Carter-Williams,PG,27,TOT,28,1,372,46,123,10,38,36,85,32,53,19,51,70,70,20,15,20,48,134
95,Alex Caruso,PG,24,LAL,25,4,531,77,173,24,50,53,123,51,64,20,47,67,77,24,9,42,54,229
96,Omri Casspi,SF,30,MEM,36,0,520,86,161,15,43,71,118,39,58,17,98,115,26,20,9,23,35,226
97,Willie Cauley-Stein,C,25,SAC,81,81,2213,412,741,1,2,411,739,140,254,181,497,678,194,96,51,84,227,965
98,Troy Caupain,PG,23,ORL,4,0,16,4,8,2,3,2,5,0,0,1,2,3,4,1,0,0,0,10
99,Tyler Cavanaugh,PF,24,UTA,11,0,39,3,10,1,5,2,5,2,2,3,5,8,1,0,0,1,3,9
100,Tyson Chandler,C,36,TOT,55,6,875,61,99,0,1,61,98,51,87,92,215,307,37,21,23,42,110,173
102,Joe Chealey,PG,23,CHO,1,0,8,1,3,0,0,1,3,0,0,0,0,0,1,0,0,0,1,2
103,Chris Chiozza,PG,23,HOU,7,0,33,2,8,2,5,0,3,0,0,1,3,4,4,1,1,1,2,6
104,Marquese Chriss,PF,21,TOT,43,2,499,67,180,16,72,51,108,32,45,40,102,142,22,17,11,36,81,182
105,Gary Clark,PF,24,HOU,51,2,641,50,151,41,138,9,13,7,7,24,92,116,18,20,26,7,47,148
106,Ian Clark,SG,27,NOP,60,6,973,151,383,66,202,85,181,33,37,13,76,89,94,22,8,58,95,401
107,Jordan Clarkson,SG,26,CLE,81,0,2214,529,1180,144,445,385,735,162,192,82,188,270,196,57,13,135,112,1364
108,John Collins,PF,21,ATL,61,59,1829,465,831,55,158,410,673,203,266,219,376,595,121,22,39,120,199,1188
109,Zach Collins,C,21,POR,77,0,1356,189,400,40,121,149,279,94,126,109,215,324,71,25,66,77,174,512
110,Darren Collison,PG,31,IND,76,76,2143,308,659,79,194,229,465,158,190,36,196,232,459,110,9,125,138,853
111,Bonzie Colson,SF,23,MIL,8,2,98,13,39,5,21,8,18,8,9,8,22,30,3,5,1,3,3,39
112,Mike Conley,PG,31,MEM,70,70,2342,490,1120,155,426,335,694,343,406,40,199,239,449,94,22,130,123,1478
113,Pat Connaughton,SG,26,MIL,61,2,1261,163,350,66,200,97,150,29,40,61,197,258,122,33,25,33,81,421
114,Quinn Cook,PG,25,GSW,74,10,1059,204,439,81,200,123,239,20,26,22,135,157,116,20,3,50,92,509
115,DeMarcus Cousins,C,28,GSW,30,30,771,178,371,26,95,152,276,106,144,43,204,247,107,40,44,72,109,488
116,Robert Covington,SF,28,TOT,35,35,1203,156,362,85,225,71,137,68,89,28,165,193,46,74,47,47,126,465
117,Allen Crabbe,SG,26,BRK,43,20,1133,137,373,98,259,39,114,41,56,16,132,148,46,23,13,46,102,413
118,Torrey Craig,SF,28,DEN,75,37,1503,160,362,61,188,99,174,49,70,89,174,263,72,37,46,44,175,430
119,Jamal Crawford,SG,38,PHO,64,0,1211,174,438,67,202,107,236,93,110,8,77,85,229,33,12,99,75,508
120,Mitch Creek,SF,26,TOT,5,0,48,8,16,0,2,8,14,5,7,6,6,12,6,2,0,1,3,21
121,Jae Crowder,SF,28,UTA,80,11,2166,318,797,173,522,145,275,142,197,60,324,384,133,64,31,85,170,951
122,Dante Cunningham,PF,31,SAS,64,21,928,75,158,30,65,45,93,14,18,48,140,188,50,27,13,22,71,194
123,Seth Curry,SG,28,POR,74,2,1399,212,465,113,251,99,214,44,52,27,93,120,66,36,12,61,97,581
124,Stephen Curry,PG,30,GSW,69,69,2331,632,1340,354,810,278,530,263,287,45,324,369,361,92,25,192,166,1881
125,Troy Daniels,SG,27,PHO,51,1,760,113,275,74,194,39,81,18,23,13,60,73,26,26,5,27,79,318
126,Anthony Davis,C,25,NOP,56,56,1850,530,1026,48,145,482,881,344,433,174,498,672,218,88,135,112,132,1452
127,Deyonta Davis,C,22,ATL,9,0,118,15,22,0,1,15,21,6,10,10,26,36,5,3,5,3,12,36
128,Ed Davis,C,29,BRK,81,1,1446,186,302,0,2,186,300,100,162,216,478,694,61,35,33,64,226,472
129,Tyler Davis,C,21,OKC,1,0,1,0,1,0,0,0,1,0,0,1,0,1,0,0,0,0,0,0
130,Dewayne Dedmon,C,29,ATL,64,52,1609,259,526,83,217,176,309,92,113,105,375,480,90,69,71,84,214,693
131,Sam Dekker,PF,24,TOT,47,5,788,120,256,19,62,101,194,28,46,53,95,148,46,38,7,24,47,287
132,Ángel Delgado,C,24,LAC,2,0,15,1,5,0,0,1,5,1,2,2,2,4,0,1,0,0,2,3
133,Matthew Dellavedova,PG,28,TOT,48,0,812,98,242,44,130,54,112,42,52,6,71,77,181,14,2,68,75,282
134,Luol Deng,SF,33,MIN,22,2,392,59,118,14,44,45,74,25,35,20,53,73,18,15,8,14,24,157
135,DeMar DeRozan,SG,29,SAS,77,77,2688,631,1313,7,45,624,1268,366,441,54,408,462,475,86,36,199,177,1635
136,Marcus Derrickson,PF,22,GSW,11,0,67,16,33,10,20,6,13,4,5,8,5,13,1,0,1,3,9,46
137,Cheick Diallo,PF,22,NOP,64,1,896,168,271,1,4,167,267,50,67,75,257,332,33,29,33,49,113,387
138,Hamidou Diallo,SG,20,OKC,51,3,526,75,165,4,24,71,141,36,59,38,59,97,17,21,10,23,77,190
139,Gorgui Dieng,C,29,MIN,76,2,1031,189,377,19,56,170,321,88,106,81,230,311,72,48,41,57,134,485
140,Spencer Dinwiddie,PG,25,BRK,68,4,1914,366,828,124,370,242,458,287,356,26,140,166,311,40,17,152,187,1143
141,Donte DiVincenzo,SG,22,MIL,27,0,411,50,124,22,83,28,41,9,12,16,49,65,31,13,6,19,38,131
142,Luka Dončić,SG,19,DAL,72,72,2318,506,1186,168,514,338,672,346,485,86,477,563,429,77,25,247,137,1526
143,Tyler Dorsey,SG,22,TOT,48,11,698,107,264,44,132,63,132,38,61,27,86,113,56,14,2,27,53,296
144,Damyean Dotson,SG,24,NYK,73,40,2004,290,698,126,342,164,356,73,98,34,228,262,135,58,10,71,135,779
145,PJ Dozier,SG,22,BOS,6,0,51,8,21,2,8,6,13,1,2,6,11,17,5,2,0,0,2,19
146,Goran Dragić,PG,32,MIA,36,22,991,179,433,57,164,122,269,79,101,20,91,111,174,30,5,71,81,494
147,Andre Drummond,C,25,DET,79,79,2647,561,1052,5,38,556,1014,243,412,423,809,1232,112,136,138,175,272,1370
148,Jared Dudley,PF,33,BRK,59,25,1220,101,239,53,151,48,88,32,46,34,121,155,83,36,16,43,131,287
149,Kris Dunn,PG,24,CHI,46,44,1389,215,506,34,96,181,410,55,69,19,168,187,277,68,21,104,166,519
150,Kevin Durant,SF,30,GSW,78,78,2702,721,1383,137,388,584,995,448,506,33,464,497,457,58,84,225,155,2027
151,Trevon Duval,PG,20,MIL,3,0,6,2,3,1,1,1,2,0,0,0,1,1,2,0,0,0,0,5
152,Vince Edwards,SF,22,HOU,2,0,16,1,4,1,4,0,0,0,0,1,1,2,0,0,0,0,0,3
153,Henry Ellenson,PF,22,TOT,19,0,259,39,95,17,38,22,57,19,25,5,61,66,16,7,2,9,27,114
154,Wayne Ellington,SG,31,TOT,53,38,1297,184,457,138,372,46,85,39,49,14,93,107,72,54,6,40,92,545
155,Joel Embiid,C,24,PHI,64,64,2154,580,1199,79,263,501,936,522,649,160,711,871,234,46,122,226,211,1761
156,James Ennis,SF,28,TOT,58,27,1230,138,294,55,156,83,138,58,81,60,122,182,41,41,23,34,150,389
157,Drew Eubanks,PF,21,SAS,23,0,113,15,26,0,0,15,26,11,13,6,28,34,7,2,5,8,11,41
158,Jacob Evans,SG,21,GSW,30,1,204,18,53,4,15,14,38,0,1,6,19,25,23,5,3,11,28,40
159,Jawun Evans,PG,22,TOT,8,0,65,3,14,0,3,3,11,0,0,1,11,12,10,3,0,6,8,6
160,Tyreke Evans,SG,29,IND,69,18,1402,257,660,77,216,180,444,115,160,33,168,201,166,58,18,118,117,706
161,Dante Exum,PG,23,UTA,42,1,664,101,241,18,62,83,179,68,86,16,52,68,110,14,5,52,69,288
162,Kenneth Faried,C,29,TOT,37,13,728,156,265,8,25,148,240,64,99,97,153,250,20,17,23,33,82,384
163,Derrick Favors,C,27,UTA,76,70,1766,363,619,17,78,346,541,154,228,207,353,560,89,56,106,84,163,897
164,Cristiano Felício,C,26,CHI,60,0,746,95,179,0,4,95,175,50,73,79,139,218,37,11,7,33,69,240
165,Raymond Felton,PG,34,OKC,33,0,379,55,135,20,61,35,74,12,13,4,30,34,52,10,6,14,29,142
166,Terrance Ferguson,SG,20,OKC,74,74,1931,185,431,106,290,79,141,37,51,33,108,141,72,40,16,47,231,513
167,Yogi Ferrell,PG,25,SAC,71,3,1067,153,352,54,149,99,203,60,67,13,96,109,137,36,4,40,64,420
168,Dorian Finney-Smith,SF,25,DAL,81,26,1985,228,528,79,254,149,274,73,103,138,251,389,95,69,36,74,186,608
169,Bryn Forbes,SG,25,SAS,82,81,2293,361,791,176,413,185,378,69,78,18,221,239,175,45,4,80,159,967
170,Evan Fournier,SG,26,ORL,81,81,2553,468,1069,153,450,315,619,137,170,38,220,258,295,71,12,154,225,1226
171,De'Aaron Fox,PG,21,SAC,81,81,2546,505,1102,86,232,419,870,303,417,43,261,304,590,133,45,227,204,1399
172,Melvin Frazier,SG,22,ORL,10,0,44,7,21,0,6,7,15,1,4,3,2,5,1,1,0,1,6,15
173,Tim Frazier,PG,28,TOT,59,19,1120,116,261,37,101,79,160,41,54,41,127,168,248,30,5,76,112,310
174,Jimmer Fredette,SG,29,PHO,6,0,65,8,29,0,13,8,16,6,6,1,6,7,8,3,0,5,5,22
175,Channing Frye,C,35,CLE,36,6,341,43,117,32,79,11,38,11,14,4,48,52,20,6,5,13,44,129
176,Markelle Fultz,SG,20,PHI,19,15,427,65,155,4,14,61,141,21,37,26,44,70,59,17,5,25,52,155
177,Danilo Gallinari,SF,30,LAC,68,68,2059,409,884,161,372,248,512,367,406,54,363,417,178,49,23,99,129,1346
178,Langston Galloway,SG,27,DET,80,4,1745,228,587,135,380,93,207,81,96,49,122,171,85,37,8,24,135,672
179,Billy Garrett,SG,24,NYK,4,0,63,11,27,0,8,11,19,4,4,0,3,3,7,1,1,2,3,26
180,Marc Gasol,C,34,TOT,79,72,2436,390,870,99,273,291,597,192,253,80,547,627,349,84,86,155,217,1071
181,Pau Gasol,C,38,TOT,30,6,360,42,94,6,13,36,81,28,40,22,115,137,52,5,15,16,29,118
182,Rudy Gay,PF,32,SAS,69,51,1842,376,746,74,184,302,562,120,147,63,407,470,182,54,34,114,159,946
183,Paul George,SF,28,OKC,77,77,2841,707,1614,292,757,415,857,453,540,105,523,628,318,170,34,205,214,2159
184,Taj Gibson,PF,33,MIN,70,57,1686,304,537,11,34,293,503,134,177,172,286,458,84,53,39,73,186,753
185,Harry Giles,PF,20,SAC,58,0,820,175,348,0,6,175,342,58,91,66,156,222,85,31,22,73,150,408
186,Shai Gilgeous-Alexander,PG,20,LAC,82,73,2174,341,716,51,139,290,577,156,195,57,175,232,270,96,45,141,175,889
187,Rudy Gobert,C,26,UTA,81,80,2577,476,712,0,0,476,712,332,522,309,732,1041,161,66,187,130,231,1284
188,Brandon Goodwin,PG,23,DEN,16,0,57,6,23,2,6,4,17,9,11,1,2,3,14,0,0,3,7,23
189,Aaron Gordon,PF,23,ORL,78,78,2633,470,1046,121,347,349,699,185,253,129,445,574,289,57,56,162,172,1246
190,Eric Gordon,SG,30,HOU,68,53,2158,384,938,216,600,168,338,119,152,17,131,148,129,41,27,90,143,1103
191,Marcin Gortat,C,34,LAC,47,43,751,99,186,0,0,99,186,35,48,67,194,261,65,6,24,50,92,233
192,Devonte' Graham,PG,23,CHO,46,3,676,74,216,34,121,40,95,35,46,10,53,63,121,23,2,30,48,217
193,Treveon Graham,SG,25,BRK,35,21,715,64,191,38,128,26,63,18,22,23,84,107,34,13,7,17,68,184
194,Jerami Grant,PF,24,OKC,80,77,2612,409,823,115,293,294,530,157,221,96,321,417,79,61,100,67,214,1090
195,Jerian Grant,PG,26,ORL,60,1,939,92,220,40,110,52,110,26,40,19,79,98,156,44,6,51,78,250
196,Donte Grantham,SF,23,OKC,3,0,2,0,2,0,2,0,0,0,0,0,0,0,0,0,0,0,0,0
197,Danny Green,SG,31,TOR,80,80,2216,293,630,198,435,95,195,37,44,60,257,317,126,73,53,75,171,821
198,Draymond Green,PF,28,GSW,66,66,2065,188,422,47,165,141,257,63,91,60,421,481,454,95,70,169,197,486
199,Gerald Green,SG,33,HOU,73,0,1473,231,578,156,441,75,137,57,68,30,152,182,40,33,27,55,126,675
200,JaMychal Green,PF,28,TOT,65,6,1371,230,476,71,176,159,300,80,101,104,305,409,50,45,34,87,193,611
201,Jeff Green,PF,32,WAS,77,44,2097,326,687,111,320,215,367,183,206,57,252,309,137,43,39,101,160,946
202,Blake Griffin,PF,29,DET,75,75,2622,619,1341,189,522,430,819,414,550,100,465,565,402,52,28,253,199,1841
203,Daniel Hamilton,SG,23,ATL,19,3,204,23,60,8,23,15,37,3,6,10,37,47,22,6,1,16,19,57
204,Dusty Hannahs,SG,25,MEM,2,0,26,3,12,0,5,3,7,2,2,0,1,1,5,1,0,1,1,8
205,Tim Hardaway,SG,26,TOT,65,63,2057,390,993,162,477,228,516,232,276,33,189,222,159,54,8,105,141,1174
206,James Harden,PG,29,HOU,78,78,2867,843,1909,378,1028,465,881,754,858,66,452,518,586,158,58,387,244,2818
207,Maurice Harkless,SF,25,POR,60,53,1415,189,388,33,120,156,268,49,73,77,192,269,74,67,53,45,163,460
208,Montrezl Harrell,C,25,LAC,82,5,2158,546,888,3,17,543,871,266,414,184,351,535,162,71,110,132,255,1361
209,Devin Harris,PG,35,DAL,68,2,1071,132,347,62,200,70,147,102,134,12,100,112,122,35,16,56,133,428
210,Gary Harris,SG,24,DEN,57,48,1639,270,637,82,242,188,395,115,144,41,119,160,127,55,19,68,113,737
211,Joe Harris,SG,27,BRK,76,76,2293,374,748,183,386,191,362,110,133,52,239,291,181,38,17,121,182,1041
212,Tobias Harris,PF,26,TOT,82,82,2847,611,1254,156,393,455,861,266,307,69,576,645,229,51,37,151,184,1644
213,Andrew Harrison,PG,24,TOT,17,0,187,16,53,5,25,11,28,17,18,6,14,20,24,4,2,12,34,54
214,Shaquille Harrison,PG,25,CHI,73,11,1430,184,426,24,89,160,337,82,123,33,189,222,139,89,30,60,124,474
215,Josh Hart,SG,23,LAL,67,22,1715,189,464,92,274,97,190,55,80,35,213,248,93,64,40,58,147,525
216,Isaiah Hartenstein,PF,20,HOU,28,0,221,20,41,2,6,18,35,11,14,21,26,47,15,7,12,13,56,53
217,Udonis Haslem,C,38,MIA,10,1,74,11,33,0,12,11,21,3,4,3,24,27,2,0,0,3,9,25
218,Gordon Hayward,PF,28,BOS,72,18,1863,296,635,77,231,219,404,156,187,51,271,322,244,62,23,105,104,825
219,John Henson,C,28,MIL,14,0,188,31,67,11,31,20,36,6,10,16,55,71,14,7,11,12,16,79
220,Juan Hernangómez,PF,23,DEN,70,25,1358,138,314,66,181,72,133,66,86,64,201,265,55,27,24,37,94,408
221,Willy Hernangómez,C,24,CHO,58,3,812,153,295,15,39,138,256,100,144,117,194,311,60,16,20,58,98,421
222,Mario Hezonja,SF,23,NYK,58,24,1206,191,464,42,152,149,312,87,114,28,211,239,88,57,8,88,110,511
223,Isaiah Hicks,PF,24,NYK,3,0,32,4,8,0,0,4,8,4,5,2,5,7,2,1,3,1,5,12
224,Buddy Hield,SG,26,SAC,82,82,2615,623,1360,278,651,345,709,171,193,106,306,412,205,58,33,146,202,1695
225,Haywood Highsmith,SF,22,PHI,5,0,40,4,10,1,5,3,5,0,2,0,5,5,2,1,0,1,1,9
226,Nenê Hilário,C,36,HOU,42,2,546,60,116,0,3,60,113,31,47,34,89,123,26,18,15,11,87,151
227,George Hill,PG,32,TOT,60,13,1302,170,376,48,153,122,223,70,85,39,109,148,135,52,8,51,102,458
228,Solomon Hill,SF,27,NOP,44,15,878,68,178,32,101,36,77,23,32,34,99,133,55,23,10,31,80,191
229,Aaron Holiday,PG,22,IND,50,0,646,105,262,43,127,62,135,41,50,5,62,67,87,21,13,40,71,294
230,Jrue Holiday,SG,28,NOP,67,67,2402,547,1159,118,363,429,796,208,271,75,259,334,518,109,54,210,148,1420
231,Justin Holiday,SG,29,TOT,82,77,2607,300,777,162,465,138,312,95,106,46,277,323,146,121,36,104,164,857
232,John Holland,SF,30,CLE,1,0,1,0,0,0,0,0,0,0,0,0,0,0,0,0,0,0,0,0
233,Rondae Hollis-Jefferson,SF,24,BRK,59,21,1234,200,487,9,49,191,438,118,183,83,227,310,96,44,27,68,107,527
234,Richaun Holmes,C,25,PHO,70,4,1184,222,365,0,0,222,365,128,175,115,216,331,60,42,79,52,194,572
235,Rodney Hood,SG,26,TOT,72,49,1893,292,671,84,236,208,435,137,155,25,132,157,126,59,12,55,146,805
236,Al Horford,C,32,BOS,68,68,1973,387,723,73,203,314,520,78,95,120,338,458,283,59,86,102,126,925
237,Danuel House,SF,25,HOU,39,13,979,118,252,74,178,44,74,56,71,25,115,140,40,21,11,35,80,366
238,Dwight Howard,C,33,WAS,9,9,230,43,69,0,0,43,69,29,48,24,59,83,4,7,4,16,34,115
239,Kevin Huerter,SG,20,ATL,75,59,2048,275,657,136,353,139,304,41,56,60,185,245,214,65,25,109,155,727
240,Isaac Humphries,C,21,ATL,5,1,56,6,21,3,11,3,10,0,0,4,7,11,0,1,0,0,7,15
241,R.J. Hunter,SG,25,BOS,1,0,26,6,13,4,10,2,3,1,2,1,2,3,3,1,0,0,3,17
242,Chandler Hutchison,SF,22,CHI,44,14,895,96,209,14,50,82,159,23,38,31,154,185,34,23,6,25,59,229
243,Serge Ibaka,C,29,TOR,74,51,2010,464,877,49,169,415,708,135,177,156,445,601,99,29,103,114,211,1112
244,Andre Iguodala,SF,35,GSW,68,13,1578,151,302,48,144,103,158,39,67,48,204,252,216,61,51,52,95,389
245,Ersan İlyasova,PF,31,MIL,67,7,1231,167,381,58,160,109,221,61,74,94,208,302,52,32,20,48,172,453
246,Joe Ingles,PF,31,UTA,82,82,2568,359,802,189,483,170,319,87,123,35,295,330,469,98,20,193,180,994
247,Andre Ingram,SG,33,LAL,4,0,15,0,6,0,3,0,3,0,0,1,1,2,0,1,0,1,0,0
248,Brandon Ingram,SF,21,LAL,52,52,1760,362,729,31,94,331,635,195,289,41,226,267,154,28,31,129,149,950
249,Kyrie Irving,PG,26,BOS,67,67,2214,604,1241,174,434,430,807,214,245,71,264,335,464,103,34,172,167,1596
250,Jonathan Isaac,PF,21,ORL,75,64,1996,262,611,86,266,176,345,110,135,99,312,411,80,59,98,75,143,720
251,Wesley Iwundu,SF,24,ORL,68,13,1233,113,274,29,79,84,195,84,103,37,147,184,73,28,22,44,123,339
252,Demetrius Jackson,PG,24,PHI,6,0,39,8,15,2,6,6,9,4,4,2,1,3,5,2,0,1,4,22
253,Frank Jackson,PG,20,NOP,61,16,1169,194,447,53,169,141,278,54,73,25,109,134,69,25,2,48,92,495
254,Jaren Jackson,PF,19,MEM,58,56,1515,298,589,51,142,247,447,151,197,73,199,272,64,52,82,98,220,798
255,Josh Jackson,SG,21,PHO,79,29,1988,347,841,73,225,274,616,143,213,66,281,347,183,74,56,173,209,910
256,Justin Jackson,SF,23,TOT,81,14,1614,217,485,87,245,130,240,62,79,44,168,212,96,32,14,29,99,583
257,Reggie Jackson,PG,28,DET,82,82,2289,441,1047,174,471,267,576,204,236,45,171,216,344,55,9,148,208,1260
258,LeBron James,SF,34,LAL,55,55,1937,558,1095,111,327,447,768,278,418,57,408,465,454,72,33,197,94,1505
259,Amile Jefferson,PF,25,ORL,12,0,68,10,16,0,0,10,16,7,8,6,15,21,3,3,3,1,8,27
260,John Jenkins,SG,27,TOT,26,0,333,42,105,22,58,20,47,15,18,6,31,37,22,0,2,9,10,121
261,Jonas Jerebko,PF,31,GSW,73,6,1218,163,355,69,188,94,167,64,80,72,216,288,96,27,18,43,137,459
262,Alize Johnson,PF,22,IND,14,0,64,4,16,1,2,3,14,4,8,4,15,19,1,1,3,0,7,13
263,Amir Johnson,C,31,PHI,51,6,529,79,157,12,40,67,117,31,41,47,100,147,60,16,13,45,99,201
264,B.J. Johnson,SF,23,TOT,7,0,49,9,18,3,7,6,11,2,2,2,6,8,0,2,0,2,4,23
265,James Johnson,PF,31,MIA,55,33,1164,164,379,50,149,114,230,50,70,22,154,176,135,35,27,74,114,428
266,Stanley Johnson,SF,22,TOT,66,7,1208,171,440,62,215,109,225,50,64,34,183,217,88,60,14,81,114,454
267,Tyler Johnson,PG,26,TOT,57,22,1529,217,526,90,260,127,266,95,127,34,139,173,166,54,27,77,97,619
268,Wesley Johnson,SF,31,TOT,38,13,534,45,128,25,76,20,52,13,19,12,60,72,23,14,12,18,63,128
269,Nikola Jokić,C,23,DEN,80,80,2504,616,1206,83,270,533,936,289,352,228,637,865,580,108,55,248,228,1604
270,Damian Jones,C,23,GSW,24,22,410,53,74,0,0,53,74,24,37,31,44,75,28,12,25,16,63,130
271,Derrick Jones,SF,21,MIA,60,14,1153,160,324,28,91,132,233,74,122,96,144,240,37,46,42,43,123,422
272,Jalen Jones,SF,25,CLE,16,0,214,26,62,10,28,16,34,19,27,11,23,34,7,9,2,8,27,81
273,Jemerrio Jones,SF,23,LAL,6,2,143,12,33,2,10,10,23,1,2,16,33,49,13,7,5,5,10,27
274,Terrence Jones,PF,27,HOU,2,0,5,1,4,0,2,1,2,0,1,0,4,4,0,0,0,1,1,2
275,Tyus Jones,PG,22,MIN,68,23,1560,185,446,40,126,145,320,58,69,23,111,134,327,81,5,47,78,468
276,DeAndre Jordan,C,30,TOT,69,69,2047,286,446,0,0,286,446,186,264,225,677,902,156,42,73,153,167,758
277,Cory Joseph,PG,27,IND,82,9,2063,226,548,55,171,171,377,30,43,39,240,279,321,94,22,80,131,537
278,Frank Kaminsky,C,25,CHO,47,0,755,138,298,50,139,88,159,79,107,39,124,163,63,12,12,41,68,405
279,Enes Kanter,C,26,TOT,67,31,1640,375,683,10,34,365,649,155,197,257,402,659,116,32,26,118,167,915
280,Luke Kennard,SG,22,DET,63,10,1437,228,520,106,269,122,251,51,61,12,171,183,114,26,10,57,92,613
281,Michael Kidd-Gilchrist,PF,25,CHO,64,3,1179,158,332,16,47,142,285,95,123,88,158,246,61,32,39,43,156,427
282,George King,SF,25,PHO,1,0,6,0,0,0,0,0,0,0,0,0,1,1,0,0,0,0,0,0
283,Maxi Kleber,PF,27,DAL,71,18,1502,175,386,77,218,98,168,58,74,90,239,329,70,36,78,54,143,485
284,Brandon Knight,PG,27,TOT,39,26,736,99,260,41,129,58,131,27,34,10,49,59,71,21,2,30,62,266
285,Kevin Knox,PF,19,NYK,75,57,2158,338,914,125,364,213,550,162,226,61,274,335,82,43,24,114,175,963
286,Furkan Korkmaz,SG,21,PHI,48,7,679,98,245,47,144,51,101,36,44,16,91,107,52,29,2,25,62,279
287,Luke Kornet,PF,23,NYK,46,18,784,107,283,70,193,37,90,38,46,28,107,135,54,27,42,25,41,322
289,Kosta Koufos,C,29,SAC,42,1,502,73,153,0,0,73,153,10,24,52,125,177,36,15,18,27,68,156
290,Rodions Kurucs,SF,20,BRK,63,46,1294,202,449,58,184,144,265,72,92,56,190,246,52,41,25,77,146,534
291,Kyle Kuzma,PF,23,LAL,70,68,2314,496,1087,128,422,368,665,188,250,60,322,382,178,41,26,133,170,1308
292,Skal Labissière,PF,22,TOT,22,1,176,26,49,6,13,20,36,9,17,9,34,43,11,5,6,11,29,67
293,Jeremy Lamb,SG,26,CHO,79,55,2250,431,979,115,330,316,649,231,260,65,369,434,172,88,32,80,140,1208
294,Zach LaVine,SG,23,CHI,63,62,2171,530,1135,120,321,410,814,312,375,40,254,294,283,60,26,215,140,1492
295,Jake Layman,SF,24,POR,71,33,1327,216,424,59,181,157,243,50,71,56,161,217,53,31,30,46,116,541
296,T.J. Leaf,PF,21,IND,58,1,522,99,183,8,31,91,152,19,31,43,82,125,24,9,19,12,35,225
297,Courtney Lee,SG,33,TOT,34,6,428,53,129,16,55,37,74,14,21,9,45,54,37,21,3,14,32,136
298,Damion Lee,SG,26,GSW,32,0,375,56,127,27,68,29,59,19,22,8,56,64,13,13,0,11,28,158
299,Walt Lemon,PG,26,CHI,6,3,167,38,87,2,5,36,82,8,11,4,23,27,30,11,1,10,14,86
300,Alex Len,C,25,ATL,77,31,1544,320,648,74,204,246,444,140,216,158,266,424,86,27,69,97,200,854
301,Kawhi Leonard,SF,27,TOR,60,60,2040,560,1129,112,302,448,827,364,426,78,361,439,199,106,24,121,87,1596
302,Meyers Leonard,C,26,POR,61,2,878,132,242,50,111,82,131,43,51,49,184,233,75,13,9,43,105,357
303,Jon Leuer,PF,29,DET,41,1,402,66,113,1,11,65,102,23,31,27,70,97,14,12,4,23,60,156
304,Caris LeVert,SF,24,BRK,40,25,1063,207,483,48,154,159,329,85,123,35,116,151,156,42,14,69,77,547
305,Damian Lillard,PG,28,POR,80,80,2838,681,1533,237,643,444,890,468,513,68,303,371,551,88,34,212,148,2067
306,Jeremy Lin,PG,30,TOT,74,4,1436,238,541,55,187,183,354,176,210,22,157,179,231,47,13,124,144,707
307,Shaun Livingston,PG,33,GSW,64,0,967,109,210,0,2,109,208,40,51,42,75,117,114,31,27,38,74,258
308,Zach Lofton,SG,26,DET,1,0,4,0,1,0,1,0,0,0,0,0,0,0,0,1,0,1,0,0
309,Kevon Looney,C,22,GSW,80,24,1481,217,347,1,10,216,337,65,105,194,223,417,123,46,53,51,211,500
310,Brook Lopez,C,30,MIL,81,81,2322,355,786,187,512,168,274,112,133,33,363,396,98,51,179,82,189,1009
311,Robin Lopez,C,30,CHI,74,36,1606,304,535,7,31,297,504,89,123,140,146,286,89,11,78,96,124,704
312,Kevin Love,PF,30,CLE,22,21,598,109,283,53,147,56,136,103,114,33,206,239,48,6,5,42,54,374
313,Kyle Lowry,PG,32,TOR,65,65,2213,304,739,157,453,147,286,161,194,41,271,312,564,91,31,182,166,926
314,Jordan Loyd,PG,25,TOR,12,0,55,8,18,4,8,4,10,9,11,1,8,9,6,0,0,2,5,29
315,Kalin Lucas,PG,29,DET,1,0,6,0,1,0,1,0,0,2,2,0,3,3,1,0,0,0,1,2
316,Timothé Luwawu-Cabarrot,SF,23,TOT,50,7,669,82,218,36,116,46,102,31,41,11,86,97,26,19,8,21,73,231
317,Tyler Lydon,PF,22,DEN,25,0,94,9,18,4,10,5,8,1,3,7,11,18,6,2,0,4,10,23
318,Trey Lyles,PF,23,DEN,64,2,1120,207,495,51,200,156,295,81,116,44,202,246,87,30,23,68,93,546
319,Scott Machado,PG,28,LAL,4,0,19,4,6,1,1,3,5,1,1,0,0,0,3,1,0,0,2,10
320,Shelvin Mack,PG,28,TOT,57,3,1246,163,403,46,130,117,273,58,84,18,86,104,183,47,4,66,84,430
321,Daryl Macon,SG,23,DAL,8,0,90,10,27,5,11,5,16,4,7,2,10,12,7,1,0,6,8,29
322,J.P. Macura,SG,23,CHO,2,0,17,3,9,0,4,3,5,0,0,0,3,3,2,0,0,0,0,6
323,Ian Mahinmi,C,32,WAS,34,6,498,47,104,3,16,44,88,42,61,48,80,128,25,25,16,21,84,139
325,Boban Marjanović,C,30,TOT,58,12,681,160,260,4,10,156,250,98,131,87,178,265,54,16,27,59,90,422
326,Lauri Markkanen,PF,21,CHI,52,51,1682,342,795,120,332,222,463,170,195,74,396,470,75,37,33,85,122,974
327,Jarell Martin,PF,24,ORL,42,1,328,43,104,20,57,23,47,9,11,11,62,73,18,3,8,11,51,115
328,Frank Mason,PG,24,SAC,38,0,435,71,169,14,64,57,105,39,57,6,37,43,84,16,4,36,34,195
329,Yante Maten,PF,22,MIA,2,0,13,1,4,0,1,1,3,0,0,1,2,3,0,1,0,0,0,2
331,Luc Mbah a Moute,PF,32,LAC,4,0,61,8,18,2,6,6,12,2,5,2,5,7,2,1,1,2,8,20
332,Tahjere McCall,SG,24,BRK,1,0,8,2,3,0,1,2,2,0,1,0,1,1,0,0,0,0,2,4
333,Patrick McCaw,SG,23,TOT,29,1,397,26,63,9,28,17,35,13,15,7,41,48,29,23,2,17,38,74
334,CJ McCollum,SG,27,POR,70,70,2375,571,1243,167,445,404,798,159,192,62,220,282,207,55,28,106,172,1468
335,T.J. McConnell,PG,26,PHI,76,3,1470,220,419,14,42,206,377,29,37,28,146,174,258,79,17,91,105,483
336,Doug McDermott,SF,27,IND,77,1,1340,207,422,84,206,123,216,66,79,17,92,109,67,18,8,42,104,564
337,JaVale McGee,C,31,LAL,75,62,1671,400,641,1,12,399,629,96,152,195,371,566,52,47,148,108,208,897
338,Rodney McGruder,SG,27,MIA,66,45,1550,186,461,79,225,107,236,52,72,60,178,238,112,36,12,64,115,503
339,Alfonzo McKinnie,SF,26,GSW,72,5,1003,134,275,42,118,92,157,27,48,81,166,247,31,18,15,30,134,337
340,Ben McLemore,SG,25,SAC,19,0,158,25,64,17,41,8,23,8,12,3,14,17,4,6,3,5,22,75
341,Jordan McRae,SG,27,WAS,27,0,333,61,130,10,35,51,95,28,35,6,34,40,30,13,7,15,26,160
342,Jodie Meeks,SG,31,TOR,8,0,104,21,39,8,18,13,21,1,1,1,11,12,8,1,1,2,5,51
343,Salah Mejri,C,32,DAL,36,4,399,55,112,11,34,44,78,20,32,36,95,131,35,10,26,21,55,141
344,De'Anthony Melton,PG,20,PHO,50,31,984,100,256,29,95,71,161,21,28,25,109,134,159,68,23,75,113,250
345,Chimezie Metu,PF,21,SAS,29,0,145,19,58,0,2,19,56,13,17,9,27,36,13,6,2,15,14,51
346,Khris Middleton,SF,27,MIL,77,77,2393,506,1148,179,474,327,674,216,258,50,411,461,331,80,7,174,172,1407
347,C.J. Miles,SF,31,TOT,53,1,856,112,311,67,203,45,108,48,58,13,82,95,36,26,15,30,79,339
348,Darius Miller,SF,28,NOP,69,15,1757,189,484,133,364,56,120,56,71,14,114,128,146,40,23,59,165,567
349,Malcolm Miller,SF,25,TOR,10,0,67,11,26,10,21,1,5,3,4,1,4,5,1,1,1,1,5,35
350,Patty Mills,PG,30,SAS,82,1,1908,282,663,159,404,123,259,88,103,24,158,182,245,49,10,93,129,811
351,Paul Millsap,PF,33,DEN,70,65,1895,322,665,58,159,264,506,181,249,153,352,505,141,83,54,95,183,883
352,Shake Milton,SG,22,PHI,20,0,268,34,87,14,44,20,43,5,7,9,26,35,18,8,8,6,29,87
353,Nikola Mirotić,PF,27,TOT,46,25,1245,238,542,116,318,122,224,105,124,60,279,339,55,31,34,48,107,697
354,Donovan Mitchell,SG,22,UTA,77,77,2598,661,1530,188,519,473,1011,319,396,59,257,316,322,106,31,218,208,1829
355,Naz Mitrou-Long,SG,25,UTA,14,0,84,6,20,2,11,4,9,2,2,1,5,6,15,1,1,8,10,16
356,Malik Monk,SG,20,CHO,73,0,1258,227,586,109,330,118,256,90,102,16,121,137,117,37,19,86,106,653
357,Greg Monroe,C,28,TOT,43,2,480,92,189,1,5,91,184,45,72,67,105,172,24,14,8,32,66,230
358,E'Twaun Moore,SG,29,NOP,53,36,1463,256,532,76,176,180,356,45,59,35,92,127,102,40,8,59,112,633
359,Eric Moreland,PF,27,TOT,5,0,43,3,7,1,1,2,6,0,0,4,16,20,4,1,1,5,9,7
360,Jaylen Morris,SG,23,MIL,4,0,29,4,10,1,3,3,7,1,2,0,5,5,4,2,0,1,1,10
361,Marcus Morris,PF,29,BOS,75,53,2091,377,844,146,389,231,455,146,173,76,382,458,109,43,25,92,181,1046
362,Markieff Morris,PF,29,TOT,58,16,1270,204,484,68,203,136,281,71,92,61,204,265,79,36,22,54,175,547
363,Monte Morris,PG,23,DEN,82,6,1970,346,702,94,227,252,475,65,81,35,159,194,297,73,4,52,102,851
364,Donatas Motiejūnas,PF,28,SAS,3,0,13,3,6,0,0,3,6,0,2,2,1,3,1,0,1,3,6,6
365,Johnathan Motley,PF,23,LAC,22,0,156,39,73,0,3,39,70,24,40,18,33,51,11,5,3,16,27,102
366,Emmanuel Mudiay,PG,22,NYK,59,42,1607,330,740,69,210,261,530,144,186,33,163,196,228,43,19,140,103,873
367,Jamal Murray,PG,21,DEN,75,74,2447,513,1173,152,414,361,759,189,223,65,252,317,363,67,27,158,153,1367
368,Džanan Musa,SG,19,BRK,9,0,39,9,22,1,10,8,12,0,2,1,4,5,2,2,0,4,1,19
369,Mike Muscala,PF,27,TOT,64,10,1306,145,361,89,256,56,105,70,85,57,187,244,76,22,38,48,130,449
370,Sviatoslav Mykhailiuk,SF,21,TOT,42,0,440,46,140,29,89,17,51,12,20,9,27,36,37,14,1,21,25,133
371,Abdel Nader,SF,25,OKC,61,1,694,91,215,32,100,59,115,27,36,14,102,116,20,20,12,26,68,241
372,Larry Nance,C,26,CLE,67,30,1795,249,479,33,98,216,381,96,134,168,384,552,214,100,40,97,192,627
373,Shabazz Napier,PG,27,BRK,56,2,983,169,435,76,228,93,207,115,138,18,82,100,143,41,16,66,67,529
374,Raul Neto,PG,26,UTA,37,1,474,74,161,20,60,54,101,28,33,6,56,62,93,14,4,35,49,196
375,Georges Niang,PF,25,UTA,59,0,516,86,181,43,105,43,76,20,24,11,76,87,35,10,6,23,57,235
376,Joakim Noah,C,33,MEM,42,1,693,110,213,0,1,110,212,78,109,58,180,238,89,20,31,50,96,298
377,Nerlens Noel,C,24,OKC,77,2,1055,162,276,0,0,162,276,54,79,127,198,325,45,66,96,48,166,378
378,Dirk Nowitzki,PF,40,DAL,51,20,795,135,376,64,205,71,171,39,50,5,153,158,35,9,18,18,76,373
379,Frank Ntilikina,PG,20,NYK,43,16,904,95,282,33,115,62,167,23,30,12,75,87,121,30,14,56,104,246
380,James Nunnally,SF,28,TOT,15,0,102,12,34,8,25,4,9,4,4,0,5,5,7,1,0,1,10,36
381,Jusuf Nurkić,C,24,POR,72,72,1974,420,826,3,29,417,797,282,365,243,505,748,233,71,103,168,250,1125
382,David Nwaba,SG,26,CLE,51,14,984,126,262,24,75,102,187,58,85,41,122,163,54,36,17,29,106,334
383,Royce O'Neale,SF,25,UTA,82,16,1671,163,343,68,176,95,167,32,42,22,263,285,124,54,24,70,172,426
384,Kyle O'Quinn,C,28,IND,45,3,371,69,136,1,12,68,124,17,21,29,90,119,56,9,25,31,68,156
385,Semi Ojeleye,PF,24,BOS,56,3,594,67,158,28,89,39,69,24,39,24,62,86,23,10,4,19,43,186
386,Jahlil Okafor,C,23,NOP,59,24,935,212,362,1,5,211,357,59,89,82,196,278,40,15,40,52,96,484
387,Élie Okobo,PG,21,PHO,53,16,958,114,290,39,132,75,158,37,47,12,86,98,127,32,7,69,109,304
388,Josh Okogie,SG,20,MIN,74,52,1757,196,508,60,215,136,293,118,162,41,177,218,91,88,33,63,166,570
389,Victor Oladipo,SG,26,IND,36,36,1147,249,588,74,216,175,372,103,141,21,181,202,186,60,11,82,72,675
390,Kelly Olynyk,PF,27,MIA,79,36,1812,261,564,113,319,148,245,152,185,72,303,375,140,53,37,114,183,787
391,Cedi Osman,SF,23,CLE,76,75,2444,360,844,130,374,230,470,141,181,45,312,357,195,60,11,114,195,991
392,Kelly Oubre,SF,23,TOT,69,19,1935,375,842,108,338,267,504,189,244,71,254,325,84,84,59,103,181,1047
393,Zaza Pachulia,C,34,DET,68,3,878,85,193,0,4,85,189,97,124,99,166,265,91,31,17,57,151,267
394,Jabari Parker,PF,23,TOT,64,17,1724,369,749,61,195,308,554,131,184,79,342,421,152,46,30,151,145,930
395,Tony Parker,PG,36,CHO,56,0,1003,213,463,13,51,200,412,91,124,14,69,83,207,21,7,75,53,530
396,Chandler Parsons,SF,30,MEM,25,3,496,68,182,29,94,39,88,22,25,4,66,70,43,19,5,32,45,187
397,Patrick Patterson,PF,29,OKC,63,5,861,82,219,46,137,36,82,19,30,42,105,147,31,16,13,22,46,229
398,Justin Patton,C,21,PHI,3,0,21,2,7,0,2,2,5,1,2,2,4,6,3,2,0,0,5,5
399,Chris Paul,PG,33,HOU,58,58,1857,302,720,127,355,175,365,175,203,36,229,265,473,114,18,152,146,906
400,Cameron Payne,PG,24,TOT,40,13,712,96,223,25,84,71,139,33,41,13,59,72,106,28,9,45,64,250
401,Elfrid Payton,PG,24,NOP,42,42,1250,179,412,33,105,146,307,55,74,49,171,220,320,44,17,112,81,446
402,Gary Payton,PG,26,WAS,3,0,16,5,8,1,2,4,6,0,0,1,1,2,4,3,1,1,2,11
403,Theo Pinson,SG,23,BRK,18,0,211,25,73,12,46,13,27,19,22,4,32,36,21,6,0,18,15,81
404,Mason Plumlee,C,28,DEN,82,17,1731,262,442,2,10,260,432,111,198,165,359,524,243,66,76,126,252,637
405,Miles Plumlee,C,30,ATL,18,0,173,32,48,0,0,32,48,16,30,16,23,39,17,6,4,10,14,80
406,Jakob Pöltl,C,23,SAS,77,24,1273,187,290,0,0,187,290,49,92,178,232,410,93,29,68,48,124,423
407,Quincy Pondexter,SF,30,SAS,53,0,292,29,58,6,18,23,40,34,42,8,38,46,24,11,1,13,24,98
408,Otto Porter,SF,25,TOT,56,43,1683,299,643,104,256,195,387,78,96,54,260,314,120,82,31,65,108,780
409,Bobby Portis,PF,23,TOT,50,28,1299,279,628,75,191,204,437,77,97,109,294,403,72,35,20,74,145,710
410,Dwight Powell,C,27,DAL,77,22,1662,290,486,39,127,251,359,196,254,140,271,411,112,44,50,67,201,815
411,Norman Powell,SG,25,TOR,60,3,1126,193,400,68,170,125,230,62,75,16,123,139,91,39,13,65,96,516
412,Alex Poythress,PF,25,ATL,21,1,305,40,81,9,23,31,58,18,29,29,47,76,17,4,10,13,47,107
413,Zhou Qi,PF,23,HOU,1,0,1,1,1,0,0,1,1,0,0,0,0,0,0,0,0,0,0,2
414,Ivan Rabb,PF,21,MEM,49,13,721,116,212,3,15,113,197,49,69,70,136,206,54,17,14,35,90,284
415,Chasson Randle,PG,25,WAS,49,2,743,91,217,46,115,45,102,43,62,10,46,56,97,25,3,43,91,271
416,Julius Randle,PF,24,NOP,73,49,2232,571,1089,67,195,504,894,356,487,162,472,634,229,52,45,208,246,1565
417,J.J. Redick,SG,34,PHI,76,63,2379,452,1027,240,605,212,422,228,255,20,166,186,206,32,17,101,129,1372
418,Davon Reed,SG,23,IND,10,0,47,5,12,2,4,3,8,0,0,2,4,6,3,1,0,1,3,12
419,Cameron Reynolds,SG,23,MIN,19,0,259,33,78,21,51,12,27,8,9,4,27,31,13,6,2,5,26,95
420,Josh Richardson,SG,25,MIA,73,73,2539,423,1026,164,460,259,566,199,231,54,209,263,298,79,34,113,200,1209
421,Malachi Richardson,SG,23,TOR,22,0,103,9,29,8,25,1,4,4,5,2,11,13,0,1,0,8,13,30
422,Austin Rivers,SG,26,TOT,76,15,2028,232,572,104,327,128,245,50,95,25,137,162,167,47,23,68,207,618
423,Devin Robinson,SF,23,WAS,7,0,95,19,32,0,2,19,30,9,14,6,14,20,6,4,6,2,11,47
424,Duncan Robinson,PF,24,MIA,15,1,161,18,46,10,35,8,11,4,6,2,17,19,5,5,0,4,11,50
425,Glenn Robinson,SF,25,DET,47,18,610,74,176,18,62,56,114,32,40,17,54,71,21,14,8,18,45,198
426,Jerome Robinson,SG,21,LAC,33,0,320,44,110,18,57,26,53,6,9,3,38,41,19,11,3,13,46,112
427,Mitchell Robinson,C,20,NYK,66,19,1360,202,291,0,0,202,291,81,135,177,246,423,37,52,161,35,217,485
428,Rajon Rondo,PG,32,LAL,46,29,1369,175,432,51,142,124,290,23,36,34,209,243,367,57,7,127,100,424
429,Derrick Rose,PG,30,MIN,51,13,1392,363,753,54,146,309,607,137,160,33,107,140,220,31,12,82,57,917
430,Terrence Ross,SG,27,ORL,81,0,2150,440,1027,217,566,223,461,126,144,27,253,280,135,72,29,90,119,1223
431,Terry Rozier,PG,24,BOS,79,14,1791,258,666,119,337,139,329,73,93,32,275,307,231,68,21,68,101,708
432,Ricky Rubio,PG,28,UTA,68,67,1899,295,730,79,254,216,476,195,228,33,210,243,416,91,10,180,180,864
433,D'Angelo Russell,PG,22,BRK,81,81,2448,659,1517,234,635,425,882,160,205,53,262,315,563,100,20,253,141,1712
434,Domantas Sabonis,C,22,IND,74,5,1838,413,700,9,17,404,683,208,291,186,504,690,212,48,30,160,239,1043
435,Brandon Sampson,SG,21,CHI,14,2,214,28,60,11,29,17,31,4,6,3,13,16,10,8,3,12,19,71
436,JaKarr Sampson,SF,25,CHI,4,0,127,29,54,5,14,24,40,17,21,5,27,32,4,4,3,4,8,80
437,Dario Šarić,PF,24,TOT,81,41,2023,304,696,118,323,186,373,132,150,126,331,457,127,45,9,97,182,858
438,Tomáš Satoranský,PG,27,WAS,80,54,2164,257,530,64,162,193,368,131,160,82,197,279,399,82,13,120,172,709
439,Dennis Schröder,PG,25,OKC,79,14,2314,457,1104,124,364,333,740,186,227,38,246,284,323,65,12,172,189,1224
440,Mike Scott,PF,30,TOT,79,3,1395,168,420,101,252,67,168,22,33,43,233,276,66,26,13,44,156,459
441,Thabo Sefolosha,SF,34,UTA,50,2,609,71,149,34,78,37,71,14,22,8,115,123,27,43,5,25,41,190
442,Wayne Selden,SG,24,TOT,75,13,1439,196,483,55,174,141,309,67,92,37,143,180,109,33,13,79,131,514
443,Collin Sexton,PG,20,CLE,82,72,2605,519,1206,119,296,400,910,214,255,57,179,236,243,44,6,185,186,1371
444,Landry Shamet,SG,21,TOT,79,27,1802,240,557,167,396,73,161,75,93,21,113,134,117,37,10,45,155,722
445,Iman Shumpert,SG,28,TOT,62,41,1481,167,446,95,273,72,173,36,45,27,156,183,112,59,24,50,127,465
446,Pascal Siakam,PF,24,TOR,80,79,2548,519,945,79,214,440,731,237,302,124,425,549,248,73,52,154,241,1354
447,Jordan Sibert,SG,26,ATL,1,0,4,1,1,1,1,0,0,0,0,0,0,0,0,0,0,0,0,3
448,Ben Simmons,PG,22,PHI,79,79,2700,540,960,0,6,540,954,257,428,172,525,697,610,112,61,274,209,1337
450,Kobi Simmons,PG,21,CLE,1,0,2,0,0,0,0,0,0,0,0,0,0,0,0,0,0,0,0,0
451,Anfernee Simons,SG,19,POR,20,1,141,28,63,10,29,18,34,9,16,3,10,13,13,1,0,11,9,75
452,Marcus Smart,SG,24,BOS,80,60,2200,239,567,126,346,113,221,104,129,57,177,234,321,143,28,123,201,708
453,Dennis Smith,PG,21,TOT,53,50,1508,278,650,67,208,211,442,99,156,32,123,155,252,67,20,154,129,722
454,Ish Smith,PG,30,DET,56,0,1251,205,489,44,135,161,354,47,62,23,122,145,203,28,11,61,109,501
455,J.R. Smith,SG,33,CLE,11,4,222,27,79,12,39,15,40,8,10,0,18,18,21,11,3,11,19,74
457,Zhaire Smith,SG,19,PHI,6,2,111,14,34,6,16,8,18,6,8,3,10,13,10,2,2,6,8,40
458,Tony Snell,SF,27,MIL,74,12,1304,163,361,81,204,82,157,37,42,29,128,157,68,26,18,23,90,444
459,Ray Spalding,PF,21,TOT,14,3,148,25,47,0,3,25,44,4,12,15,33,48,5,9,8,9,23,54
460,Omari Spellman,PF,21,ATL,46,11,805,98,244,44,128,54,116,32,45,72,122,194,47,26,25,31,67,272
461,Nik Stauskas,SG,25,TOT,68,0,1015,136,338,70,188,66,150,57,64,18,109,127,81,21,7,51,50,399
462,D.J. Stephens,SG,28,MEM,1,0,7,1,2,0,0,1,2,0,0,0,0,0,0,1,0,1,0,2
463,Lance Stephenson,SG,28,LAL,68,3,1123,184,432,73,197,111,235,50,73,32,183,215,140,41,7,86,111,491
464,Edmond Sumner,PG,23,IND,23,2,210,22,64,7,27,15,37,15,24,9,15,24,10,12,5,10,26,66
465,Caleb Swanigan,PF,21,TOT,21,0,178,18,53,1,7,17,46,6,9,17,47,64,11,6,1,18,28,43
466,Jayson Tatum,SF,20,BOS,79,79,2455,466,1036,116,311,350,725,195,228,70,407,477,168,84,57,122,168,1243
467,Jeff Teague,PG,30,MIN,42,41,1264,176,416,35,105,141,311,123,153,16,90,106,343,43,18,97,90,510
468,Garrett Temple,SG,32,TOT,75,55,2040,208,493,90,264,118,229,80,107,28,188,216,106,76,30,70,204,586
469,Miloš Teodosić,PG,31,LAC,15,0,150,17,40,10,27,7,13,4,7,3,13,16,32,3,1,21,27,48
470,Jared Terrell,SG,23,MIN,14,0,111,12,39,4,17,8,22,3,6,1,5,6,12,3,2,10,16,31
471,Emanuel Terry,PF,22,TOT,3,0,23,4,7,0,0,4,7,2,4,3,4,7,2,3,0,2,4,10
472,Daniel Theis,C,26,BOS,66,2,908,146,266,26,67,120,199,56,76,87,138,225,68,21,42,33,161,374
473,Isaiah Thomas,SG,29,DEN,12,0,181,34,99,12,43,22,56,17,27,5,8,13,23,5,1,18,17,97
474,Khyri Thomas,SG,22,DET,26,0,195,22,69,10,35,12,34,7,11,4,16,20,8,7,5,4,22,61
475,Lance Thomas,PF,30,NYK,46,17,783,78,197,22,79,56,118,27,36,21,96,117,27,17,7,24,83,205
476,Klay Thompson,SG,28,GSW,78,78,2652,655,1402,241,599,414,803,129,158,37,262,299,186,84,47,115,157,1680
477,Tristan Thompson,C,27,CLE,43,40,1198,201,380,0,0,201,380,68,106,173,265,438,86,28,16,59,89,470
478,Sindarius Thornwell,SG,24,LAC,64,1,313,17,49,3,15,14,34,25,34,5,39,44,18,14,7,20,41,62
479,Anthony Tolliver,PF,33,MIN,65,0,1079,99,259,81,215,18,44,47,60,15,162,177,46,17,21,36,91,326
480,Karl-Anthony Towns,C,23,MIN,77,77,2545,681,1314,142,355,539,959,376,450,263,691,954,259,67,125,240,292,1880
481,Gary Trent,SG,20,POR,15,1,111,16,50,5,21,11,29,3,7,1,10,11,5,1,2,4,4,40
482,Allonzo Trier,SG,23,NYK,64,3,1459,232,518,52,132,180,386,179,223,31,166,197,119,28,14,116,117,695
483,P.J. Tucker,PF,33,HOU,82,82,2802,207,523,146,387,61,136,41,59,121,358,479,96,132,39,63,252,601
484,Evan Turner,PG,30,POR,73,2,1605,204,443,11,52,193,391,75,106,37,291,328,283,33,18,114,110,494
485,Myles Turner,C,22,IND,74,74,2119,380,780,76,196,304,584,148,201,101,430,531,115,60,199,100,195,984
486,Ekpe Udoh,C,31,UTA,51,1,320,50,72,0,0,50,72,19,30,27,63,90,28,10,31,13,36,119
487,Tyler Ulis,PG,23,CHI,1,0,1,0,0,0,0,0,0,0,0,0,0,0,0,0,0,0,0,0
488,Jonas Valančiūnas,C,26,TOT,49,27,1091,301,538,14,48,287,490,147,185,106,313,419,70,19,53,90,146,763
489,Jarred Vanderbilt,PF,19,DEN,17,0,69,9,19,0,1,9,18,6,10,7,16,23,3,6,1,8,8,24
490,Fred VanVleet,PG,24,TOR,64,28,1760,246,600,112,296,134,304,97,115,21,146,167,307,57,20,82,110,701
491,Noah Vonleh,PF,23,NYK,68,57,1722,207,440,46,137,161,303,111,156,113,415,528,129,46,51,88,174,571
492,Nikola Vučević,C,28,ORL,80,80,2510,701,1354,84,231,617,1123,179,227,224,736,960,307,81,89,159,157,1665
493,Dwyane Wade,SG,37,MIA,72,2,1885,416,960,86,261,330,699,165,233,69,216,285,301,59,38,166,118,1083
494,Moritz Wagner,C,21,LAL,43,5,446,71,171,22,77,49,94,43,53,17,68,85,24,11,13,39,57,207
495,Dion Waiters,SG,27,MIA,44,28,1138,198,478,109,289,89,189,22,44,7,109,116,121,29,9,64,72,527
496,Kemba Walker,PG,28,CHO,82,82,2863,731,1684,260,731,471,953,380,450,52,309,361,484,102,34,211,131,2102
497,Lonnie Walker,SG,20,SAS,17,0,118,16,46,5,13,11,33,8,10,0,17,17,9,7,3,4,7,45
498,John Wall,PG,28,WAS,32,32,1104,245,552,51,169,194,383,122,175,15,101,116,279,49,29,121,71,663
499,Tyrone Wallace,PG,24,LAC,62,0,628,92,217,4,19,88,198,30,57,20,81,101,42,21,7,36,83,218
500,Taurean Waller-Prince,SF,24,ATL,55,47,1552,262,594,123,315,139,279,95,116,22,177,199,118,53,19,100,141,742
501,Brad Wanamaker,PG,29,BOS,36,0,343,50,105,16,39,34,66,24,28,3,38,41,56,12,2,19,34,140
502,T.J. Warren,SF,25,PHO,43,36,1360,297,611,77,180,220,431,101,124,31,143,174,64,51,29,52,119,772
503,Julian Washburn,SF,27,MEM,18,3,254,16,48,5,24,11,24,3,4,8,33,41,14,13,2,7,16,40
504,Yuta Watanabe,SF,24,MEM,15,0,174,15,51,2,16,13,35,7,10,4,27,31,8,4,1,6,11,39
505,Thomas Welsh,C,22,DEN,11,0,36,7,13,3,7,4,6,1,2,0,4,4,5,0,0,1,3,18
506,Russell Westbrook,PG,30,OKC,73,73,2630,630,1473,119,411,511,1062,296,451,109,698,807,784,142,33,325,245,1675
507,Derrick White,PG,24,SAS,67,55,1728,260,543,48,142,212,401,95,123,35,212,247,263,67,47,97,145,663
508,Okaro White,PF,26,WAS,3,0,6,0,2,0,2,0,0,0,0,1,1,2,0,0,0,0,0,0
509,Hassan Whiteside,C,29,MIA,72,53,1674,388,680,2,16,386,664,109,243,257,560,817,56,46,136,97,192,887
510,Andrew Wiggins,SF,23,MIN,73,73,2543,498,1209,118,348,380,861,207,296,83,269,352,184,70,48,138,153,1321
511,Alan Williams,PF,26,BRK,5,0,26,8,13,0,1,8,12,2,4,4,15,19,3,1,0,1,2,18
512,C.J. Williams,SG,28,MIN,15,0,128,17,35,5,16,12,19,0,1,1,7,8,12,6,0,5,16,39
513,Johnathan Williams,C,23,LAL,24,0,372,65,110,0,2,65,108,27,48,48,51,99,13,8,7,16,62,157
514,Kenrich Williams,SF,24,NOP,46,29,1079,107,279,52,156,55,123,13,19,55,164,219,83,45,19,36,95,279
515,Lou Williams,SG,32,LAC,75,1,1993,484,1138,105,291,379,847,425,485,40,182,222,402,57,11,181,80,1498
516,Marvin Williams,PF,32,CHO,75,75,2133,275,652,140,382,135,270,66,86,76,331,407,92,71,61,47,156,756
517,Robert Williams,C,21,BOS,32,2,283,36,51,0,0,36,51,9,15,27,54,81,7,9,40,10,36,81
518,Troy Williams,SF,24,SAC,21,0,312,44,98,14,44,30,54,9,15,12,47,59,11,10,8,9,37,111
519,D.J. Wilson,PF,22,MIL,48,3,882,104,251,46,127,58,124,26,47,45,177,222,52,18,20,32,85,280
520,Justise Winslow,SF,22,MIA,66,52,1959,324,749,96,256,228,493,86,137,63,292,355,282,72,19,142,177,830
521,Christian Wood,PF,23,TOT,21,2,251,61,117,9,26,52,91,41,56,17,66,83,8,7,10,17,17,172
522,Delon Wright,PG,26,TOT,75,13,1699,242,558,50,168,192,390,119,150,68,198,266,248,88,30,77,103,653
523,Guerschon Yabusele,PF,23,BOS,41,1,251,35,77,9,28,26,49,15,22,23,30,53,15,8,7,15,32,94
524,Nick Young,SG,33,DEN,4,0,37,3,9,3,8,0,1,0,0,0,1,1,2,0,1,2,4,9
525,Thaddeus Young,PF,30,IND,81,81,2489,443,841,51,146,392,695,87,135,192,331,523,204,123,36,123,194,1024
526,Trae Young,PG,20,ATL,81,81,2503,525,1256,156,482,369,774,343,414,64,237,301,653,72,15,308,140,1549
527,Cody Zeller,C,26,CHO,49,47,1243,190,345,6,22,184,323,111,141,110,223,333,102,38,41,62,164,497
528,Tyler Zeller,C,29,TOT,6,1,93,16,30,0,1,16,29,14,18,11,13,24,4,1,3,4,20,46
529,Ante Žižić,C,22,CLE,59,25,1082,183,331,0,0,183,331,93,132,108,212,320,53,13,22,61,113,459
530,Ivica Zubac,C,21,TOT,59,37,1040,212,379,0,0,212,379,101,126,115,247,362,63,14,51,70,137,525
