Rk,Player,Pos,Age,Tm,G,GS,MP,FG,FGA,3P,3PA,2P,2PA,FT,FTA,ORB,DRB,TRB,AST,STL,BLK,TOV,PF,PTS
1,Mahmoud Abdul-Rauf,PG,31,VAN,41,0,486,120,246,4,14,116,232,22,29,5,20,25,76,9,1,26,50,266
2,Tariq Abdul-Wahad,SG,26,DEN,29,12,420,43,111,4,10,39,101,21,36,14,45,59,22,14,13,34,54,111
3,Shareef Abdur-Rahim,SF,24,VAN,81,81,3241,604,1280,12,64,592,1216,443,531,175,560,735,250,90,77,231,238,1663
4,Cory Alexander,PG,27,ORL,26,0,227,18,56,4,16,14,40,12,18,0,25,25,36,16,0,25,29,52
5,Courtney Alexander,PG,23,TOT,65,24,1382,239,573,17,46,222,527,123,150,42,101,143,62,45,5,75,139,618
6,Ray Allen*,SG,25,MIL,82,82,3129,628,1309,202,467,426,842,348,392,101,327,428,374,124,20,204,192,1806
7,Rafer Alston,PG,24,MIL,37,2,288,30,84,8,30,22,54,9,13,4,27,31,68,13,0,20,27,77
8,John Amaechi,C,30,ORL,82,36,1710,237,592,0,7,237,585,176,279,77,191,268,74,28,29,124,175,650
9,Derek Anderson,SG,26,SAS,82,82,2859,413,993,101,253,312,740,342,402,75,288,363,301,120,14,165,188,1269
10,Kenny Anderson,PG,30,BOS,33,28,849,88,227,11,33,77,194,59,71,16,57,73,134,44,2,52,62,246
11,Nick Anderson,SG,33,SAC,21,0,169,14,57,10,39,4,18,0,0,3,22,25,13,10,4,7,13,38
12,Shandon Anderson,SG,27,HOU,82,82,2396,263,590,46,170,217,420,138,188,72,261,333,189,82,40,131,202,710
13,Greg Anthony,PG,33,POR,58,0,856,97,253,65,159,32,94,23,35,21,40,61,82,40,3,43,63,282
14,Darrell Armstrong,PG,32,ORL,75,75,2767,413,1002,143,403,270,599,220,249,94,249,343,524,135,13,200,155,1189
15,Chucky Atkins,PG,26,DET,81,75,2363,380,952,121,339,259,613,90,130,28,145,173,330,67,5,149,184,971
16,Stacey Augmon,SG,32,POR,66,23,1182,127,266,0,4,127,262,57,87,60,99,159,98,48,21,48,105,311
17,Isaac Austin,C,31,VAN,52,16,845,96,270,6,24,90,246,28,40,50,172,222,58,20,23,54,94,226
18,William Avery,PG,21,MIN,55,0,463,55,144,16,59,39,85,28,36,5,24,29,75,13,4,45,48,154
19,Dalibor Bagarić,C,20,CHI,35,0,259,17,65,0,1,17,64,13,28,22,34,56,10,9,16,21,44,47
20,Vin Baker,PF,29,SEA,76,27,2129,347,822,1,16,346,806,232,321,179,251,430,90,38,73,158,264,927
21,Erick Barkley,PG,22,POR,8,0,38,8,22,3,8,5,14,0,0,0,3,3,6,2,0,5,2,19
22,Dana Barros,PG,33,DET,60,0,1079,183,412,44,105,139,307,68,80,6,88,94,110,30,2,60,63,478
23,Brent Barry,SG,29,SEA,67,20,1778,198,401,109,229,89,172,84,103,33,178,211,225,80,14,86,126,589
24,Jon Barry,SG,31,SAC,62,2,1010,103,255,46,132,57,123,64,73,16,78,94,130,28,6,53,66,316
25,Tony Battie,C,24,BOS,40,25,845,108,201,0,3,108,198,44,69,73,160,233,16,27,60,37,126,260
26,Raja Bell,SG,24,PHI,5,0,30,2,7,1,3,1,4,0,0,0,1,1,0,1,0,2,1,5
27,Jonathan Bender,SF,20,IND,59,7,574,66,186,11,41,55,145,50,68,14,60,74,32,7,28,42,73,193
28,Corey Benjamin,PG,22,CHI,65,5,857,115,302,21,81,94,221,56,83,38,62,100,69,28,16,63,128,307
29,David Benoit,SF,32,UTA,49,2,446,71,147,5,13,66,134,31,39,20,61,81,22,6,6,28,75,178
30,Travis Best,PG,28,IND,77,21,2457,347,788,37,97,310,691,187,226,38,184,222,473,110,11,127,246,918
31,Mike Bibby,PG,22,VAN,82,82,3190,525,1157,108,285,417,872,143,188,47,257,304,685,107,12,248,148,1301
32,Chauncey Billups,SG,24,MIN,77,33,1790,248,587,73,194,175,393,144,171,32,126,158,260,51,11,111,178,713
33,Mookie Blaylock,PG,33,GSW,69,59,2352,317,801,73,225,244,576,53,76,71,201,272,462,163,20,128,134,760
34,Corie Blount,PF,32,TOT,68,6,1305,130,294,2,8,128,286,51,83,181,219,400,59,42,22,73,165,313
35,Mark Blount,C,25,BOS,64,50,1098,101,200,0,0,101,200,46,66,97,134,231,32,39,76,62,183,248
36,Muggsy Bogues,PG,36,TOR,3,0,34,0,2,0,1,0,1,0,0,0,3,3,5,2,0,4,3,0
37,Etdrick Bohannon,PF,27,CLE,6,0,19,2,4,0,0,2,4,4,4,3,4,7,0,0,2,1,4,8
38,Calvin Booth,C,24,TOT,55,29,933,120,252,0,0,120,252,53,78,77,169,246,42,29,111,53,146,293
39,Cal Bowdler,SF,23,ATL,44,0,375,53,114,1,5,52,109,33,40,30,47,77,4,10,21,11,45,140
40,Bruce Bowen,SF,29,MIA,82,72,2685,211,581,103,307,108,274,98,161,45,200,245,132,83,53,74,269,623
41,Ryan Bowen,SF,25,DEN,57,0,696,80,144,4,11,76,133,27,44,62,51,113,30,37,12,24,95,191
42,Ira Bowman,PG,27,ATL,3,0,19,0,2,0,0,0,2,0,0,1,1,2,7,0,0,1,0,0
43,Earl Boykins,PG,24,LAC,10,0,149,25,63,1,8,24,55,14,17,4,7,11,32,5,0,9,9,65
44,Shawn Bradley,C,28,DAL,82,35,2001,219,447,1,6,218,441,140,178,160,448,608,38,36,228,88,256,579
45,Elton Brand,PF,21,CHI,74,74,2906,578,1215,0,2,578,1213,334,472,285,461,746,240,71,118,219,243,1490
46,Terrell Brandon,PG,30,MIN,78,78,2821,511,1134,33,91,478,1043,195,224,60,238,298,583,161,21,155,138,1250
47,Chucky Brown,SF,32,TOT,26,2,339,40,95,0,3,40,92,22,34,8,46,54,11,9,7,8,37,102
48,Dee Brown,PG,32,ORL,7,0,155,16,44,12,32,4,12,4,5,0,11,11,12,4,0,7,10,48
49,P.J. Brown,C,31,CHH,80,79,2811,249,561,0,4,249,557,178,209,257,485,742,127,78,92,108,260,676
50,Randy Brown,PG,32,BOS,54,35,1238,100,237,0,3,100,234,23,40,23,76,99,154,62,10,56,132,223
51,Rick Brunson,PG,28,TOT,22,0,208,18,54,2,14,16,40,8,15,5,16,21,31,8,1,17,21,46
52,Kobe Bryant,SG,22,LAL,68,68,2783,701,1510,61,200,640,1310,475,557,104,295,399,338,114,43,220,222,1938
53,Mark Bryant,PF,35,DAL,18,1,101,8,20,0,0,8,20,3,5,4,17,21,3,1,2,5,29,19
54,Greg Buckner,SG,24,DAL,37,9,820,84,192,2,7,82,185,59,81,60,97,157,49,33,9,27,118,229
55,Jud Buechler,SF,32,DET,57,3,737,76,164,32,77,44,87,9,12,20,74,94,39,21,10,25,83,193
56,Rodney Buford,SF,23,PHI,47,0,573,104,241,16,38,88,203,24,29,16,58,74,17,17,6,29,68,248
57,Matt Bullard,PF,33,HOU,61,5,1000,129,305,86,213,43,92,10,14,22,108,130,42,10,9,12,76,354
58,Scott Burrell,SF,30,CHH,4,0,41,7,15,2,6,5,9,1,4,1,2,3,1,3,0,0,8,17
59,Jason Caffey,PF,27,MIL,70,33,1460,179,367,0,0,179,367,142,211,135,218,353,53,38,25,77,184,500
60,Marcus Camby,C,26,NYK,63,63,2127,304,580,1,8,303,572,150,225,196,527,723,52,66,136,63,205,759
61,Elden Campbell,PF,32,CHH,78,78,2337,367,834,0,6,367,828,288,406,157,451,608,104,60,140,144,280,1022
62,Brian Cardinal,PF,23,DET,15,0,126,10,31,0,5,10,26,11,18,8,15,23,3,7,2,9,27,31
63,Chris Carr,SG,26,BOS,35,0,309,53,112,17,37,36,75,46,60,11,33,44,11,4,3,19,45,169
64,Anthony Carter,PG,25,MIA,72,6,1630,195,480,6,40,189,440,65,103,46,134,180,268,73,10,119,154,461
65,Vince Carter,SF,24,TOR,75,75,2979,762,1656,162,397,600,1259,384,502,176,240,416,291,114,82,167,205,2070
66,Sam Cassell,PG,31,MIL,76,75,2709,537,1132,30,98,507,1034,277,323,46,244,290,580,88,8,220,214,1381
67,Kelvin Cato,C,26,HOU,35,13,624,64,111,0,0,64,111,37,57,47,94,141,11,13,31,25,89,165
68,Duane Causwell,C,32,MIA,31,14,384,32,85,0,0,32,85,12,25,23,60,83,5,8,18,23,67,76
69,Cedric Ceballos,SF,31,TOT,40,0,559,101,229,22,73,79,156,37,43,34,72,106,20,16,7,32,61,261
70,Calbert Cheaney,SG,29,DEN,9,5,153,10,30,0,0,10,30,1,2,5,15,20,9,4,2,5,14,21
71,Chris Childs,PG,33,TOT,77,5,1859,135,335,32,106,103,229,60,71,24,178,202,355,59,15,156,242,362
72,Doug Christie,SG,30,SAC,81,81,2939,311,788,94,250,217,538,280,312,95,260,355,289,183,45,154,224,996
73,Keon Clark,PF,25,TOT,81,3,1720,249,519,0,1,249,518,142,240,136,298,434,72,32,154,90,244,640
74,Mateen Cleaves,PG,23,DET,78,8,1268,160,400,5,17,155,383,97,137,26,106,132,207,49,1,139,153,422
75,John Coker,C,29,GSW,6,0,32,1,8,0,0,1,8,0,0,3,2,5,2,1,0,2,4,2
76,Derrick Coleman,PF,33,CHH,34,3,683,97,255,20,51,77,204,63,92,46,138,184,39,10,21,42,53,277
77,Bimbo Coles,PG,32,CLE,47,0,804,91,239,2,16,89,223,48,56,9,39,48,138,27,6,59,87,232
78,Jason Collier,C,23,HOU,23,0,222,27,71,0,1,27,70,17,24,12,25,37,6,2,3,11,27,71
79,Sean Colson,PG,25,TOT,13,0,44,6,24,1,5,5,19,2,4,2,4,6,10,1,0,2,6,15
80,Tyrone Corbin,SF,38,TOR,15,1,117,9,38,0,5,9,33,2,4,3,10,13,4,2,0,3,18,20
81,Chris Crawford,PF,25,ATL,47,22,901,122,270,6,22,116,248,68,83,28,82,110,37,21,16,62,117,318
82,Jamal Crawford,PG,20,CHI,61,8,1050,107,304,41,117,66,187,27,34,9,80,89,141,43,14,85,68,282
83,Austin Croshere,PF,25,IND,81,23,1874,276,701,70,207,206,494,200,231,123,264,387,92,36,50,136,180,822
84,John Crotty,PG,31,UTA,31,0,264,22,65,4,7,18,58,17,19,13,15,28,34,6,0,19,32,65
85,Vonteego Cummings,PG,24,GSW,66,11,1495,178,517,48,143,130,374,79,116,47,90,137,227,67,14,91,160,483
86,Bill Curley,PF,28,TOT,20,2,192,25,47,1,2,24,45,12,19,21,16,37,3,7,9,16,45,63
87,Dell Curry,SG,36,TOR,71,1,956,162,382,62,145,100,237,43,51,16,69,85,75,27,8,39,66,429
88,Michael Curry,SG,32,DET,68,58,1485,145,319,4,9,141,310,62,73,21,100,121,132,27,3,61,173,356
89,Erick Dampier,C,25,GSW,43,26,1038,126,314,0,2,126,312,67,126,97,153,250,59,17,58,82,123,319
90,Antonio Daniels,PG,25,SAS,79,23,2060,275,588,74,183,201,405,121,156,26,137,163,304,61,14,109,120,745
91,Kornél Dávid,SF,29,TOT,27,0,209,25,51,0,0,25,51,12,13,15,37,52,7,6,4,11,28,62
92,Antonio Davis,C,32,TOR,78,77,2729,375,866,0,1,375,865,319,423,274,513,787,106,22,151,135,230,1069
93,Baron Davis,PG,21,CHH,82,82,3192,409,957,85,274,324,683,228,337,129,279,408,598,170,36,226,267,1131
94,Dale Davis,C,31,POR,81,43,2162,242,487,0,4,242,483,96,152,233,373,606,103,44,76,67,199,580
95,Emanual Davis,SG,32,SEA,62,39,1290,133,318,50,127,83,191,45,55,28,126,154,137,64,12,77,101,361
96,Hubert Davis,PG,30,TOT,66,18,1692,196,433,78,171,118,262,54,62,28,111,139,110,35,1,81,121,524
97,Ricky Davis,SG,21,MIA,7,0,70,12,29,1,1,11,28,7,8,1,6,7,11,5,2,5,7,32
98,Terry Davis,PF,33,DEN,19,1,228,12,25,0,0,12,25,9,22,24,29,53,7,1,1,5,34,33
99,Todd Day,SG,31,MIN,31,0,345,44,118,26,69,18,49,18,23,10,27,37,28,10,7,24,52,132
100,Andrew DeClercq,C,27,ORL,67,51,903,107,193,0,0,107,193,47,82,91,145,236,32,41,33,51,198,261
101,Vinny Del Negro,PG,34,TOT,65,1,922,106,234,1,13,105,221,41,44,12,70,82,126,26,3,34,78,254
102,Tony Delk,SG,27,PHO,82,11,2288,383,923,54,168,329,755,185,235,76,185,261,160,75,17,101,171,1005
103,Derrick Dial,SG,25,SAS,33,0,207,36,83,2,10,34,73,12,21,12,26,38,21,4,6,12,22,86
104,Michael Dickerson,SG,25,VAN,70,69,2618,425,1020,86,230,339,790,206,270,70,159,229,233,62,27,162,207,1142
105,Vlade Divac*,C,32,SAC,81,81,2420,364,755,4,14,360,741,242,350,207,466,673,231,87,93,192,242,974
106,Michael Doleac,C,23,ORL,77,21,1398,220,527,0,3,220,524,50,59,70,203,273,65,37,41,59,239,490
107,Keyon Dooling,PG,20,LAC,76,1,1237,148,362,28,80,120,282,125,179,8,81,89,177,41,11,94,107,449
108,Sherman Douglas,PG,34,NJN,59,7,1094,122,303,8,40,114,263,86,115,21,53,74,144,36,4,79,93,338
109,Bryce Drew,PG,26,CHI,48,41,1305,124,327,40,105,84,222,14,19,12,57,69,185,32,3,68,99,302
110,Chris Dudley,C,35,PHO,53,33,613,29,73,0,0,29,73,14,36,64,119,183,18,14,29,26,111,72
111,Tim Duncan,PF,24,SAS,82,82,3174,702,1406,7,27,695,1379,409,662,259,738,997,245,70,192,242,247,1820
112,Tyus Edney,PG,27,IND,24,0,263,35,91,1,6,34,85,35,39,5,19,24,54,17,0,25,17,106
113,Kevin Edwards,SG,35,VAN,46,5,634,56,170,5,19,51,151,43,53,23,59,82,52,29,8,37,46,160
114,Howard Eisley,SG,28,DAL,82,40,2426,265,675,107,269,158,406,104,126,23,174,197,295,99,12,102,218,741
115,Obinna Ekezie,PF,25,TOT,33,0,281,32,81,0,0,32,81,37,53,31,47,78,9,5,5,14,48,101
116,Khalid El-Amin,PG,21,CHI,50,14,936,115,311,28,84,87,227,56,72,21,60,81,145,48,2,54,99,314
117,Mario Elie,SG,37,PHO,68,67,1506,104,246,36,100,68,146,55,69,38,117,155,131,58,12,60,112,299
118,Sean Elliott,SF,32,SAS,52,34,1229,147,339,55,129,92,210,60,84,17,153,170,81,23,25,51,80,409
119,LaPhonso Ellis,PF,30,MIN,82,5,1948,298,642,7,22,291,620,169,214,199,295,494,93,67,74,108,290,772
120,Pervis Ellison,C,33,SEA,9,0,40,2,7,0,0,2,7,2,2,2,10,12,3,0,2,3,13,6
121,Evan Eschmeyer,C,25,NJN,74,51,1331,92,200,0,0,92,200,67,102,135,231,366,40,41,58,53,220,251
122,Patrick Ewing*,C,38,SEA,79,79,2107,294,684,0,2,294,682,172,251,124,461,585,92,53,91,151,229,760
123,Jamie Feick,C,26,NJN,6,0,149,8,23,0,0,8,23,6,12,12,44,56,5,8,3,7,15,22
124,Danny Ferry,SF,34,SAS,80,29,1688,178,375,70,156,108,219,22,30,55,168,223,71,28,21,50,169,448
125,Michael Finley,SF,27,DAL,82,82,3443,711,1552,91,263,620,1289,252,325,109,316,425,360,118,32,190,174,1765
126,Derek Fisher,PG,26,LAL,20,20,709,77,187,25,63,52,124,50,62,5,54,59,87,39,2,29,50,229
127,Marcus Fizer,PF,22,CHI,72,13,1580,278,646,10,39,268,607,117,161,76,237,313,76,30,19,124,175,683
128,Danny Fortson,PF,24,GSW,6,6,203,29,50,0,0,29,50,42,54,29,69,98,5,2,0,10,22,100
129,Greg Foster,C,32,LAL,62,8,451,56,133,3,9,53,124,10,14,29,83,112,32,9,12,25,76,125
130,Jeff Foster,C,24,IND,71,9,1152,100,213,2,7,98,206,47,91,144,245,389,33,39,28,52,152,249
131,Rick Fox,SF,31,LAL,82,77,2291,287,646,118,300,169,346,95,122,80,245,325,262,70,29,136,225,787
132,Adonal Foyle,C,25,GSW,58,37,1457,156,375,0,0,156,375,30,68,156,249,405,48,31,156,79,136,342
133,Steve Francis,PG,23,HOU,80,79,3194,550,1219,133,336,417,883,358,438,190,363,553,517,141,31,265,274,1591
134,Todd Fuller,C,26,MIA,10,0,77,10,35,0,0,10,35,8,8,7,11,18,1,3,2,3,10,28
135,Lawrence Funderburke,PF,30,SAC,59,2,698,120,242,0,0,120,242,48,77,74,122,196,17,9,13,32,44,288
136,Rubén Garcés,PF,27,TOT,13,0,73,7,22,0,0,7,22,2,8,16,13,29,5,3,2,5,14,16
137,Chris Garner,PG,25,GSW,8,0,149,7,37,0,7,7,30,5,6,2,10,12,18,7,1,9,18,19
138,Kevin Garnett,PF,24,MIN,81,81,3202,704,1475,19,66,685,1409,357,467,219,702,921,401,111,145,230,204,1784
139,Dean Garrett,C,34,MIN,70,21,831,75,156,0,0,75,156,27,39,65,152,217,24,26,49,25,93,177
140,Pat Garrity,SF,24,ORL,76,1,1579,223,576,97,224,126,352,85,98,51,159,210,51,40,15,68,241,628
141,Chris Gatling,PF,33,CLE,74,6,1670,329,733,28,92,301,641,156,228,99,292,391,61,52,27,119,185,842
142,Matt Geiger,C,31,PHI,35,4,542,88,224,0,2,88,222,37,54,50,89,139,14,12,8,25,73,213
143,Devean George,SF,23,LAL,59,1,593,64,207,15,68,49,139,39,55,35,75,110,19,15,15,34,87,182
144,Eddie Gill,PG,22,NJN,8,0,152,16,41,3,9,13,32,4,5,0,9,9,24,4,1,10,9,39
145,Kendall Gill,SG,32,NJN,31,26,892,107,323,4,14,103,309,65,90,32,99,131,87,47,7,48,64,283
146,Dion Glover,SG,22,ATL,57,7,929,141,336,9,46,132,290,47,69,39,92,131,69,49,10,54,92,338
147,Anthony Goldwire,PG,29,DEN,20,0,201,30,80,9,34,21,46,13,17,1,11,12,34,9,0,15,13,82
148,Steve Goodrich,PF,24,CHI,12,0,133,7,18,1,3,6,15,4,7,7,14,21,6,2,1,8,14,19
149,Brian Grant,C,28,MIA,82,79,2771,484,1010,0,1,484,1009,282,354,217,501,718,101,60,71,170,293,1250
150,Gary Grant,PG,35,POR,4,0,17,5,7,0,0,5,7,0,0,0,0,0,1,0,0,0,1,10
151,Horace Grant,PF,35,LAL,77,77,2390,263,569,0,3,263,566,131,169,220,325,545,121,51,61,48,181,657
152,A.C. Green,PF,37,MIA,82,1,1411,144,324,0,6,144,318,79,111,107,206,313,39,30,8,45,119,367
153,Adrian Griffin,SF,26,BOS,44,0,377,33,97,9,26,24,71,18,24,27,60,87,27,18,5,18,45,93
154,Tom Gugliotta,PF,31,PHO,57,2,1159,149,380,3,12,146,368,61,77,76,179,255,55,47,21,51,110,362
155,A.J. Guyton,PG,22,CHI,33,8,630,78,192,27,69,51,123,15,18,10,26,36,64,9,5,24,35,198
156,Darvin Ham,SF,27,MIL,29,13,540,39,80,2,3,37,77,29,49,56,65,121,25,17,21,33,85,109
157,Richard Hamilton,SF,22,WAS,78,42,2519,547,1249,40,146,507,1103,277,319,75,163,238,224,75,10,201,203,1411
158,Zendon Hamilton,C,25,LAC,3,0,19,2,9,0,0,2,9,5,8,3,5,8,0,0,0,2,4,9
159,Tom Hammonds,PF,33,MIN,7,0,30,3,10,0,0,3,10,1,2,2,2,4,1,0,0,3,8,7
160,Anfernee Hardaway,SG,29,PHO,4,4,112,15,36,2,8,13,28,7,11,5,13,18,15,6,1,3,6,39
161,Tim Hardaway,PG,34,MIA,77,77,2613,408,1042,189,517,219,525,145,181,26,178,204,483,90,6,189,155,1150
162,Ron Harper,PG,37,LAL,47,46,1139,127,271,19,72,108,199,34,48,46,120,166,113,39,25,62,70,307
163,Matt Harpring,SG,24,CLE,56,55,1615,238,524,13,52,225,472,134,165,90,152,242,102,42,17,90,161,623
164,Al Harrington,PF,20,IND,78,38,1892,241,543,1,7,240,536,103,157,119,262,381,130,63,18,148,223,586
165,Othella Harrington,C,27,TOT,74,45,1815,247,507,0,3,247,504,171,224,139,249,388,56,34,45,145,237,665
166,Lucious Harris,SG,30,NJN,73,50,2071,265,624,46,132,219,492,107,139,71,217,288,135,74,16,64,127,683
167,Jason Hart,PG,22,MIL,1,0,10,1,1,0,0,1,1,0,0,0,0,0,1,0,0,2,0,2
168,Antonio Harvey,PF,30,POR,12,0,72,13,28,0,0,13,28,5,6,5,9,14,4,1,6,3,10,31
169,Donnell Harvey,PF,20,DAL,18,0,65,8,14,0,0,8,14,6,16,6,14,20,2,3,1,7,15,22
170,Hersey Hawkins,SG,34,CHH,59,0,681,56,137,17,46,39,91,54,63,17,63,80,72,33,9,19,45,183
171,Michael Hawkins,PG,28,CLE,10,0,76,3,9,2,4,1,5,0,0,2,3,5,13,2,0,6,13,8
172,Alan Henderson,PF,28,ATL,73,42,1810,298,671,0,1,298,670,173,271,180,226,406,50,51,29,126,164,769
173,Cedric Henderson,SF,25,CLE,55,10,961,102,262,1,8,101,254,30,46,19,71,90,79,29,23,63,101,235
174,Chris Herren,PG,25,BOS,25,7,408,29,96,16,55,13,41,9,12,4,17,21,56,14,0,20,43,83
175,Grant Hill*,SF,28,ORL,4,4,133,19,43,1,1,18,42,16,26,8,17,25,25,5,2,11,9,55
176,Tyrone Hill,PF,32,PHI,76,75,2363,278,587,0,1,278,586,172,273,239,448,687,48,37,27,127,242,728
177,Fred Hoiberg,SG,28,CHI,74,37,2247,217,495,103,250,114,245,136,157,21,287,308,263,98,12,74,155,673
178,Robert Horry,PF,30,LAL,79,1,1587,147,380,54,156,93,224,59,83,93,203,296,128,54,54,79,210,407
179,Eddie House,PG,22,MIA,50,0,550,104,247,19,55,85,192,24,35,5,37,42,52,13,0,35,58,251
180,Allan Houston,SG,29,NYK,78,78,2858,542,1208,96,252,446,956,279,307,20,263,283,173,52,10,161,190,1459
181,Juwan Howard,PF,27,TOT,81,81,2974,583,1218,0,3,583,1215,296,383,171,401,572,224,75,37,242,292,1462
182,Troy Hudson,PG,24,ORL,75,7,1008,125,372,22,109,103,263,85,104,38,67,105,162,37,3,92,82,357
183,Larry Hughes,SG,22,GSW,50,45,1846,308,805,14,75,294,730,193,252,76,200,276,223,96,29,152,147,823
184,Lindsey Hunter,PG,30,MIL,82,5,2002,298,783,152,407,146,376,77,96,32,137,169,222,102,12,68,172,825
185,Zydrunas Ilgauskas,C,25,CLE,24,24,616,114,234,0,2,114,232,53,78,65,95,160,18,15,37,60,78,281
186,Allen Iverson*,SG,25,PHI,71,71,2979,762,1813,98,306,664,1507,585,719,50,223,273,325,178,20,237,147,2207
187,Bobby Jackson,PG,27,SAC,79,7,1648,231,526,39,104,192,422,65,88,74,172,246,161,87,7,103,139,566
188,Jaren Jackson,SG,33,SAS,16,0,114,16,40,7,18,9,22,0,2,1,11,12,7,5,0,3,13,39
189,Jim Jackson,SF,30,TOT,56,40,1690,239,632,26,80,213,552,139,169,53,171,224,163,53,10,130,139,643
190,Marc Jackson,C,26,GSW,48,35,1410,237,508,5,23,232,485,154,192,119,242,361,59,34,27,93,138,633
191,Mark Jackson,PG,35,TOT,83,82,2588,244,583,70,207,174,376,73,93,63,242,305,661,84,7,175,139,631
192,Stephen Jackson,SF,22,NJN,77,40,1660,243,572,52,155,191,417,97,135,41,167,208,140,86,14,130,166,635
193,Sam Jacobson,PG,25,MIN,14,0,59,9,18,0,0,9,18,2,3,3,3,6,4,3,0,0,19,20
194,Tim James,SF,24,CHH,30,0,197,16,52,1,3,15,49,12,14,15,20,35,8,2,5,8,27,45
195,Antawn Jamison,SF,24,GSW,82,82,3394,800,1812,62,205,738,1607,382,534,280,435,715,164,114,28,199,225,2044
196,Anthony Johnson,PG,26,TOT,53,0,511,53,152,1,5,52,147,23,33,10,34,44,78,23,6,34,62,130
197,Avery Johnson,PG,35,SAS,55,20,1290,134,300,1,6,133,294,41,60,21,64,85,237,33,4,60,90,310
198,DerMarr Johnson,SF,20,ATL,78,21,1313,146,390,41,127,105,263,64,87,56,122,178,64,43,30,93,134,397
199,Ervin Johnson,C,33,MIL,82,19,1981,108,198,0,0,108,198,50,93,205,408,613,40,44,97,47,257,266
200,Larry Johnson,PF,31,NYK,65,65,2105,246,598,51,163,195,435,102,128,90,273,363,127,39,29,97,209,645
201,Damon Jones,PG,24,VAN,71,10,1415,170,416,84,231,86,185,37,52,16,108,124,224,36,1,76,58,461
202,Eddie Jones,SG,29,MIA,63,58,2282,388,871,90,238,298,633,228,270,75,217,292,171,110,58,135,183,1094
203,Jumaine Jones,SF,21,PHI,65,0,866,122,275,20,60,102,215,40,53,63,126,189,32,30,15,39,68,304
204,Popeye Jones,PF,30,WAS,45,1,638,60,153,1,6,59,147,41,55,83,137,220,31,19,8,21,95,162
205,Garth Joseph,C,27,TOT,4,0,16,1,5,0,0,1,5,0,2,2,0,2,1,0,1,2,1,2
206,Adam Keefe,PF,30,GSW,67,13,836,64,159,1,3,63,156,39,63,90,119,209,36,28,20,40,102,168
207,Shawn Kemp,PF,31,POR,68,3,1083,168,413,4,11,164,402,101,131,63,196,259,65,45,23,99,184,441
208,Steve Kerr,PG,35,SAS,55,1,650,67,159,33,77,34,82,14,15,6,29,35,57,16,1,21,30,181
209,Jerome Kersey,SF,38,MIL,22,2,243,32,69,0,1,32,68,8,16,8,37,45,15,14,8,6,36,72
210,Lari Ketner,PF,23,IND,3,0,7,0,0,0,0,0,0,0,0,0,0,0,1,0,0,2,0,0
211,Jason Kidd*,PG,27,PHO,77,76,3065,451,1097,69,232,382,865,328,403,91,403,494,753,166,23,286,171,1299
212,Gerard King,SF,28,WAS,45,3,706,90,176,0,0,90,176,36,45,39,90,129,31,14,11,47,94,216
213,Brevin Knight,PG,25,TOT,53,43,1457,139,371,1,10,138,361,54,66,23,145,168,311,101,4,91,155,333
214,Travis Knight,C,26,NYK,45,0,256,10,53,0,1,10,52,9,18,19,34,53,5,5,11,10,47,29
215,Toni Kukoč,SF,32,TOT,65,19,1597,275,582,70,157,205,425,101,160,66,193,259,199,48,11,111,98,721
217,Raef LaFrentz,C,24,DEN,78,74,2457,387,812,51,139,336,673,183,262,173,434,607,107,37,206,97,290,1008
218,Trajan Langdon,SG,24,CLE,65,5,1116,135,313,51,124,84,189,68,76,12,77,89,81,38,9,52,114,389
219,Dan Langhi,SF,23,HOU,33,0,241,37,99,0,1,37,98,16,29,13,28,41,4,7,1,8,16,90
220,Voshon Lenard,SG,27,DEN,80,58,2331,336,846,147,382,189,464,153,192,47,184,231,190,65,18,102,170,972
221,Quincy Lewis,SF,23,UTA,35,2,402,50,123,9,25,41,98,15,21,14,33,47,18,10,10,17,78,124
222,Rashard Lewis,PF,21,SEA,78,78,2720,426,887,123,285,303,602,176,213,143,398,541,125,91,45,129,191,1151
223,Randy Livingston,PG,25,GSW,2,0,7,0,2,0,1,0,1,0,0,0,1,1,1,0,0,0,0,0
224,Art Long,SF,28,SAC,9,0,20,0,4,0,0,0,4,0,2,2,6,8,1,0,3,2,5,0
225,Grant Long,PF,34,VAN,66,27,1507,140,319,4,15,136,304,112,157,76,198,274,83,72,15,62,160,396
226,Luc Longley,C,32,NYK,25,2,301,18,54,0,0,18,54,13,17,26,40,66,7,3,9,22,51,49
228,Tyronn Lue,PG,23,LAL,38,1,468,50,117,11,34,39,83,19,24,5,27,32,45,19,0,27,54,130
229,George Lynch,SF,30,PHI,82,80,2649,274,616,15,57,259,559,123,171,200,390,590,139,99,30,109,222,686
230,Todd MacCulloch,C,25,PHI,63,3,597,109,185,0,0,109,185,42,66,69,99,168,10,7,19,27,96,260
231,Don MacLean,SF,31,MIA,8,1,76,10,20,2,2,8,18,9,12,7,11,18,4,5,1,10,9,31
232,Mark Madsen,PF,25,LAL,70,3,641,55,113,1,1,54,112,26,37,74,78,152,24,8,8,27,111,137
233,Corey Maggette,SF,21,LAC,69,9,1359,225,487,17,56,208,431,223,288,88,203,291,82,35,9,106,140,690
234,Jamaal Magloire,C,22,CHH,74,0,1095,122,271,0,2,122,269,95,145,103,192,295,27,18,78,61,139,339
235,Dan Majerle,SG,35,MIA,53,19,1306,87,259,57,181,30,78,36,44,20,146,166,88,53,15,35,98,267
236,Karl Malone*,PF,37,UTA,81,81,2895,670,1345,2,5,668,1340,536,676,114,555,669,361,93,62,244,216,1878
237,Matt Maloney,PG,29,ATL,55,27,1403,146,348,51,142,95,206,26,34,14,103,117,154,56,5,70,94,369
238,Danny Manning,PF,34,UTA,82,0,1305,247,500,7,28,240,472,102,140,66,148,214,92,47,29,96,219,603
239,Stephon Marbury,PG,23,NJN,67,67,2557,563,1277,110,335,453,942,362,458,53,152,205,506,79,5,197,150,1598
240,Shawn Marion,SF,22,PHO,79,79,2857,557,1160,21,82,536,1078,234,289,220,628,848,160,132,108,129,211,1369
241,Donyell Marshall,SF,27,UTA,81,49,2326,427,849,41,128,386,721,205,273,172,394,566,133,85,78,128,196,1100
242,Darrick Martin,PG,29,SAC,31,0,176,29,76,14,27,15,49,31,35,2,14,16,14,7,0,10,27,103
243,Kenyon Martin,PF,23,NJN,68,68,2272,346,777,1,11,345,766,121,192,137,365,502,131,78,113,138,281,814
244,Jamal Mashburn,SF,28,CHH,76,76,2989,573,1388,103,289,470,1099,279,364,92,484,576,411,85,13,211,185,1528
245,Anthony Mason,PF,34,MIA,80,80,3254,460,954,0,0,460,954,370,474,169,601,770,248,80,25,179,231,1290
246,Desmond Mason,SF,23,SEA,78,14,1522,189,439,18,67,171,372,67,91,72,177,249,63,39,20,53,146,463
247,Tony Massenburg,PF,33,VAN,52,20,823,92,199,0,0,92,199,49,70,75,135,210,9,10,28,48,122,233
248,Vernon Maxwell,PG,35,TOT,43,6,660,73,223,34,111,39,112,21,32,4,62,66,49,21,3,35,64,201
249,Walter McCarty,PF,26,BOS,60,3,478,45,126,19,56,26,70,22,28,24,57,81,39,14,7,20,82,131
250,Dan McClintock,C,23,DEN,6,1,58,9,18,0,0,9,18,0,5,10,7,17,1,0,2,3,11,18
251,George McCloud,SF,33,DEN,76,8,2007,250,655,77,234,173,421,152,181,55,169,224,279,53,27,117,165,729
252,Jelani McCoy,C,23,SEA,70,44,1143,138,264,0,0,138,264,41,93,92,159,251,57,18,49,75,141,317
253,Antonio McDyess,PF,26,DEN,70,70,2555,577,1165,0,0,577,1165,304,434,240,605,845,146,43,102,162,220,1458
254,Tracy McGrady*,SG,21,ORL,77,77,3087,788,1724,59,166,729,1558,430,587,192,388,580,352,116,118,198,160,2065
255,Jim McIlvaine,C,28,NJN,18,3,193,10,28,0,0,10,28,8,12,8,27,35,4,7,15,9,35,28
256,Jeff McInnis,PG,26,LAC,81,81,2831,432,933,52,144,380,789,130,161,41,179,220,447,75,7,113,199,1046
257,Derrick McKey,SF,34,IND,66,20,987,60,136,4,20,56,116,21,27,49,127,176,74,48,13,47,136,145
258,Aaron McKie,SG,28,PHI,76,33,2394,338,714,53,170,285,544,149,194,33,278,311,377,106,8,203,178,878
259,Roshown McLeod,SF,25,TOT,35,25,922,145,332,2,22,143,310,45,51,38,82,120,58,23,8,58,90,337
260,Paul McPherson,PG,22,TOT,55,0,595,109,216,2,12,107,204,42,58,40,39,79,38,25,4,47,80,262
261,Stanislav Medvedenko,PF,21,LAL,7,0,39,12,25,1,1,11,24,7,12,1,8,9,2,1,1,3,9,32
262,Ron Mercer,SG,24,CHI,61,61,2535,500,1121,14,46,486,1075,188,228,72,164,236,201,78,27,129,148,1202
263,Chris Mihm,C,21,CLE,59,43,1166,173,391,0,1,173,390,100,126,106,174,280,16,20,53,80,156,446
264,Darius Miles,SF,19,LAC,81,21,2133,318,630,1,19,317,611,124,238,127,350,477,99,51,125,147,191,761
265,Andre Miller,PG,24,CLE,82,82,2848,452,999,17,64,435,935,375,450,94,266,360,657,119,28,265,229,1296
266,Anthony Miller,PF,29,TOT,4,0,11,1,2,0,0,1,2,0,0,0,2,2,0,0,0,1,1,2
267,Brad Miller,C,24,CHI,57,45,1434,168,386,1,5,167,381,168,226,144,275,419,107,33,38,73,176,505
268,Mike Miller,SF,20,ORL,82,62,2390,368,845,148,364,220,481,91,128,66,261,327,140,51,19,97,200,975
269,Reggie Miller*,SG,35,IND,81,81,3181,517,1176,170,464,347,712,323,348,38,247,285,260,81,15,133,162,1527
270,Chris Mills,SF,31,GSW,15,8,493,71,191,7,25,64,166,31,36,24,69,93,18,9,5,20,43,180
271,Terry Mills,PF,33,IND,14,0,113,11,34,3,17,8,17,0,0,4,17,21,5,3,1,10,20,25
272,Sam Mitchell,SF,37,MIN,82,4,983,118,289,9,43,109,246,40,55,28,95,123,57,26,10,36,117,285
273,Cuttino Mobley,SG,25,HOU,79,49,3002,527,1214,90,252,437,962,394,474,83,314,397,195,84,26,165,169,1538
274,Nazr Mohammed,C,23,TOT,58,22,912,176,369,0,1,176,368,89,126,115,192,307,19,29,35,64,113,441
275,Jérôme Moïso,C,22,BOS,24,0,135,12,30,0,1,12,29,11,26,12,30,42,3,3,4,18,29,35
276,Eric Montross,C,29,TOT,54,21,649,56,138,0,0,56,138,8,31,52,121,173,19,11,26,41,115,120
277,Mikki Moore,C,25,DET,81,2,1154,132,268,0,1,132,267,95,130,121,195,316,33,24,61,74,202,359
278,Hanno Möttölä,SF,24,ATL,73,3,989,123,277,0,3,123,274,73,90,49,125,174,25,11,9,67,163,319
279,Alonzo Mourning*,C,30,MIA,13,3,306,73,141,0,1,73,140,31,55,35,66,101,12,4,31,28,24,177
280,Chris Mullin*,SF,37,GSW,20,8,374,36,106,19,52,17,54,24,28,10,31,41,19,16,10,19,28,115
281,Lamond Murray,SF,27,CLE,78,46,2225,391,925,61,165,330,760,155,211,104,236,340,124,83,27,141,173,998
282,Tracy Murray,SF,29,TOT,51,1,588,94,248,36,103,58,145,33,42,22,59,81,23,12,7,26,53,257
283,Dikembe Mutombo*,C,34,TOT,75,75,2591,269,556,0,0,269,556,211,291,307,708,1015,76,29,203,144,204,749
284,Mamadou N'Diaye,C,25,TOR,3,0,10,1,4,0,0,1,4,2,2,1,1,2,0,0,0,0,3,4
285,Lee Nailon,SF,25,CHH,42,0,469,66,136,0,1,66,135,32,43,29,63,92,24,9,5,27,60,164
286,Eduardo Nájera,PF,24,DAL,40,4,431,58,111,1,3,57,108,14,33,41,54,95,27,13,8,17,48,131
287,Steve Nash*,PG,26,DAL,70,70,2387,386,792,89,219,297,573,231,258,46,177,223,509,72,5,205,158,1092
289,Rasho Nesterović,C,24,MIN,73,39,1233,147,319,0,1,147,318,34,65,99,187,286,45,25,63,55,189,328
290,Ira Newble,SF,26,SAS,27,6,184,21,55,4,9,17,46,8,16,13,22,35,6,2,4,7,18,54
291,Johnny Newman,SG,37,NJN,82,17,2049,291,695,59,176,232,519,254,297,34,142,176,115,63,10,106,229,895
292,Moochie Norris,PG,27,HOU,82,6,1654,184,413,25,89,159,324,151,194,44,154,198,283,69,2,107,84,544
293,Dirk Nowitzki,PF,22,DAL,82,82,3125,591,1247,151,390,440,857,451,538,119,635,754,173,79,101,156,245,1784
294,Jermaine O'Neal,C,22,IND,81,80,2641,404,868,0,5,404,863,233,388,249,545,794,98,49,228,161,280,1041
295,Shaquille O'Neal*,C,28,LAL,74,74,2924,813,1422,0,2,813,1420,499,972,291,649,940,277,47,204,218,256,2125
296,Charles Oakley,PF,37,TOR,78,77,2767,305,786,11,49,294,737,127,152,142,599,741,264,76,48,139,258,748
297,Lamar Odom,PF,21,LAC,76,74,2836,481,1046,80,253,401,793,262,386,110,482,592,392,74,122,264,236,1304
298,Hakeem Olajuwon*,C,38,HOU,58,55,1545,283,568,0,1,283,567,123,198,124,307,431,72,70,88,81,141,689
299,Kevin Ollie,PG,28,TOT,70,4,925,76,192,1,3,75,189,63,89,16,79,95,146,30,1,49,84,216
300,Michael Olowokandi,C,25,LAC,82,82,2127,308,708,0,0,308,708,85,156,168,357,525,46,30,108,169,250,701
301,Greg Ostertag,C,27,UTA,81,3,1491,139,281,1,2,138,279,84,151,164,251,415,22,22,142,63,215,363
302,Bo Outlaw,PF,29,ORL,80,69,2534,226,368,1,2,225,366,129,225,211,408,619,225,105,137,141,241,582
303,Doug Overton,PG,31,TOT,21,10,475,52,139,11,36,41,103,10,16,4,35,39,72,8,0,31,37,125
304,Billy Owens,PF,31,DET,45,14,793,88,230,3,20,85,210,19,40,84,121,205,55,32,12,39,93,198
305,Olumide Oyedeji,C,19,SEA,30,1,221,18,37,0,0,18,37,9,12,24,43,67,2,7,10,11,40,45
306,Robert Pack,PG,31,DEN,74,11,1260,181,426,12,31,169,395,105,137,30,107,137,293,65,1,135,114,479
307,Scott Padgett,PF,24,UTA,27,0,127,18,43,5,9,13,34,15,20,19,20,39,5,6,3,10,21,56
308,Milt Palacio,PG,22,BOS,58,6,1141,126,267,12,36,114,231,78,92,25,77,102,151,48,0,80,83,342
309,Andy Panko,SF,23,ATL,1,0,1,0,0,0,0,0,0,0,0,0,0,0,0,0,0,0,0,0
310,Cherokee Parks,C,28,TOT,65,31,1054,134,274,0,6,134,268,31,44,71,158,229,46,25,36,41,122,299
311,Ruben Patterson,SF,25,SEA,76,22,2059,370,749,2,36,368,713,246,361,183,199,382,161,103,45,155,176,988
312,Gary Payton*,PG,32,SEA,79,79,3244,725,1591,102,272,623,1319,271,354,73,288,361,642,127,26,209,184,1823
313,Anthony Peeler,SG,31,MIN,75,41,2126,308,732,100,256,208,476,75,87,44,148,192,192,91,18,105,166,791
314,Mike Penberthy,PG,26,LAL,53,0,851,92,222,55,139,37,83,28,31,10,53,63,71,22,2,34,57,267
315,Will Perdue,C,35,POR,13,0,58,6,9,0,0,6,9,2,4,6,12,18,2,3,2,0,8,14
316,Sam Perkins,PF,39,IND,64,41,999,86,226,38,110,48,116,32,38,32,136,168,41,33,18,19,61,242
317,Elliot Perry,PG,31,TOT,49,6,499,65,140,1,5,64,135,16,22,9,37,46,79,22,1,38,29,147
318,Wesley Person,SG,29,CLE,44,22,958,128,292,34,84,94,208,24,30,11,119,130,64,27,11,40,62,314
319,Morris Peterson,SG,23,TOR,80,49,1809,290,673,63,165,227,508,104,145,112,147,259,105,63,20,78,164,747
320,Eric Piatkowski,SG,30,LAC,81,40,2144,291,672,120,297,171,375,158,181,54,187,241,96,46,19,76,123,860
321,Paul Pierce,SF,23,BOS,82,82,3120,687,1513,147,384,540,1129,550,738,94,428,522,253,138,69,262,251,2071
322,Scottie Pippen*,SF,35,POR,64,60,2133,269,596,64,186,205,410,119,161,70,263,333,294,94,35,154,158,721
323,Scot Pollard,C,25,SAC,77,8,1658,185,395,0,2,185,393,128,171,173,292,465,47,48,97,66,206,498
324,Olden Polynice,C,36,UTA,81,79,1619,206,415,0,1,206,414,17,65,157,221,378,31,27,77,78,241,429
325,Mark Pope,PF,28,MIL,63,45,942,62,142,5,24,57,118,22,35,56,91,147,38,16,26,17,140,151
326,Chris Porter,SF,22,GSW,51,35,1147,173,445,0,5,173,440,94,141,89,100,189,61,45,6,59,111,440
327,Terry Porter,PG,37,SAS,80,42,1678,197,440,87,205,110,235,92,116,24,177,201,251,52,11,104,88,573
328,James Posey,SF,24,DEN,82,82,2255,243,590,65,217,178,373,115,141,125,306,431,163,93,40,102,226,666
329,Lavor Postell,SG,22,NYK,26,0,169,17,54,3,11,14,43,22,27,8,17,25,5,4,2,17,12,59
330,Vitaly Potapenko,C,25,BOS,82,7,1901,248,521,0,0,248,521,115,158,206,289,495,64,52,23,105,228,611
331,Brent Price,PG,32,VAN,6,0,30,3,11,1,4,2,7,6,7,1,3,4,5,2,0,4,8,13
332,Laron Profit,PG,23,WAS,35,12,605,56,142,7,26,49,116,33,45,18,46,64,89,36,11,46,43,152
333,Joel Przybilla,C,21,MIL,33,13,270,12,35,0,0,12,35,3,11,29,42,71,2,3,30,13,56,27
334,Theo Ratliff,C,27,PHI,50,50,1800,228,457,0,0,228,457,165,217,125,288,413,58,30,187,126,165,621
335,Eldridge Recasner,PG,33,CHH,43,0,403,38,114,13,39,25,75,14,18,13,37,50,39,6,1,27,30,103
336,Michael Redd,SG,21,MIL,6,0,35,5,19,0,3,5,16,3,6,3,1,4,1,1,0,1,2,13
337,Bryant Reeves,C,27,VAN,75,48,1832,254,552,1,4,253,548,113,142,132,320,452,80,43,54,90,243,622
338,Don Reid,PF,27,ORL,65,7,764,82,145,0,0,82,145,46,75,84,158,242,21,23,54,48,190,210
339,J.R. Reid,PF,32,CLE,6,0,39,2,5,0,0,2,5,6,8,5,3,8,1,2,1,1,4,10
340,Glen Rice,SF,33,NYK,75,25,2212,331,752,82,211,249,541,155,182,61,246,307,89,41,13,96,179,899
341,Quentin Richardson,SG,20,LAC,76,28,1358,232,525,50,151,182,374,99,158,105,152,257,62,42,7,64,98,613
342,Mitch Richmond*,SG,35,WAS,37,30,1216,205,504,45,133,160,371,143,160,15,94,109,111,43,7,84,86,598
343,Isaiah Rider,SG,29,LAL,67,6,1206,201,472,34,92,167,380,71,83,44,112,156,111,27,7,98,105,507
344,Terrance Roberson,SF,24,CHH,3,0,13,0,2,0,1,0,1,0,0,0,1,1,1,0,0,2,3,0
345,Clifford Robinson,PF,34,PHO,82,82,2751,501,1186,90,249,411,937,253,357,105,229,334,237,87,82,186,258,1345
346,David Robinson*,C,35,SAS,80,80,2371,400,823,0,1,400,822,351,470,208,483,691,116,80,197,122,212,1151
347,Eddie Robinson,SF,24,CHH,67,6,1201,216,407,2,4,214,403,64,88,60,138,198,59,50,32,43,66,498
348,Glenn Robinson,SF,28,MIL,76,74,2813,684,1460,55,184,629,1276,251,306,124,402,526,252,86,62,219,191,1674
349,Jamal Robinson,SF,27,MIA,6,0,72,3,22,0,2,3,20,0,0,3,8,11,2,6,0,3,7,6
350,James Robinson,PG,30,ORL,6,0,50,4,11,2,5,2,6,0,0,0,8,8,0,4,1,4,5,10
352,Carlos Rogers,C,29,HOU,39,0,544,75,110,0,1,75,109,29,52,48,91,139,9,10,18,17,33,179
353,Rodney Rogers,SF,29,PHO,82,3,2183,377,876,56,189,321,687,188,247,94,265,359,180,97,47,157,269,998
354,Sean Rooks,C,31,LAC,82,0,1553,169,395,1,2,168,393,107,143,91,212,303,77,34,64,73,197,446
355,Jalen Rose,SF,28,IND,72,72,2943,567,1242,59,174,508,1068,285,344,37,322,359,435,65,43,211,230,1478
356,Malik Rose,PF,26,SAS,57,9,1219,160,368,3,17,157,351,114,160,95,213,308,48,59,40,74,148,437
357,Michael Ruffin,PF,24,CHI,45,16,879,40,90,0,0,40,90,39,77,101,161,262,39,30,38,46,131,119
358,Bryon Russell,SF,30,UTA,78,46,2473,308,700,95,230,213,470,222,285,94,236,330,160,96,20,113,229,933
359,Arvydas Sabonis*,C,36,POR,61,42,1299,247,516,1,15,246,501,121,156,51,280,331,91,40,62,85,137,616
360,Soumaila Samake,C,22,NJN,34,0,226,18,48,0,0,18,48,10,24,22,31,53,1,2,14,4,23,46
361,Pepe Sánchez,PG,23,TOT,29,0,150,9,28,0,1,9,27,2,2,3,12,15,41,11,1,6,21,20
362,Daniel Santiago,C,24,PHO,54,2,581,64,134,0,0,64,134,42,61,35,67,102,11,17,21,47,101,170
363,Detlef Schrempf,SF,38,POR,26,0,397,39,95,3,8,36,87,23,27,17,61,78,44,7,3,28,43,104
364,Shawnelle Scott,C,28,SAS,27,1,144,17,41,0,0,17,41,9,22,23,27,50,4,5,6,11,23,43
365,Brian Shaw,SG,34,LAL,80,28,1833,164,411,42,135,122,276,51,64,48,256,304,258,49,27,97,159,421
366,Brian Skinner,PF,24,LAC,39,23,584,64,161,0,0,64,161,32,59,55,113,168,18,14,11,32,61,160
367,Reggie Slater,PF,30,MIN,55,16,686,90,175,0,0,90,175,74,110,78,108,186,26,18,9,43,126,254
368,Jabari Smith,C,23,SAC,9,0,66,11,22,0,0,11,22,4,6,1,7,8,6,4,0,3,7,26
369,Joe Smith,PF,25,DET,69,59,1941,308,765,0,5,308,760,231,287,160,331,491,79,47,50,88,258,847
370,Michael Smith,PF,28,WAS,79,29,1610,106,218,0,1,106,217,89,154,172,390,562,101,57,37,62,156,301
371,Mike Smith,SF,24,WAS,17,0,180,19,59,3,18,16,41,10,16,10,12,22,10,5,3,7,8,51
372,Steve Smith,SG,31,POR,81,36,2542,359,788,78,230,281,558,309,347,87,185,272,213,48,24,137,203,1105
373,Tony Smith,SG,32,ATL,6,0,78,8,23,0,2,8,21,1,2,2,1,3,10,7,0,9,12,17
374,Eric Snow,PG,27,PHI,50,50,1740,182,435,5,19,177,416,122,154,27,139,166,369,77,7,124,123,491
375,Felton Spencer,C,33,NYK,18,0,113,12,20,0,0,12,20,15,25,16,19,35,2,2,2,11,24,39
376,Latrell Sprewell,SF,30,NYK,77,77,3017,524,1219,41,135,483,1084,275,351,49,298,347,269,106,28,218,159,1364
377,Jerry Stackhouse,SG,26,DET,80,80,3215,774,1927,166,473,608,1454,666,810,99,216,315,410,97,54,326,160,2380
378,John Starks,SG,35,UTA,75,64,2122,273,686,64,182,209,504,89,111,29,125,154,178,73,10,94,217,699
379,Vladimir Stepania,C,24,NJN,29,0,280,28,88,1,4,27,84,25,34,35,74,109,16,10,11,19,47,82
380,DeShawn Stevenson,SG,19,UTA,40,2,293,31,91,1,12,30,79,26,38,9,19,28,18,10,2,28,29,89
381,Michael Stewart,C,25,TOR,26,0,123,11,34,0,0,11,34,11,18,16,13,29,2,4,3,5,19,33
382,Bryant Stith,SG,30,BOS,78,74,2504,245,611,91,242,154,369,175,207,65,219,284,168,93,14,90,182,756
383,John Stockton*,PG,38,UTA,82,82,2397,328,651,61,132,267,519,227,278,54,173,227,713,132,21,203,194,944
384,Peja Stojaković,SF,23,SAC,75,75,2905,559,1189,144,360,415,829,267,312,93,341,434,164,91,13,146,144,1529
385,Damon Stoudamire,PG,27,POR,82,82,2655,406,935,82,219,324,716,172,207,69,234,303,468,106,8,191,202,1066
386,Erick Strickland,PG,27,TOT,50,0,830,81,267,30,95,51,172,68,79,18,110,128,95,44,2,48,88,260
387,Mark Strickland,SF,30,TOT,55,2,719,103,239,1,2,102,237,45,70,54,107,161,24,16,22,34,72,252
388,Rod Strickland,PG,34,TOT,54,28,1371,182,429,4,17,178,412,130,173,36,104,140,303,53,5,107,76,498
389,Derek Strong,PF,32,LAC,28,8,491,45,117,0,1,45,116,28,37,34,74,108,7,14,1,22,30,118
390,Bruno Šundov,C,20,IND,11,4,120,20,41,0,4,20,37,3,5,4,19,23,2,2,4,3,21,43
391,Bob Sura,SG,27,GSW,53,42,1684,202,518,47,172,155,346,135,189,54,173,227,242,54,8,160,127,586
392,Stromile Swift,PF,21,VAN,80,6,1312,153,339,0,4,153,335,85,141,109,175,284,28,62,82,64,160,391
393,Wally Szczerbiak,SF,23,MIN,82,82,2856,469,920,26,77,443,843,181,208,133,314,447,260,59,33,138,226,1145
394,Žan Tabak,C,30,IND,55,14,777,98,186,0,0,98,186,20,47,65,148,213,33,10,30,57,125,216
395,Dragan Tarlać,C,27,CHI,43,12,598,39,99,0,0,39,99,25,33,37,85,122,31,7,19,38,95,103
396,Maurice Taylor,SF,24,HOU,69,69,1972,390,797,0,4,390,793,119,162,109,269,378,104,28,38,125,208,899
397,Jason Terry,SG,23,ATL,82,77,3089,596,1367,124,314,472,1053,303,358,42,227,269,403,104,12,239,204,1619
398,Jamel Thomas,SF,27,NJN,5,0,56,6,19,1,3,5,16,0,0,4,5,9,0,3,0,6,6,13
399,Kenny Thomas,PF,23,HOU,74,21,1820,206,465,25,92,181,373,91,126,122,295,417,77,40,43,116,178,528
400,Kurt Thomas,PF,28,NYK,77,29,2125,314,614,1,3,313,611,171,210,172,343,515,63,61,69,99,287,800
401,Tim Thomas,PF,23,MIL,76,16,2086,326,758,107,260,219,498,195,253,79,234,313,138,78,45,114,194,954
402,Otis Thorpe,PF,38,CHH,49,4,647,59,131,0,0,59,131,20,24,50,95,145,29,12,7,32,108,138
403,Robert Traylor,C,23,CLE,70,7,1212,161,324,0,2,161,322,80,141,124,176,300,63,49,76,98,204,402
404,Gary Trent,PF,26,DAL,33,4,319,57,130,0,1,57,129,19,36,39,53,92,10,13,8,22,52,133
405,Jake Tsakalidis,C,21,PHO,57,39,947,101,215,0,0,101,215,54,91,83,159,242,19,10,55,66,137,256
406,Hedo Türkoğlu,SF,21,SAC,74,7,1245,138,335,28,86,110,249,87,112,49,161,210,69,52,24,55,139,391
407,Nick Van Exel,PG,29,DEN,71,70,2688,460,1112,135,358,325,754,204,249,44,197,241,600,61,18,165,109,1259
408,Keith Van Horn,SF,25,NJN,49,47,1733,308,708,65,170,243,538,150,186,78,269,347,82,40,20,103,150,831
409,David Vanterpool,PG,27,WAS,22,0,411,46,110,0,6,46,104,30,50,15,22,37,66,23,3,37,44,122
410,Jacque Vaughn,PG,25,UTA,82,0,1620,170,393,30,78,140,315,128,164,18,132,150,323,48,3,129,145,498
411,Loy Vaught,PF,32,TOT,51,1,549,80,169,0,0,80,169,8,10,51,122,173,23,21,7,26,74,168
412,Jake Voskuhl,C,23,CHI,16,2,143,11,25,0,0,11,25,8,14,12,22,34,5,5,6,12,38,30
413,Antoine Walker,PF,24,BOS,81,81,3396,711,1720,221,603,490,1117,249,348,151,568,719,445,138,49,301,251,1892
414,Samaki Walker,PF,24,SAS,61,1,963,121,252,1,3,120,249,78,124,67,176,243,29,10,41,68,103,321
415,Ben Wallace,C,26,DET,80,80,2760,215,439,1,4,214,435,80,238,303,749,1052,123,107,186,117,192,511
416,John Wallace,SF,26,DET,40,0,527,100,236,2,15,98,221,35,45,25,58,83,23,13,16,36,72,237
417,Rasheed Wallace,PF,26,POR,77,75,2940,590,1178,52,162,538,1016,245,320,147,455,602,212,90,135,158,206,1477
418,Charlie Ward,PG,30,NYK,61,33,1492,155,373,67,175,88,198,56,70,32,127,159,273,70,10,112,132,433
419,Clarence Weatherspoon,PF,30,CLE,82,82,2774,347,692,0,0,347,692,230,291,223,573,796,103,85,105,112,171,924
420,Chris Webber,PF,27,SAC,70,70,2836,786,1635,2,28,784,1607,324,461,179,598,777,294,93,118,195,226,1898
421,Bonzi Wells,SF,24,POR,75,46,1995,387,726,17,50,370,676,159,240,120,247,367,208,94,20,169,203,950
422,David Wesley,SG,30,CHH,82,82,3106,523,1239,97,258,426,981,271,339,64,160,224,361,128,16,171,220,1414
423,Doug West,SG,33,VAN,15,6,171,11,38,0,2,11,36,6,7,4,11,15,14,3,4,4,21,28
424,Jahidi White,C,24,WAS,68,56,1609,203,408,0,1,203,407,177,312,178,343,521,20,32,111,136,211,583
425,Chris Whitney,PG,29,WAS,59,31,1532,182,470,93,248,89,222,101,113,12,94,106,248,55,3,103,150,558
426,Aaron Williams,PF,29,NJN,82,25,2336,297,650,0,2,297,648,244,310,211,379,590,88,59,113,132,319,838
427,Alvin Williams,SG,26,TOR,82,34,2394,330,767,33,108,297,659,109,145,50,162,212,407,123,26,103,171,802
428,Eric Williams,SF,28,BOS,81,11,1745,162,448,46,139,116,309,165,231,64,143,207,112,64,13,76,179,535
429,Jason Williams,PG,25,SAC,77,77,2290,281,690,98,311,183,379,60,76,19,166,185,416,94,9,160,114,720
430,Jerome Williams,PF,27,TOT,59,2,1182,136,294,0,3,136,291,100,135,133,249,382,45,57,20,63,124,372
431,Monty Williams,SF,29,ORL,82,0,1211,162,364,1,13,161,351,85,133,86,157,243,79,29,16,85,136,410
432,Scott Williams,C,32,MIL,66,31,1272,171,361,1,4,170,357,60,70,97,267,364,35,48,32,41,178,403
433,Shammond Williams,PG,25,SEA,69,6,1238,161,368,61,133,100,235,84,96,34,98,132,190,31,4,82,83,467
434,Walt Williams,SF,30,HOU,72,31,1583,202,513,98,248,104,265,97,126,31,214,245,97,30,28,73,153,599
435,Corliss Williamson,SF,27,TOT,69,40,1686,325,647,0,2,325,645,151,237,110,211,321,61,50,21,110,185,801
436,Kevin Willis,C,38,TOT,78,22,1830,304,690,1,6,303,684,113,147,177,355,532,50,57,52,87,216,722
437,David Wingate,SG,37,SEA,1,0,9,3,3,0,0,3,3,0,0,0,0,0,2,0,0,0,1,6
438,Rubén Wolkowyski,PF,27,SEA,34,1,305,25,79,0,2,25,77,25,34,12,34,46,3,6,18,12,38,75
439,Metta World Peace,SF,21,CHI,76,74,2363,327,815,43,148,284,667,210,280,59,235,294,228,152,45,159,254,907
440,Lorenzen Wright,C,25,ATL,71,46,1988,363,811,0,2,363,809,155,216,180,355,535,87,42,63,125,232,881
441,Wang Zhizhi,C,23,DAL,5,0,38,8,19,0,2,8,17,8,10,1,6,7,0,0,0,1,8,24
