Rk,Player,Pos,Age,Tm,G,GS,MP,FG,FGA,3P,3PA,2P,2PA,FT,FTA,ORB,DRB,TRB,AST,STL,BLK,TOV,PF,PTS
1,Tariq Abdul-Wahad,SG,27,TOT,24,12,441,55,147,1,2,54,145,24,33,41,43,84,24,20,10,27,56,135
2,Shareef Abdur-Rahim,PF,25,ATL,77,77,2980,598,1297,21,70,577,1227,419,523,198,498,696,239,98,81,250,214,1636
3,Courtney Alexander,SG,24,WAS,56,28,1325,223,474,5,18,218,456,98,121,43,105,148,86,35,7,60,113,549
4,Victor Alexander,C,32,DET,15,0,97,18,51,0,2,18,49,4,8,7,22,29,6,0,1,5,6,40
5,Malik Allen,PF,23,MIA,12,2,161,22,51,0,1,22,50,8,10,15,23,38,5,3,8,2,16,52
6,Ray Allen*,SG,26,MIL,69,67,2525,530,1148,229,528,301,620,214,245,81,231,312,271,88,18,159,157,1503
7,Rafer Alston,PG,25,MIL,50,7,600,66,191,27,71,39,120,18,29,10,62,72,143,32,2,40,42,177
8,John Amaechi,PF,31,UTA,54,0,586,54,166,0,0,54,166,67,105,52,57,109,29,7,10,55,64,175
9,Chris Andersen,C,23,DEN,24,1,262,25,74,0,4,25,70,22,28,38,38,76,7,7,28,13,35,72
10,Derek Anderson,SG,27,POR,70,27,1860,247,612,85,228,162,384,178,208,47,142,189,216,68,8,87,113,757
11,Kenny Anderson,PG,31,BOS,76,76,2430,312,716,9,33,303,683,98,132,57,218,275,403,141,10,119,210,731
12,Nick Anderson,SG,34,MEM,15,0,219,21,76,13,48,8,28,5,9,1,32,33,14,6,6,14,17,60
13,Shandon Anderson,SG,28,NYK,82,6,1596,149,373,39,141,110,232,74,107,57,192,249,76,48,15,97,134,411
14,Greg Anthony,PG,34,TOT,60,38,1514,183,475,48,163,135,312,60,91,22,110,132,282,77,5,94,114,474
15,Gilbert Arenas,PG,20,GSW,47,30,1155,174,384,39,113,135,271,124,160,41,91,132,174,69,11,97,115,511
16,Brandon Armstrong,SG,21,NJN,35,0,196,27,85,5,17,22,68,5,10,10,6,16,8,7,1,8,26,64
17,Darrell Armstrong,PG,33,ORL,82,79,2730,347,828,139,398,208,430,182,205,83,236,319,453,157,10,175,166,1015
18,Carlos Arroyo,PG,22,TOT,37,1,371,49,111,0,2,49,109,13,18,12,28,40,70,11,1,23,30,111
19,Chucky Atkins,PG,27,DET,79,62,2285,368,790,138,336,230,454,83,120,31,127,158,263,72,11,128,177,957
20,Stacey Augmon,SG,33,CHH,77,3,1319,140,328,0,3,140,325,77,101,59,166,225,103,56,12,54,115,357
21,Isaac Austin,C,32,MEM,21,8,307,36,92,0,3,36,89,4,4,11,60,71,13,9,5,11,36,76
22,William Avery,PG,22,MIN,28,0,258,26,90,6,35,20,55,13,19,4,20,24,36,7,0,19,17,71
23,Dalibor Bagarić,C,21,CHI,50,0,638,72,178,0,1,72,177,41,70,55,107,162,23,17,24,46,108,185
24,Vin Baker,C,30,SEA,55,41,1710,315,649,1,8,314,641,143,226,168,182,350,72,22,36,127,197,774
25,Erick Barkley,PG,23,POR,19,4,228,24,68,1,7,23,61,9,10,5,13,18,34,17,1,12,29,58
26,Dana Barros,PG,34,DET,29,20,582,74,192,24,71,50,121,21,27,1,56,57,78,14,2,33,37,193
27,Brent Barry,SG,30,SEA,81,81,3040,401,790,164,387,237,403,198,234,58,383,441,426,147,37,165,182,1164
28,Jon Barry,SG,32,DET,82,6,1985,255,522,121,258,134,264,108,116,42,192,234,274,94,20,111,134,739
29,Mengke Bateer,C,26,DEN,27,10,408,53,132,4,12,49,120,29,37,32,64,96,22,10,5,32,94,139
30,Tony Battie,C,25,BOS,74,73,1819,211,390,0,2,211,388,88,130,184,297,481,35,60,67,51,219,510
31,Shane Battier,SF,23,MEM,78,78,3097,412,961,103,276,309,685,198,283,180,238,418,216,121,81,155,215,1125
32,Charlie Bell,SG,22,TOT,7,0,44,3,11,0,6,3,5,2,2,2,3,5,2,0,0,5,3,8
33,Raja Bell,SG,25,PHI,74,12,890,103,240,12,44,91,196,36,48,31,80,111,71,21,4,48,109,254
34,Jonathan Bender,SF,21,IND,78,17,1647,198,460,45,125,153,335,140,181,64,180,244,62,19,49,96,147,581
35,Travis Best,PG,29,TOT,74,21,1747,228,518,21,59,207,459,104,116,20,131,151,324,89,7,99,173,581
36,Mike Bibby,PG,23,SAC,80,80,2659,446,985,51,138,395,847,155,193,37,185,222,403,87,15,134,133,1098
37,Chauncey Billups,PG,25,MIN,82,54,2355,348,823,124,315,224,508,207,234,35,191,226,450,66,17,138,169,1027
38,Mookie Blaylock,PG,34,GSW,35,0,599,50,146,15,42,35,104,4,8,8,44,52,114,24,4,37,20,119
39,Corie Blount,PF,33,PHI,72,21,1426,115,251,0,1,115,250,29,45,149,219,368,44,49,26,52,176,259
40,Mark Blount,C,26,BOS,44,0,415,32,76,0,0,32,76,30,37,26,59,85,10,16,19,23,59,94
41,Calvin Booth,C,25,SEA,15,15,279,35,82,0,0,35,82,23,24,20,34,54,16,6,13,16,47,93
42,Ruben Boumtje-Boumtje,C,23,POR,33,1,245,13,32,0,0,13,32,13,25,21,34,55,4,3,16,14,38,39
43,Cal Bowdler,PF,24,ATL,52,0,585,61,174,1,5,60,169,39,47,38,72,110,11,18,15,11,64,162
44,Bruce Bowen,SF,30,SAS,59,59,1699,155,398,56,148,99,250,46,96,42,120,162,88,62,25,66,116,412
45,Ryan Bowen,SF,26,DEN,75,21,1686,147,307,1,12,146,295,69,92,134,165,299,52,75,41,41,171,364
46,Ira Bowman,SG,28,PHI,3,0,29,5,7,0,1,5,6,0,0,0,1,1,1,2,0,0,3,10
47,Earl Boykins,PG,25,LAC,68,2,761,110,275,13,42,97,233,47,61,27,27,54,145,20,2,44,44,280
48,Michael Bradley,PF,22,TOR,26,0,118,13,25,0,2,13,23,4,8,7,17,24,3,0,6,6,10,30
49,Shawn Bradley,C,29,DAL,53,16,757,78,163,0,1,78,162,59,64,53,123,176,20,28,64,25,128,215
50,Elton Brand,PF,22,LAC,80,80,3020,532,1010,0,0,532,1010,389,524,396,529,925,191,80,163,173,254,1453
51,Terrell Brandon,PG,31,MIN,32,28,962,155,365,4,23,151,342,83,84,17,76,93,264,52,6,43,49,397
52,Jamison Brewer,SG,21,IND,13,0,43,2,5,0,1,2,4,0,0,2,6,8,9,2,0,3,3,4
53,Primož Brezec,C,22,IND,22,4,160,14,29,0,0,14,29,15,25,16,12,28,6,0,7,6,28,43
54,Chucky Brown,SF,33,SAC,18,0,92,10,27,0,0,10,27,1,2,10,23,33,6,2,4,5,12,21
55,Damone Brown,SF,22,PHI,17,0,67,8,21,0,1,8,20,7,8,2,2,4,2,1,1,9,11,23
56,Dee Brown,PG,33,ORL,7,0,65,3,20,1,12,2,8,0,0,0,9,9,2,3,1,4,4,7
57,Ernest Brown,C,22,MIA,3,0,21,1,6,0,0,1,6,1,4,1,5,6,0,0,1,3,4,3
58,Kedrick Brown,SF,20,BOS,29,5,245,23,70,5,27,18,43,12,20,11,39,50,15,18,7,7,18,63
59,Kwame Brown,PF,19,WAS,57,3,817,94,243,0,1,94,242,70,99,63,135,198,43,16,26,43,105,258
60,P.J. Brown,C,32,CHH,80,80,2563,250,527,0,0,250,527,169,197,273,513,786,107,59,78,85,222,669
61,Randy Brown,PG,33,BOS,1,0,6,0,1,0,0,0,1,0,0,0,0,0,2,0,1,0,1,0
62,Tierre Brown,SG,22,HOU,40,1,403,49,115,4,12,45,103,21,28,12,30,42,70,19,3,40,26,123
63,Rick Brunson,PG,29,POR,59,2,520,45,113,6,11,39,102,29,41,23,45,68,114,25,2,47,51,125
64,Kobe Bryant,SG,23,LAL,80,80,3063,749,1597,33,132,716,1465,488,589,112,329,441,438,118,35,223,228,2019
65,Mark Bryant,PF,36,SAS,30,3,206,25,55,0,0,25,55,6,8,25,19,44,10,7,2,6,38,56
66,Greg Buckner,SG,25,DAL,44,16,885,104,198,5,16,99,182,40,58,67,106,173,48,31,19,27,124,253
67,Jud Buechler,SF,33,TOT,66,2,684,44,118,21,60,23,58,2,4,29,87,116,32,21,8,15,53,111
68,Rodney Buford,SG,24,MEM,63,21,1769,258,593,17,70,241,523,58,80,52,220,272,71,42,12,63,110,591
69,Matt Bullard,PF,34,CHH,31,0,350,39,115,16,57,23,58,11,12,10,37,47,16,2,2,12,29,105
70,Mitchell Butler,SG,31,POR,11,0,90,10,23,1,3,9,20,8,12,6,8,14,5,0,1,5,10,29
71,Jason Caffey,PF,28,MIL,23,0,283,36,72,0,1,36,71,27,43,24,26,50,12,4,5,19,39,99
72,Marcus Camby,C,27,NYK,29,29,1007,130,290,0,1,130,289,62,99,89,233,322,33,34,50,42,107,322
73,Elden Campbell,PF,33,CHH,77,74,2156,384,794,0,2,384,792,306,384,133,397,530,102,60,137,138,264,1074
74,Brian Cardinal,PF,24,DET,8,0,43,6,13,3,7,3,6,2,2,2,4,6,2,1,0,0,5,17
75,Anthony Carter,PG,26,MIA,46,18,1050,89,260,1,19,88,241,19,36,19,98,117,214,50,3,72,85,198
76,Vince Carter,SG,25,TOR,60,60,2385,559,1307,121,313,438,994,245,307,138,175,313,239,94,43,154,191,1484
77,Sam Cassell,PG,32,MIL,74,73,2605,554,1197,71,204,483,993,282,328,54,258,312,493,90,12,177,208,1461
78,Kelvin Cato,C,27,HOU,75,73,1917,190,326,0,1,190,325,113,194,176,349,525,29,40,95,53,208,493
79,Tyson Chandler,C,19,CHI,71,31,1389,151,304,0,0,151,304,134,222,114,229,343,54,28,93,99,179,436
80,Calbert Cheaney,SG,30,DEN,68,47,1631,224,466,0,4,224,462,46,67,57,183,240,110,34,21,70,156,494
81,Chris Childs,PG,34,TOR,69,4,1576,97,296,33,120,64,176,58,71,18,136,154,351,56,5,123,177,285
82,Doug Christie,SG,31,SAC,81,81,2798,338,735,90,256,248,479,206,242,74,300,374,340,160,25,164,209,972
83,Keon Clark,C,26,TOR,81,31,2185,380,775,0,5,380,770,155,230,182,421,603,88,58,122,140,258,915
84,Speedy Claxton,PG,23,PHI,67,18,1528,181,452,4,33,177,419,114,136,46,114,160,198,95,6,95,145,480
85,Mateen Cleaves,PG,24,SAC,32,0,153,30,68,2,8,28,60,8,9,1,7,8,25,7,0,27,9,70
86,Derrick Coleman,PF,34,PHI,58,58,2080,331,735,28,83,303,652,185,227,167,342,509,98,42,51,119,158,875
87,Bimbo Coles,PG,33,CLE,47,1,693,56,146,4,20,52,126,33,37,12,43,55,107,13,4,31,59,149
88,Jason Collier,C,24,HOU,25,2,365,41,95,0,1,41,94,24,32,31,51,82,9,6,4,13,40,106
89,Jarron Collins,C,23,UTA,70,68,1440,158,343,0,1,158,342,134,181,138,158,296,58,29,22,56,234,450
90,Jason Collins,C,23,NJN,77,9,1407,117,278,1,2,116,276,115,164,132,169,301,81,29,47,72,173,350
91,Chris Crawford,PF,26,ATL,7,4,131,21,45,0,1,21,44,11,15,9,16,25,5,2,5,10,21,53
92,Jamal Crawford,PG,21,CHI,23,6,481,89,187,26,58,63,129,10,13,5,29,34,55,18,5,32,18,214
93,Joe Crispin,PG,22,TOT,21,0,156,26,68,15,39,11,29,12,13,2,9,11,26,5,0,10,10,79
94,Austin Croshere,PF,26,IND,76,1,1286,185,448,49,145,136,303,97,114,74,220,294,77,26,29,67,106,516
95,John Crotty,PG,32,UTA,41,0,802,98,208,31,69,67,139,57,66,16,59,75,141,19,1,51,77,284
96,Vonteego Cummings,PG,25,PHI,58,1,501,78,187,12,46,66,141,24,32,14,38,52,60,18,5,36,53,192
97,Dell Curry,SG,37,TOR,56,4,886,141,347,45,131,96,216,33,37,23,58,81,61,22,6,41,50,360
98,Eddy Curry,C,19,CHI,72,31,1150,189,377,0,0,189,377,105,160,111,161,272,25,16,53,69,173,483
99,Michael Curry,SG,33,DET,82,75,1912,125,276,7,26,118,250,72,91,15,153,168,127,47,10,60,207,329
100,Samuel Dalembert,C,20,PHI,34,0,177,22,50,0,0,22,50,7,18,25,43,68,5,6,13,14,30,51
101,Erick Dampier,C,26,GSW,73,46,1740,209,480,0,0,209,480,136,211,167,220,387,87,17,167,156,235,554
102,Antonio Daniels,SG,26,SAS,82,13,2175,269,612,57,196,212,416,158,210,23,153,176,228,48,12,70,104,753
103,Antonio Davis,PF,33,TOR,77,77,2978,410,963,0,1,410,962,293,358,254,486,740,155,54,83,159,225,1113
104,Baron Davis,PG,22,CHH,82,82,3318,559,1341,170,478,389,863,196,338,93,256,349,698,172,47,246,241,1484
105,Dale Davis,C,32,POR,78,77,2447,296,580,0,0,296,580,150,212,262,426,688,96,62,83,62,193,742
106,Emanual Davis,PG,33,ATL,28,20,774,70,198,29,85,41,113,16,18,19,55,74,68,27,5,52,68,185
107,Hubert Davis,SG,31,WAS,51,17,1231,146,326,57,126,89,200,16,21,7,70,77,107,28,3,44,58,365
108,Ricky Davis,SF,22,CLE,82,8,1954,376,781,11,35,365,746,196,248,63,180,243,178,69,23,148,145,959
109,Andrew DeClercq,C,28,ORL,61,14,633,67,149,0,0,67,149,28,50,74,89,163,22,23,24,34,130,162
110,Vinny Del Negro,PG,35,PHO,2,0,6,1,4,0,0,1,4,0,0,0,0,0,2,0,0,0,0,2
111,Tony Delk,SG,28,TOT,63,17,1447,226,588,67,214,159,374,78,97,58,145,203,132,53,10,59,98,597
112,Derrick Dial,SG,26,TOT,32,0,299,41,120,1,11,40,109,18,24,14,42,56,35,10,4,16,13,101
113,Michael Dickerson,SG,26,MEM,4,4,124,15,48,8,21,7,27,5,6,3,9,12,9,3,1,8,12,43
114,DeSagana Diop,C,20,CLE,18,1,109,12,29,0,0,12,29,1,5,5,12,17,5,1,10,12,19,25
115,Vlade Divac*,C,33,SAC,80,80,2420,338,716,3,13,335,703,209,340,205,466,671,297,79,94,158,229,888
116,Michael Doleac,C,24,CLE,42,15,705,78,187,0,0,78,187,38,46,47,121,168,25,15,11,37,98,194
117,Keyon Dooling,PG,21,LAC,14,0,155,22,57,4,14,18,43,10,12,0,3,3,12,4,3,10,20,58
118,Bryce Drew,PG,27,CHH,61,0,774,78,182,31,73,47,109,23,29,14,58,72,101,32,2,33,49,210
119,Predrag Drobnjak,C,26,SEA,64,12,1174,191,414,0,2,191,412,55,73,75,144,219,51,20,31,51,109,437
120,Chris Dudley,C,36,POR,43,2,327,20,50,0,2,20,48,8,15,27,53,80,13,3,14,14,42,48
121,Tim Duncan,PF,25,SAS,82,82,3329,764,1504,1,10,763,1494,560,701,268,774,1042,307,61,203,263,217,2089
122,Howard Eisley,PG,29,NYK,39,0,609,59,175,14,58,45,117,39,49,9,40,49,100,24,3,53,55,171
123,Obinna Ekezie,PF,26,LAC,29,1,152,13,39,0,0,13,39,28,40,12,22,34,3,2,6,10,16,54
124,LaPhonso Ellis,SF,31,MIA,66,14,1684,189,452,38,124,151,328,53,84,107,180,287,56,30,37,73,196,469
125,Evan Eschmeyer,C,26,DAL,31,6,299,21,50,0,0,21,50,20,33,35,63,98,9,10,9,16,60,62
126,Maurice Evans,SG,23,MIN,10,0,45,9,19,0,3,9,16,3,4,3,1,4,4,0,0,2,9,21
127,Patrick Ewing*,C,39,ORL,65,4,901,148,333,0,1,148,332,94,134,60,203,263,35,22,45,65,129,390
128,Danny Ferry,SF,35,SAS,50,2,799,76,177,43,99,33,78,34,36,15,75,90,48,16,9,22,70,229
129,Michael Finley,SF,28,DAL,69,69,2754,569,1228,76,224,493,1004,210,251,90,270,360,230,65,25,117,144,1424
130,Derek Fisher,PG,27,LAL,70,35,1974,274,666,144,349,130,317,94,111,15,131,146,181,66,9,62,121,786
131,Marcus Fizer,PF,23,CHI,76,20,1963,371,848,7,41,364,807,189,283,128,299,427,120,49,24,131,186,938
132,Isaac Fontaine,SG,26,MEM,6,0,75,3,14,1,5,2,9,4,6,0,5,5,4,0,0,4,6,11
133,Alton Ford,PF,20,PHO,53,0,452,61,118,0,0,61,118,42,57,32,75,107,7,6,7,32,99,164
134,Joseph Forte,SG,20,BOS,8,0,39,1,12,0,3,1,9,4,4,1,5,6,6,2,0,3,1,6
135,Danny Fortson,PF,25,GSW,77,76,2216,309,722,1,4,308,718,245,308,290,609,899,127,44,17,160,255,864
136,Greg Foster,PF,33,MIL,6,0,24,2,9,0,4,2,5,3,4,0,8,8,1,0,0,0,4,7
137,Jeff Foster,C,25,IND,82,48,1786,177,394,2,15,175,379,111,182,206,350,556,70,71,38,79,232,467
138,Antonis Fotsis,PF,20,MEM,28,1,320,42,104,7,23,35,81,17,20,25,37,62,10,9,11,21,22,108
139,Tremaine Fowlkes,SF,25,LAC,22,17,343,25,64,0,0,25,64,24,31,32,32,64,17,11,1,13,39,74
140,Rick Fox,SF,32,LAL,82,82,2289,255,605,65,208,190,397,70,85,90,299,389,283,67,21,132,244,645
141,Adonal Foyle,C,26,GSW,79,36,1485,171,385,0,0,171,385,37,93,150,234,384,41,36,168,76,179,379
142,Steve Francis,PG,24,HOU,57,56,2343,420,1007,68,210,352,797,326,422,102,299,401,362,71,25,221,172,1234
143,Lawrence Funderburke,PF,31,SAC,56,1,722,115,245,0,3,115,242,34,56,76,122,198,32,11,18,33,65,264
144,Kevin Garnett,PF,25,MIN,81,81,3175,659,1401,37,116,622,1285,359,448,243,738,981,422,96,126,229,184,1714
145,Dean Garrett,C,35,TOT,34,0,183,18,55,0,0,18,55,0,3,16,41,57,5,7,10,10,32,36
146,Pat Garrity,PF,25,ORL,80,43,2406,327,767,169,396,158,371,61,73,77,261,338,99,61,28,68,230,884
147,Pau Gasol,C,21,MEM,82,79,3007,551,1064,1,5,550,1059,338,477,238,492,730,223,41,169,224,195,1441
148,Chris Gatling,PF,34,MIA,54,1,809,131,293,1,8,130,285,82,117,71,135,206,25,17,11,58,109,345
149,Matt Geiger,C,32,PHI,4,0,36,1,8,0,0,1,8,1,2,3,3,6,0,0,2,2,2,3
150,Devean George,SF,24,LAL,82,1,1759,215,523,66,178,149,345,85,126,78,225,303,111,71,42,66,190,581
151,Eddie Gill,PG,23,MEM,23,5,384,39,92,7,22,32,70,31,39,7,21,28,49,11,3,34,38,116
152,Kendall Gill,SG,33,MIA,65,49,1410,162,422,6,44,156,378,42,62,29,155,184,100,44,8,55,140,372
153,Dion Glover,SG,23,ATL,55,25,1156,192,456,30,91,162,365,78,103,36,133,169,84,45,14,76,89,492
154,Steve Goodrich,SF,25,NJN,9,0,50,2,10,0,0,2,10,1,2,1,4,5,5,1,2,3,10,5
155,Brian Grant,PF,29,MIA,72,72,2256,286,610,0,2,286,608,101,119,168,407,575,137,48,31,122,236,673
156,Horace Grant,C,36,ORL,76,76,2210,264,515,0,0,264,515,80,111,159,322,481,104,57,49,51,118,608
157,Adrian Griffin,SG,27,DAL,58,34,1383,179,359,16,54,163,305,41,49,68,161,229,106,75,12,42,142,415
158,Eddie Griffin,PF,19,HOU,73,24,1896,244,666,90,273,154,393,64,86,117,299,416,53,17,134,47,117,642
159,Tom Gugliotta,PF,32,PHO,44,40,1129,127,301,3,9,124,292,28,37,59,162,221,77,39,30,61,116,285
160,A.J. Guyton,PG,23,CHI,45,6,607,88,244,46,123,42,121,22,27,12,32,44,81,10,7,37,23,244
161,Darvin Ham,SF,28,MIL,70,2,1208,120,211,1,7,119,204,62,123,91,111,202,73,25,37,83,175,303
162,Richard Hamilton,SG,23,WAS,63,57,2203,472,1084,16,42,456,1042,300,337,73,143,216,171,38,14,132,136,1260
163,Tang Hamilton,SF,23,MIA,9,2,98,10,19,0,1,10,18,0,1,6,12,18,5,4,0,2,10,20
164,Zendon Hamilton,PF,26,DEN,54,15,848,103,245,0,0,103,245,118,181,110,143,253,14,21,18,60,104,324
165,Anfernee Hardaway,SG,30,PHO,80,55,2462,389,931,23,83,366,848,158,195,98,252,350,324,122,32,189,184,959
166,Tim Hardaway,PG,35,TOT,68,16,1601,226,620,123,354,103,266,77,97,14,110,124,278,57,10,111,109,652
167,Matt Harpring,SF,25,PHI,81,81,2541,386,838,21,69,365,769,165,222,203,370,573,107,70,5,127,201,958
168,Al Harrington,PF,21,IND,44,1,1313,230,484,1,3,229,481,115,144,96,180,276,54,41,21,78,166,576
169,Othella Harrington,PF,28,NYK,77,4,1563,237,450,0,2,237,448,122,172,125,224,349,37,30,36,95,250,596
170,Lucious Harris,SG,31,NJN,74,0,1553,249,537,44,118,205,419,133,158,49,158,207,116,53,6,61,99,675
171,Jason Hart,PG,23,SAS,10,0,92,10,19,0,2,10,17,6,6,4,9,13,12,7,1,8,16,26
172,Antonio Harvey,PF,31,SEA,5,3,47,4,12,0,0,4,12,1,2,5,4,9,5,1,3,3,8,9
173,Donnell Harvey,PF,21,TOT,47,4,841,108,217,0,0,108,217,54,90,80,147,227,37,21,24,33,115,270
174,Trenton Hassell,SG,22,CHI,78,47,2237,267,628,60,165,207,463,87,114,65,190,255,172,55,44,101,184,681
175,Kirk Haston,PF,22,CHH,15,0,77,11,39,0,3,11,36,4,8,5,15,20,5,0,1,3,9,26
176,Brendan Haywood,C,22,WAS,62,2,1266,109,221,0,0,109,221,97,160,143,179,322,29,21,91,50,158,315
177,Alan Henderson,PF,29,ATL,26,1,422,59,116,1,1,58,115,24,45,31,66,97,11,11,15,21,40,143
178,Cedric Henderson,SF,26,GSW,12,0,70,15,31,2,4,13,27,4,7,1,2,3,4,6,2,8,4,36
179,Grant Hill*,SF,29,ORL,14,14,512,83,195,0,2,83,193,69,80,29,96,125,64,8,4,37,40,235
180,Tyrone Hill,PF,33,CLE,26,26,810,71,182,0,1,71,181,67,103,79,195,274,23,17,13,48,102,209
181,Fred Hoiberg,SG,29,CHI,79,8,1408,121,291,24,92,97,199,79,94,18,192,210,136,61,5,32,87,345
182,Robert Horry,PF,31,LAL,81,23,2140,183,460,76,203,107,257,108,138,130,349,479,232,77,89,88,208,550
183,Eddie House,PG,23,MIA,64,3,1230,209,524,54,157,155,367,42,49,17,93,110,123,43,5,80,98,514
184,Allan Houston,SG,30,NYK,77,77,2914,568,1301,136,346,432,955,295,339,37,215,252,190,54,10,170,182,1567
185,Juwan Howard,PF,28,TOT,81,72,2635,462,1005,0,2,462,1003,261,343,223,389,612,169,46,47,152,265,1185
186,Troy Hudson,PG,25,ORL,81,4,1854,354,815,66,187,288,628,176,201,30,115,145,255,57,6,163,119,950
187,Larry Hughes,SG,23,GSW,73,56,2049,343,810,18,93,325,717,191,259,83,162,245,316,113,23,171,150,895
188,Lindsey Hunter,PG,31,LAL,82,47,1616,187,490,79,208,108,282,20,40,18,103,121,129,66,19,55,120,473
189,Steven Hunter,C,20,ORL,53,21,516,67,147,0,0,67,147,55,94,40,57,97,5,5,43,16,81,189
190,Zydrunas Ilgauskas,C,26,CLE,62,23,1329,241,567,0,5,241,562,208,276,136,198,334,70,17,84,94,187,690
191,Allen Iverson*,SG,26,PHI,60,59,2622,665,1669,78,268,587,1401,475,585,44,225,269,331,168,13,237,102,1883
192,Bobby Jackson,PG,28,SAC,81,3,1750,334,754,79,219,255,535,149,184,82,169,251,164,73,11,93,145,896
193,Jaren Jackson,SG,34,ORL,9,0,144,15,37,7,20,8,17,2,4,1,16,17,8,5,0,8,13,39
194,Jermaine Jackson,SG,25,TOR,24,0,280,20,42,1,2,19,40,16,24,3,24,27,57,9,1,14,24,57
195,Jim Jackson,SF,31,MIA,55,19,1825,238,538,38,81,200,457,75,87,54,236,290,140,42,14,106,145,589
196,Marc Jackson,C,27,TOT,39,0,495,60,164,0,1,60,163,66,80,48,80,128,14,11,6,30,69,186
197,Mark Jackson,PG,36,NYK,82,82,2367,260,592,79,195,181,397,87,110,56,253,309,605,74,1,150,162,686
198,Stephen Jackson,SF,23,SAS,23,1,227,34,91,9,36,25,55,12,17,3,23,26,11,15,3,23,29,89
199,Jerome James,C,26,SEA,56,40,949,134,273,0,0,134,273,30,60,89,143,232,24,25,86,74,174,298
200,Mike James,PG,26,MIA,15,0,119,15,43,8,21,7,22,4,7,2,12,14,19,6,1,13,17,42
201,Tim James,SF,25,PHI,9,0,41,5,13,0,0,5,13,2,6,5,2,7,1,0,1,3,5,12
202,Antawn Jamison,SF,25,GSW,82,82,3033,614,1375,68,210,546,1165,323,440,211,345,556,161,70,45,161,187,1619
203,Harold Jamison,PF,25,LAC,25,2,176,22,43,0,0,22,43,10,15,24,15,39,6,5,1,6,23,54
204,Richard Jefferson,SF,21,NJN,79,9,1917,270,591,13,56,257,535,189,265,85,208,293,140,64,48,107,211,742
205,Anthony Johnson,SG,27,NJN,34,0,366,37,90,4,12,33,78,16,25,10,19,29,48,31,1,20,30,94
206,Avery Johnson,PG,36,TOT,68,13,1352,207,432,0,5,207,427,121,163,14,55,69,286,40,9,76,86,535
207,DerMarr Johnson,SF,21,ATL,72,46,1727,214,540,89,247,125,293,85,105,59,188,247,81,62,56,102,163,602
208,Ervin Johnson,C,34,MIL,81,9,1660,89,193,0,1,89,192,30,66,142,324,466,27,37,82,52,219,208
209,Joe Johnson,SG,20,TOT,77,60,1916,251,584,38,130,213,454,41,53,75,182,257,179,59,20,71,114,581
210,Alvin Jones,C,23,PHI,23,2,126,8,20,0,0,8,20,10,20,13,23,36,3,3,9,11,35,26
211,Damon Jones,PG,25,DET,67,0,1083,114,284,69,186,45,98,43,59,13,90,103,140,23,1,61,83,340
212,Eddie Jones,SG,30,MIA,81,81,3156,517,1198,149,382,368,816,297,355,61,317,378,262,117,77,148,258,1480
213,Jumaine Jones,PF,22,CLE,81,36,2142,287,640,52,168,235,472,45,68,125,365,490,116,75,46,79,184,671
214,Popeye Jones,PF,31,WAS,79,40,1920,222,508,4,11,218,497,106,130,233,345,578,127,50,19,88,209,554
215,Michael Jordan*,SF,38,WAS,60,53,2093,551,1324,10,53,541,1271,263,333,50,289,339,310,85,26,162,119,1375
216,Shawn Kemp,PF,32,POR,75,5,1232,175,407,0,4,175,403,104,131,90,198,288,52,43,33,81,184,454
217,Steve Kerr,PG,36,POR,65,0,775,102,217,26,66,76,151,39,40,6,54,60,63,13,1,24,49,269
218,Jason Kidd*,PG,28,NJN,82,82,3056,445,1138,117,364,328,774,201,247,130,465,595,808,175,20,286,136,1208
219,Andrei Kirilenko,SF,20,UTA,82,40,2151,285,633,25,100,260,533,285,371,149,253,402,94,116,159,108,156,880
220,Kerry Kittles,SG,27,NJN,82,82,2601,438,940,98,242,340,698,128,172,68,207,275,216,130,31,109,108,1102
221,Brevin Knight,PG,26,MEM,53,11,1151,141,334,2,8,139,326,87,115,11,98,109,302,79,7,111,135,371
222,Travis Knight,C,27,NYK,49,0,429,41,113,0,0,41,113,16,21,48,56,104,8,11,10,27,95,98
223,Toni Kukoč,SF,33,ATL,59,9,1494,211,504,53,171,158,333,109,153,43,175,218,210,48,17,113,91,584
224,Christian Laettner,PF,32,WAS,57,48,1441,168,362,2,10,166,352,66,76,74,227,301,151,60,25,85,129,404
225,Raef LaFrentz,C,25,TOT,78,76,2455,421,920,104,268,317,652,105,151,176,403,579,89,55,213,94,281,1051
226,Trajan Langdon,SG,25,CLE,44,0,477,70,176,27,74,43,102,42,46,13,42,55,60,13,5,40,49,209
227,Dan Langhi,SF,24,HOU,34,8,434,49,125,1,4,48,121,8,11,22,45,67,14,8,5,9,25,107
228,Rusty LaRue,PG,28,UTA,33,0,542,73,185,17,50,56,135,30,35,11,38,49,71,17,7,43,58,193
229,Voshon Lenard,SG,28,DEN,71,19,1665,315,769,89,240,226,529,94,120,38,145,183,130,59,25,91,105,813
230,Quincy Lewis,SG,24,UTA,36,19,490,64,143,3,18,61,125,13,20,10,33,43,36,23,9,32,89,144
231,Rashard Lewis,SF,22,SEA,71,70,2585,455,972,123,316,332,656,162,200,139,359,498,123,104,40,97,174,1195
232,Randy Livingston,PG,26,SEA,13,0,176,15,54,1,8,14,46,10,11,9,16,25,26,9,2,2,11,41
233,Art Long,PF,29,SEA,63,27,989,120,244,0,0,120,244,45,85,107,144,251,41,22,28,63,180,285
234,Grant Long,PF,35,MEM,66,56,1868,164,385,3,17,161,368,86,123,31,200,231,136,63,12,103,123,417
235,Felipe López,SG,27,MIN,67,0,581,59,156,14,33,45,123,37,55,29,51,80,39,18,1,36,73,169
236,Tyronn Lue,PG,24,WAS,71,0,1458,222,520,63,141,159,379,48,63,14,108,122,246,49,0,96,120,555
237,George Lynch,SF,31,CHH,45,18,893,73,198,1,6,72,192,25,40,70,116,186,54,40,14,41,75,172
238,Todd MacCulloch,C,26,NJN,62,61,1502,247,465,0,0,247,465,110,164,157,221,378,78,24,89,66,181,604
239,Sam Mack,SF,31,MIA,12,1,159,14,49,7,28,7,21,5,7,2,12,14,4,5,1,7,17,40
240,Mark Madsen,PF,26,LAL,59,5,650,66,146,0,2,66,144,35,54,89,73,162,44,16,13,22,104,167
241,Corey Maggette,SG,22,LAC,63,52,1615,235,530,46,139,189,391,201,251,54,177,231,112,41,19,116,155,717
242,Jamaal Magloire,C,23,CHH,82,8,1549,228,414,0,1,228,413,243,333,153,308,461,31,27,86,118,201,699
243,Dan Majerle,SG,36,PHO,65,1,1180,99,289,79,235,20,54,23,39,28,148,176,90,48,15,35,104,300
244,Karl Malone*,PF,38,UTA,80,80,3040,635,1399,9,25,626,1374,509,639,142,544,686,341,152,59,263,229,1788
245,Danny Manning,PF,35,DAL,41,10,552,71,149,1,7,70,142,22,33,25,83,108,30,21,21,25,80,165
246,Stephon Marbury,PG,24,PHO,82,80,3187,625,1413,71,248,554,1165,353,452,75,191,266,666,77,13,284,186,1674
247,Shawn Marion,SF,23,PHO,81,81,3109,654,1395,48,122,606,1273,191,226,211,592,803,162,149,86,144,214,1547
248,Sean Marks,C,26,MIA,21,6,319,38,88,0,0,38,88,20,34,19,56,75,8,5,10,19,40,96
249,Donny Marshall,SF,29,NJN,20,0,118,8,29,2,4,6,25,12,18,8,13,21,5,3,0,2,14,30
250,Donyell Marshall,SF,28,UTA,58,42,1750,343,661,13,42,330,619,160,226,158,285,443,101,50,67,124,150,859
251,Darrick Martin,PG,30,DAL,3,0,22,0,10,0,2,0,8,1,2,0,1,1,3,2,0,1,4,1
252,Kenyon Martin,PF,24,NJN,73,73,2504,445,962,15,67,430,895,181,267,113,275,388,192,90,121,172,261,1086
253,Jamal Mashburn,SF,29,CHH,40,40,1601,303,744,41,112,262,632,211,241,31,211,242,171,45,6,110,80,858
254,Anthony Mason,PF,35,MIL,82,82,3143,316,626,1,1,315,625,154,221,124,522,646,346,57,22,130,187,787
255,Desmond Mason,SF,24,SEA,75,20,2420,357,769,16,59,341,710,201,237,92,259,351,104,67,27,104,170,931
256,Tony Massenburg,PF,34,MEM,73,31,1247,159,349,1,1,158,348,84,117,100,224,324,26,30,31,65,174,403
257,Walter McCarty,PF,27,BOS,56,0,718,80,180,39,99,41,81,13,19,32,96,128,41,18,7,22,83,212
258,Amal McCaskill,C,28,SAS,27,0,153,20,49,0,0,20,49,12,26,16,20,36,4,6,10,14,23,52
259,George McCloud,SF,34,DEN,69,26,1830,206,576,60,222,146,354,132,163,67,184,251,204,58,19,144,175,604
260,Jelani McCoy,C,24,LAL,21,0,104,12,21,0,0,12,21,2,8,8,17,25,7,0,5,8,14,26
261,Antonio McDyess,PF,27,DEN,10,10,236,43,75,0,0,43,75,27,33,18,37,55,18,10,8,20,20,113
262,Tracy McGrady*,SG,22,ORL,76,76,2912,715,1586,103,283,612,1303,415,555,150,447,597,400,119,73,189,139,1948
263,Jeff McInnis,PG,27,LAC,81,80,3030,463,1121,75,234,388,887,183,219,45,168,213,500,63,6,147,202,1184
264,Derrick McKey,SF,35,PHI,41,1,784,52,122,5,12,47,110,10,14,48,79,127,45,41,4,22,90,119
265,Aaron McKie,SG,29,PHI,48,16,1471,220,490,51,128,169,362,96,122,26,166,192,179,56,14,93,74,587
266,Stanislav Medvedenko,C,22,LAL,71,6,729,145,304,0,4,145,300,41,62,85,73,158,43,29,11,42,119,331
267,Ron Mercer,SG,25,TOT,53,41,1716,311,784,18,62,293,722,95,119,50,128,178,128,32,13,88,108,735
268,Chris Mihm,C,22,CLE,74,60,1659,221,526,3,7,218,519,124,179,133,259,392,24,18,89,97,260,569
269,Darius Miles,SF,20,LAC,82,6,2227,309,642,3,19,306,623,158,255,109,344,453,184,71,103,160,184,779
270,Andre Miller,PG,25,CLE,81,81,3023,474,1045,22,87,452,958,365,447,108,271,379,882,126,34,245,228,1335
271,Brad Miller,C,25,TOT,76,75,2263,366,733,3,7,363,726,297,383,252,369,621,152,76,41,115,244,1032
272,Mike Miller,SF,21,ORL,63,53,2123,351,802,116,303,235,499,138,181,49,224,273,198,47,23,108,145,956
273,Reggie Miller*,SG,36,IND,79,79,2889,414,913,180,443,234,470,296,325,23,196,219,253,88,10,120,143,1304
274,Chris Mills,SF,32,GSW,66,0,1237,178,427,48,127,130,300,85,107,51,139,190,72,31,13,56,120,489
275,Sam Mitchell,SF,38,MIN,74,10,726,98,227,10,35,88,192,38,49,18,64,82,45,12,4,26,79,244
276,Cuttino Mobley,SG,26,HOU,74,74,3116,595,1358,149,377,446,981,267,314,63,237,300,187,109,37,180,189,1606
277,Nazr Mohammed,C,24,ATL,82,73,2168,329,713,0,1,329,712,137,222,242,409,651,33,63,61,118,252,795
278,Jérôme Moïso,C,23,CHH,15,0,76,8,20,0,0,8,20,0,0,4,21,25,4,3,2,8,12,16
279,Eric Montross,C,30,TOR,49,24,655,53,132,0,1,53,131,10,31,36,104,140,16,12,23,25,92,116
280,Mikki Moore,C,26,DET,30,0,217,29,61,1,2,28,59,20,26,22,31,53,11,7,9,14,35,79
281,Terence Morris,SF,23,HOU,68,12,1110,111,289,15,78,96,211,18,28,77,134,211,64,21,27,45,72,255
282,Hanno Möttölä,C,25,ATL,82,14,1371,169,384,1,13,168,371,57,76,81,187,268,50,20,19,70,174,396
283,Alonzo Mourning*,C,31,MIA,75,74,2455,447,866,1,3,446,863,283,431,182,450,632,87,27,186,182,258,1178
284,Troy Murphy,PF,21,GSW,82,4,1448,178,423,3,9,175,414,121,156,99,223,322,70,36,21,84,217,480
285,Lamond Murray,SF,28,CLE,71,68,2312,430,986,101,238,329,748,215,263,81,291,372,157,70,43,141,148,1176
286,Tracy Murray,SF,30,TOR,40,3,473,85,207,40,104,45,103,17,21,18,35,53,19,11,8,25,38,227
287,Dikembe Mutombo*,C,35,PHI,80,80,2907,321,641,0,0,321,641,278,364,254,609,863,83,29,190,156,242,920
288,Mamadou N'Diaye,C,26,TOR,5,0,46,6,10,0,0,6,10,8,10,6,5,11,0,0,2,1,6,20
289,Lee Nailon,SF,26,CHH,79,41,1912,369,764,1,2,368,762,112,150,103,188,291,94,59,17,96,175,851
290,Eduardo Nájera,PF,25,DAL,62,11,1357,150,300,0,2,150,298,100,148,149,193,342,38,56,30,40,156,400
291,Steve Nash*,PG,27,DAL,82,82,2837,525,1088,156,343,369,745,260,293,50,204,254,634,53,4,229,164,1466
292,Tyrone Nesby,SF,26,WAS,70,9,1498,183,421,13,47,170,374,64,93,105,213,318,91,61,22,49,164,443
293,Rasho Nesterović,C,25,MIN,82,82,2218,324,657,0,1,324,656,39,71,200,334,534,75,45,109,94,262,687
294,Ira Newble,SF,27,ATL,42,35,1273,131,263,1,7,130,256,75,88,80,142,222,45,38,20,49,117,338
295,Johnny Newman,SF,38,DAL,47,17,724,67,148,22,57,45,91,42,58,9,40,49,14,29,4,21,88,198
296,Moochie Norris,PG,28,HOU,82,26,2249,251,631,36,134,215,497,127,169,73,173,246,403,81,4,156,130,665
297,Dirk Nowitzki,C,23,DAL,76,76,2891,600,1258,139,350,461,908,440,516,120,635,755,186,83,77,145,222,1779
298,Jermaine O'Neal,PF,23,IND,72,72,2707,543,1133,1,14,542,1119,284,413,188,569,757,118,45,166,174,269,1371
299,Shaquille O'Neal*,C,29,LAL,67,66,2422,712,1229,0,1,712,1228,398,717,235,480,715,200,41,137,171,199,1822
300,Charles Oakley,PF,38,CHI,57,36,1383,97,263,1,6,96,257,21,28,72,271,343,114,49,11,87,175,216
301,Lamar Odom,SF,22,LAC,29,25,999,151,360,16,84,135,276,61,93,31,145,176,171,23,36,97,91,379
302,Hakeem Olajuwon*,C,39,TOR,61,37,1378,194,418,0,2,194,416,47,84,98,268,366,66,74,90,98,147,435
303,Dean Oliver,PG,23,GSW,20,0,139,17,46,2,13,15,33,6,9,0,8,8,21,3,0,11,16,42
304,Kevin Ollie,PG,29,TOT,81,17,1723,137,353,1,2,136,351,187,227,25,159,184,291,62,2,106,97,462
305,Michael Olowokandi,C,26,LAC,80,79,2568,384,886,0,0,384,886,117,188,164,547,711,90,55,145,175,217,885
306,Greg Ostertag,C,28,UTA,74,14,1107,91,201,0,0,91,201,63,130,125,188,313,50,15,109,51,152,245
307,Bo Outlaw,PF,30,TOT,83,36,1928,166,299,1,2,165,297,43,102,147,217,364,127,70,92,96,205,376
308,Doug Overton,PG,32,LAC,18,0,130,14,44,7,27,7,17,4,7,1,11,12,13,3,1,12,10,39
309,Olumide Oyedeji,C,20,SEA,36,1,221,22,41,0,0,22,41,11,18,27,52,79,4,4,2,14,36,55
310,Robert Pack,PG,32,MIN,16,0,252,25,68,1,4,24,64,11,15,7,16,23,49,13,0,20,32,62
311,Scott Padgett,PF,25,UTA,75,1,1295,188,395,49,113,139,282,75,102,111,174,285,82,43,13,69,140,500
313,Tony Parker,PG,19,SAS,77,72,2267,268,639,61,189,207,450,108,160,33,164,197,334,89,7,151,166,705
314,Cherokee Parks,C,29,SAS,42,1,234,30,83,0,0,30,83,3,8,24,34,58,10,7,8,14,34,63
315,Ruben Patterson,SF,26,POR,75,13,1765,319,619,9,36,310,583,192,274,155,143,298,107,79,37,114,140,839
316,Gary Payton*,PG,33,SEA,82,82,3301,737,1578,74,236,663,1342,267,335,80,316,396,737,131,26,209,179,1815
317,Anthony Peeler,SG,32,MIN,82,0,2060,288,684,111,283,177,401,50,58,37,169,206,177,61,11,76,137,737
318,Mike Penberthy,PG,27,LAL,3,0,12,1,2,0,0,1,2,3,4,0,2,2,2,2,0,0,0,5
319,Elliot Perry,PG,32,MEM,2,0,48,5,10,0,0,5,10,1,2,0,4,4,7,3,0,7,6,11
320,Wesley Person,SG,30,CLE,78,78,2793,467,944,143,322,324,622,99,124,50,244,294,173,77,37,74,93,1176
321,Morris Peterson,SF,24,TOR,63,56,1988,336,768,84,231,252,537,127,169,91,132,223,153,73,11,86,174,883
322,Eric Piatkowski,SG,31,LAC,71,64,1718,207,471,111,238,96,233,101,113,43,141,184,112,41,12,64,110,626
323,Paul Pierce,SG,24,BOS,82,82,3302,707,1598,210,520,497,1078,520,643,81,485,566,261,154,86,241,237,2144
324,Scottie Pippen*,SF,36,POR,62,60,1996,246,599,54,177,192,422,113,146,77,244,321,363,101,35,171,162,659
325,Scot Pollard,C,26,SAC,80,29,1881,197,358,0,0,197,358,115,166,188,377,565,53,70,76,68,202,509
326,Mark Pope,PF,29,MIL,45,12,426,36,91,4,25,32,66,11,21,20,53,73,17,11,11,15,47,87
327,Terry Porter,PG,38,SAS,72,0,1294,136,321,59,142,77,179,68,83,12,152,164,205,45,16,85,89,399
328,James Posey,SF,25,DEN,73,63,2238,277,736,67,237,210,499,161,203,109,320,429,180,114,39,127,224,782
329,Lavor Postell,SG,23,NYK,23,0,179,28,84,6,26,22,58,31,41,2,14,16,5,6,0,11,7,93
330,Vitaly Potapenko,C,26,BOS,79,9,1343,137,301,0,0,137,301,89,120,167,180,347,30,37,18,63,174,363
331,Brent Price,PG,33,SAC,20,0,89,9,27,4,15,5,12,9,13,4,4,8,9,3,1,10,13,31
332,Joel Przybilla,C,22,MIL,71,62,1128,76,142,0,1,76,141,38,90,78,205,283,21,20,118,43,199,190
333,Vladimir Radmanović,PF,21,SEA,61,16,1230,146,354,66,157,80,197,49,72,45,185,230,81,56,24,72,119,407
334,Zach Randolph,PF,20,POR,41,0,238,48,107,0,0,48,107,18,27,31,38,69,13,7,4,15,29,114
335,Theo Ratliff,C,28,ATL,3,2,82,10,20,0,0,10,20,6,11,5,11,16,1,1,8,7,8,26
336,Željko Rebrača,C,29,DET,74,4,1179,189,374,0,0,189,374,135,175,84,206,290,38,28,73,84,192,513
338,Michael Redd,SG,22,MIL,67,8,1417,294,609,88,198,206,411,91,115,77,147,224,91,42,7,57,96,767
339,Don Reid,PF,28,ORL,68,5,714,90,190,0,0,90,190,44,68,65,111,176,27,20,44,54,180,224
340,Glen Rice,SF,34,HOU,20,20,606,65,167,18,64,47,103,24,30,5,42,47,31,12,3,24,34,172
341,Jason Richardson,SG,21,GSW,80,75,2629,464,1090,82,246,382,844,141,210,124,216,340,236,106,31,160,195,1151
342,Norm Richardson,SG,22,TOT,11,0,67,10,26,4,8,6,18,6,9,3,5,8,2,0,0,3,5,30
343,Quentin Richardson,SG,21,LAC,81,0,2152,400,926,133,349,267,577,143,187,113,221,334,128,78,21,102,142,1076
344,Mitch Richmond*,SG,36,LAL,64,2,709,100,247,18,62,82,185,42,44,14,80,94,57,18,6,40,61,260
345,Isaiah Rider,SG,30,DEN,10,1,173,37,81,6,15,31,66,13,17,10,23,33,12,3,2,14,11,93
346,Clifford Robinson,PF,35,DET,80,80,2855,454,1069,115,304,339,765,143,206,79,307,386,202,89,95,151,243,1166
347,David Robinson*,C,36,SAS,78,78,2303,341,672,0,0,341,672,269,395,191,456,647,94,86,140,104,193,951
348,Eddie Robinson,SF,25,CHI,29,12,653,112,247,2,5,110,242,36,48,24,54,78,37,23,11,36,35,262
349,Glenn Robinson,SF,29,MIL,66,63,2346,536,1147,58,178,478,969,236,282,70,336,406,168,97,41,174,173,1366
350,Larry Robinson,SG,34,NYK,2,0,10,1,4,1,2,0,2,0,0,0,2,2,0,0,0,0,1,3
351,Carlos Rogers,C,30,IND,22,1,168,24,43,1,6,23,37,10,19,14,24,38,3,5,6,5,17,59
352,Rodney Rogers,SF,30,TOT,77,8,1880,356,756,88,235,268,521,117,149,129,219,348,112,66,29,108,226,917
353,Sean Rooks,C,32,LAC,61,2,728,81,194,0,0,81,194,21,29,32,92,124,25,12,21,20,114,183
354,Jalen Rose,SF,29,TOT,83,83,3153,663,1458,89,246,574,1212,281,335,43,330,373,355,78,45,201,251,1696
355,Malik Rose,PF,27,SAS,82,1,1725,293,633,1,12,292,621,185,257,172,320,492,61,70,42,140,208,772
356,Michael Ruffin,PF,25,PHI,15,0,169,7,26,0,0,7,26,2,8,23,28,51,5,5,8,11,23,16
357,Bryon Russell,SG,31,UTA,66,40,1998,222,584,77,226,145,358,115,140,79,216,295,136,64,19,110,205,636
358,Daniel Santiago,C,25,PHO,3,0,24,4,8,0,0,4,8,0,0,0,7,7,2,0,1,2,4,8
359,Jeryl Sasser,SG,22,ORL,7,0,36,3,14,0,0,3,14,4,5,3,4,7,2,3,0,2,3,10
360,Kenny Satterfield,PG,20,DEN,36,4,560,73,199,7,27,66,172,36,46,17,35,52,108,31,1,53,43,189
361,Brian Scalabrine,PF,23,NJN,28,0,290,23,67,3,10,20,57,11,15,12,39,51,21,9,2,24,39,60
362,Shawnelle Scott,C,29,DEN,21,10,252,37,75,0,0,37,75,8,20,53,50,103,8,3,6,15,49,82
363,Ansu Sesay,SF,25,SEA,9,0,142,22,44,0,0,22,44,14,20,7,13,20,8,3,2,2,18,58
364,Brian Shaw,PG,35,LAL,58,0,631,61,173,29,88,32,85,18,26,19,93,112,89,25,3,32,43,169
365,Bobby Simmons,SF,21,WAS,30,3,343,43,95,4,14,39,81,22,30,25,27,52,17,13,5,14,31,112
366,Dickey Simpkins,PF,29,ATL,1,0,3,0,0,0,0,0,0,0,0,0,0,0,1,0,0,0,0,0
367,Brian Skinner,PF,25,CLE,65,8,1107,88,162,0,0,88,162,48,79,93,188,281,17,24,61,42,130,224
368,Reggie Slater,PF,31,TOT,8,0,47,7,15,0,0,7,15,7,10,5,4,9,1,1,1,1,3,21
369,Charles Smith,SG,26,SAS,60,22,1141,182,428,35,131,147,297,42,65,34,99,133,80,52,44,59,114,441
370,Jabari Smith,C,24,TOT,23,0,181,26,63,0,3,26,60,21,32,8,20,28,11,6,6,5,31,73
371,Joe Smith,C,26,MIN,72,63,1922,297,581,2,3,295,578,171,206,152,301,453,82,39,59,86,250,767
372,Leon Smith,C,21,ATL,14,0,100,10,26,0,0,10,26,11,17,10,21,31,3,5,1,3,12,31
373,Steve Smith,SG,32,SAS,77,76,2211,310,682,116,246,194,436,159,181,45,148,193,151,54,15,108,158,895
374,Eric Snow,PG,28,PHI,61,61,2225,276,624,3,27,273,597,183,227,33,182,215,400,95,9,138,167,738
375,Will Solomon,SG,23,MEM,62,4,872,113,331,46,162,67,169,49,73,12,56,68,92,35,7,62,76,321
376,Felton Spencer,C,34,NYK,32,8,248,6,26,0,0,6,26,17,33,16,34,50,3,7,8,12,73,29
377,Latrell Sprewell,SF,31,NYK,81,81,3326,573,1419,145,403,428,1016,284,346,59,239,298,313,94,14,223,161,1575
378,Jerry Stackhouse,SF,27,DET,76,76,2685,524,1319,86,300,438,1019,495,577,77,238,315,403,77,37,266,163,1629
379,John Starks,SG,36,UTA,66,1,929,114,310,29,95,85,215,33,41,15,53,68,70,33,0,52,126,290
380,Vladimir Stepania,C,25,MIA,67,4,884,117,249,1,2,116,247,50,104,100,170,270,16,24,44,52,103,285
381,DeShawn Stevenson,SG,20,UTA,67,23,1134,143,371,2,25,141,346,37,53,44,87,131,116,29,24,68,82,325
382,Michael Stewart,C,26,TOR,11,0,93,8,23,0,0,8,23,6,11,12,13,25,3,4,3,4,22,22
383,Bryant Stith,SG,31,CLE,50,5,665,70,188,24,68,46,120,44,52,20,65,85,42,29,6,30,42,208
384,John Stockton*,PG,39,UTA,82,82,2566,401,775,25,78,376,697,275,321,59,204,263,674,152,24,208,209,1102
385,Peja Stojaković,SF,24,SAC,71,71,2649,547,1130,129,310,418,820,283,323,72,301,373,175,81,14,140,120,1506
386,Damon Stoudamire,PG,28,POR,75,71,2796,369,918,104,295,265,623,174,196,78,214,292,490,67,7,149,153,1016
387,Erick Strickland,PG,28,BOS,79,4,1643,190,488,95,247,95,241,131,155,22,191,213,184,56,1,94,145,606
388,Mark Strickland,SF,31,ATL,46,10,654,91,204,1,4,90,200,25,44,41,90,131,20,19,17,28,48,208
389,Rod Strickland,PG,35,MIA,76,64,2294,316,714,8,26,308,688,154,201,49,183,232,463,82,11,159,114,794
390,Bruno Šundov,C,21,IND,22,0,88,16,40,0,1,16,39,0,2,7,14,21,3,3,3,4,16,32
391,Bob Sura,PG,28,GSW,78,5,1780,250,590,42,133,208,457,236,328,89,167,256,275,88,17,133,160,778
392,Stromile Swift,PF,22,MEM,68,14,1805,293,611,0,3,293,608,217,305,161,269,430,50,53,113,122,178,803
393,Wally Szczerbiak,SF,24,MIN,82,82,3117,609,1200,87,191,522,1009,226,272,120,271,391,257,66,21,181,188,1531
394,Jason Terry,SG,24,ATL,78,78,2967,524,1219,172,444,352,775,284,340,40,230,270,444,144,13,181,156,1504
395,Etan Thomas,C,23,WAS,47,0,618,81,151,0,0,81,151,41,74,55,126,181,6,17,35,26,76,203
396,Kenny Thomas,PF,24,HOU,72,71,2484,396,829,0,16,396,813,223,336,158,358,516,137,85,66,143,195,1015
397,Kurt Thomas,C,29,NYK,82,82,2771,463,938,1,6,462,932,216,265,214,533,747,87,71,79,153,341,1143
398,Tim Thomas,SF,24,MIL,74,22,1987,316,753,95,291,221,462,142,179,64,236,300,105,65,32,127,200,869
399,Jamaal Tinsley,PG,23,IND,80,78,2442,289,760,42,175,247,585,131,186,78,220,298,647,138,40,270,248,751
400,Óscar Torres,SG,25,HOU,65,13,1075,135,341,37,126,98,215,82,105,47,75,122,40,25,9,49,64,389
401,Robert Traylor,PF,24,CHH,61,1,678,87,204,1,1,86,203,53,84,67,120,187,37,24,37,45,127,228
402,Gary Trent,PF,27,MIN,64,10,1140,193,381,0,2,193,379,92,144,104,166,270,60,21,27,58,160,478
403,Jeff Trepagnier,SG,22,CLE,12,0,77,7,23,0,1,7,22,4,7,3,9,12,12,8,4,11,8,18
404,Jake Tsakalidis,C,22,PHO,67,47,1582,190,400,0,1,190,399,111,159,130,244,374,23,23,69,78,193,491
405,Hedo Türkoğlu,SF,22,SAC,80,10,1970,290,687,63,171,227,516,167,230,63,300,363,163,57,31,81,184,810
407,Keith Van Horn,SF,26,NJN,81,81,2465,471,1089,101,293,370,796,156,195,137,472,609,164,63,42,146,221,1199
408,Ratko Varda,C,22,DET,1,0,6,2,3,0,0,2,3,1,1,0,1,1,0,0,0,1,3,5
409,Jacque Vaughn,PG,26,ATL,82,16,1856,206,438,24,54,182,384,104,126,18,150,168,349,65,2,112,183,540
410,Jake Voskuhl,C,24,PHO,59,34,900,107,193,0,0,107,193,82,109,103,147,250,18,11,23,48,139,296
411,Antoine Walker,PF,25,BOS,81,81,3406,666,1689,222,645,444,1044,240,324,150,564,714,407,122,38,251,237,1794
412,Samaki Walker,PF,25,LAL,69,63,1655,187,365,0,0,187,365,86,129,129,352,481,64,28,88,53,170,460
413,Ben Wallace,C,27,DET,80,80,2921,255,480,0,3,255,477,99,234,318,721,1039,115,138,278,70,178,609
414,Gerald Wallace,SF,19,SAC,54,1,430,75,175,0,7,75,168,23,46,49,40,89,27,19,6,22,46,173
415,John Wallace,SF,27,PHO,46,0,490,93,214,5,13,88,201,40,46,27,58,85,29,11,9,29,60,231
416,Rasheed Wallace,PF,27,POR,79,79,2963,603,1287,114,317,489,970,201,274,136,509,645,152,101,101,131,212,1521
417,Charlie Ward,PG,31,NYK,63,0,1058,113,303,53,164,60,139,47,58,15,112,127,203,68,14,75,100,326
418,Earl Watson,PG,22,SEA,64,0,964,96,212,16,44,80,168,23,36,31,52,83,125,60,5,51,93,231
419,Clarence Weatherspoon,PF,31,NYK,56,41,1728,189,452,0,0,189,452,116,146,149,311,460,60,37,48,47,132,494
420,Chris Webber,PF,28,SAC,54,54,2071,532,1075,5,19,527,1056,253,338,150,396,546,258,90,76,158,181,1322
421,Bonzi Wells,SG,25,POR,74,69,2348,487,1039,66,172,421,867,215,290,121,323,444,204,113,25,191,208,1255
422,David Wesley,SG,31,CHH,67,63,2487,364,910,85,256,279,654,138,188,44,99,143,236,74,15,119,147,951
423,Jahidi White,C,25,WAS,71,69,1346,150,279,0,0,150,279,83,154,159,285,444,17,25,75,65,163,383
424,Rodney White,SF,21,DET,16,0,129,21,60,2,9,19,51,12,14,2,16,18,12,9,2,14,6,56
425,Chris Whitney,PG,30,WAS,82,81,2171,274,656,131,323,143,333,154,175,11,141,152,314,72,6,85,182,833
426,Aaron Williams,PF,30,NJN,82,13,1546,231,439,0,2,231,437,130,186,115,224,339,77,29,76,79,212,592
427,Alvin Williams,PG,27,TOR,82,82,2927,403,971,62,193,341,778,103,140,58,223,281,468,135,26,150,191,971
428,Eric Williams,SF,29,BOS,74,30,1747,144,385,24,86,120,299,160,219,58,163,221,109,77,8,95,179,472
429,Jason Williams,PG,26,MEM,65,65,2236,376,985,127,430,249,555,80,101,22,173,195,519,111,7,214,102,959
430,Jerome Williams,PF,28,TOR,68,32,1641,190,388,0,0,190,388,138,204,165,221,386,75,78,25,68,153,518
431,Monty Williams,SF,30,ORL,68,19,1284,198,362,0,4,198,358,88,134,80,155,235,96,49,17,86,134,484
432,Scott Williams,PF,33,DEN,41,16,737,86,217,0,2,86,215,30,41,82,127,209,13,17,33,35,98,202
433,Shammond Williams,SG,26,SEA,50,2,603,81,193,28,75,53,118,31,39,16,47,63,83,21,2,35,35,221
434,Walt Williams,SF,31,HOU,48,25,1117,166,396,78,183,88,213,40,51,37,125,162,69,18,10,53,106,450
435,Corliss Williamson,SF,28,DET,78,7,1701,411,806,1,5,410,801,240,298,117,202,319,94,49,26,137,226,1063
436,Kevin Willis,PF,39,HOU,52,5,865,125,284,0,1,125,283,65,87,105,194,299,14,25,23,41,98,315
437,Loren Woods,C,23,MIN,60,0,516,33,96,0,2,33,94,44,60,46,76,122,22,17,34,36,60,110
438,Metta World Peace,SF,22,TOT,55,50,1642,269,636,53,170,216,466,136,204,73,198,271,127,141,39,118,217,727
439,Lorenzen Wright,C,26,MEM,43,33,1251,223,486,0,2,223,484,70,123,130,275,405,44,30,23,72,126,516
440,Wang Zhizhi,C,24,DAL,55,0,600,109,248,48,116,61,132,42,57,19,92,111,22,11,18,25,84,308
