Rk,Player,Pos,Age,Tm,G,GS,MP,FG,FGA,3P,3PA,2P,2PA,FT,FTA,ORB,DRB,TRB,AST,STL,BLK,TOV,PF,PTS
1,Shareef Abdur-Rahim,PF,27,TOT,85,56,2684,501,1054,9,34,492,1020,373,429,189,450,639,174,68,37,184,222,1384
2,Malik Allen,PF,25,MIA,45,6,616,83,198,0,0,83,198,25,33,42,77,119,16,12,28,27,81,191
3,Ray Allen*,SG,28,SEA,56,56,2152,447,1017,148,378,299,639,245,271,69,217,286,268,71,11,156,132,1287
4,Rafer Alston,PG,27,MIA,82,28,2581,287,764,161,434,126,330,103,134,26,200,226,372,114,18,128,212,838
5,Chris Andersen,PF,25,DEN,71,0,1029,90,203,0,1,90,202,63,107,89,209,298,35,34,114,48,119,243
6,Derek Anderson,SG,29,POR,51,46,1810,230,612,79,259,151,353,155,188,26,156,182,228,66,3,90,79,694
7,Kenny Anderson,PG,33,IND,44,31,905,113,256,1,4,112,252,35,48,19,62,81,125,26,5,50,73,262
8,Shandon Anderson,SG,30,NYK,80,37,1974,238,564,36,128,202,436,123,161,53,169,222,122,68,17,118,182,635
9,Carmelo Anthony,SF,19,DEN,82,82,2995,624,1465,69,214,555,1251,408,525,183,315,498,227,97,41,247,225,1725
11,Gilbert Arenas,PG,22,WAS,55,52,2066,358,914,125,333,233,581,237,317,55,199,254,275,103,12,226,176,1078
12,Brandon Armstrong,SG,23,NJN,56,0,434,65,175,19,52,46,123,2,4,12,31,43,14,12,2,24,49,151
13,Darrell Armstrong,PG,35,NOH,79,22,2247,291,736,135,429,156,307,123,144,63,163,226,311,133,16,155,148,840
14,Carlos Arroyo,PG,24,UTA,71,71,2008,339,768,38,117,301,651,181,225,41,144,185,355,63,5,156,165,897
15,Chucky Atkins,PG,29,TOT,64,24,1544,192,484,81,241,111,243,73,97,9,84,93,223,45,2,92,102,538
16,Stacey Augmon,SF,35,NOH,69,24,1416,143,347,1,7,142,340,110,139,52,122,174,85,55,15,76,114,397
17,Vin Baker,PF,32,TOT,54,33,1313,208,432,1,3,207,429,114,157,112,168,280,66,29,32,77,160,531
18,Marcus Banks,PG,22,BOS,81,2,1385,177,442,27,86,150,356,99,131,30,103,133,175,88,13,125,171,480
19,Leandro Barbosa,PG,21,PHO,70,46,1500,210,470,83,210,127,260,47,61,23,100,123,165,93,7,120,184,550
20,Matt Barnes,SF,23,LAC,38,9,724,63,138,2,13,61,125,43,61,53,98,151,48,27,3,44,76,171
21,Dana Barros,SG,36,BOS,1,0,11,2,3,0,0,2,3,2,2,0,0,0,0,0,0,0,2,6
22,Brent Barry,SG,32,SEA,59,53,1803,215,427,114,252,101,175,91,110,21,183,204,342,85,16,139,121,635
23,Jon Barry,SG,34,DEN,57,9,1101,120,297,51,138,69,159,60,71,25,98,123,147,57,8,53,66,351
24,Mengke Bateer,C,28,TOR,7,0,40,4,7,0,0,4,7,0,0,5,3,8,1,1,0,2,10,8
25,Tony Battie,C,27,TOT,73,7,1478,170,384,2,9,168,375,66,89,118,241,359,58,26,67,63,159,408
26,Shane Battier,SF,25,MEM,79,1,1947,242,543,65,186,177,357,120,164,102,201,303,101,101,58,56,187,669
28,Jerome Beasley,PF,23,MIA,2,0,5,1,3,0,0,1,3,0,0,0,1,1,0,0,0,0,0,2
29,Raja Bell,SG,27,UTA,82,4,2020,329,805,62,166,267,639,195,248,60,181,241,107,63,13,111,262,915
30,Troy Bell,PG,23,MEM,6,0,34,4,18,0,4,4,14,3,3,3,1,4,4,1,0,6,6,11
31,Jonathan Bender,SF,23,IND,21,0,271,50,106,9,22,41,84,39,47,9,31,40,9,5,11,33,23,148
32,Travis Best,PG,31,DAL,61,1,762,64,172,3,20,61,152,40,46,17,51,68,112,31,4,33,66,171
33,Mike Bibby,PG,25,SAC,82,82,2980,527,1170,148,378,379,792,304,373,67,210,277,444,112,18,175,146,1506
34,Chauncey Billups,PG,27,DET,78,78,2758,392,996,130,335,262,661,404,460,35,241,276,446,84,8,189,177,1318
35,Steve Blake,PG,23,WAS,75,14,1392,157,407,75,202,82,205,55,67,18,99,117,209,57,7,128,100,444
37,Mark Blount,C,28,BOS,82,73,2402,342,604,0,0,342,604,159,221,207,382,589,75,80,106,150,253,843
38,Keith Bogans,SF,23,ORL,73,36,1787,183,454,67,187,116,267,65,103,106,211,317,98,46,10,75,128,498
39,Calvin Booth,C,27,SEA,71,35,1206,135,290,0,2,135,288,75,94,86,194,280,28,17,101,45,150,345
40,Carlos Boozer,PF,22,CLE,75,75,2592,471,900,1,6,470,894,219,285,230,627,857,148,74,55,134,199,1162
41,Curtis Borchardt,C,23,UTA,16,0,258,22,56,0,1,22,55,14,18,13,41,54,15,4,14,18,40,58
42,Chris Bosh,C,19,TOR,75,63,2510,327,712,5,14,322,698,202,288,191,366,557,78,59,106,107,215,861
43,Ruben Boumtje-Boumtje,C,25,POR,9,0,26,1,5,0,0,1,5,2,2,0,1,1,1,0,1,0,2,4
44,Bruce Bowen,SF,32,SAS,82,82,2624,211,502,77,212,134,290,66,114,45,208,253,113,84,33,90,166,565
45,Ryan Bowen,PF,28,DEN,52,1,392,18,53,0,0,18,53,10,12,39,48,87,18,18,16,6,47,46
46,Earl Boykins,SG,27,DEN,82,3,1849,321,766,55,171,266,595,142,162,42,101,143,295,51,3,100,84,839
48,Shawn Bradley,C,31,DAL,66,5,773,89,188,0,1,89,187,41,49,72,101,173,20,33,74,17,130,219
49,Torraye Braggs,PF,27,TOT,15,0,154,16,33,0,0,16,33,8,12,18,21,39,7,4,2,13,29,40
50,Elton Brand,PF,24,LAC,69,68,2670,484,982,0,1,484,981,411,532,269,445,714,227,64,154,193,229,1379
51,J.R. Bremer,PG,23,TOT,36,2,443,43,158,19,74,24,84,13,20,9,27,36,51,18,4,24,32,118
52,Jamison Brewer,PG,23,IND,13,1,160,13,35,5,14,8,21,1,6,2,9,11,17,7,0,10,9,32
53,Primož Brezec,C,24,IND,18,0,72,12,26,0,0,12,26,4,6,5,10,15,3,0,3,6,13,28
54,Damone Brown,PF,24,NJN,3,0,17,1,10,0,0,1,10,1,2,3,2,5,0,2,0,1,2,3
55,Devin Brown,SG,25,SAS,58,0,627,85,196,4,14,81,182,60,74,38,92,130,33,15,4,38,61,234
56,Kedrick Brown,SF,22,TOT,55,26,969,117,254,38,99,79,155,17,27,41,105,146,64,30,7,29,80,289
57,Kwame Brown,PF,21,WAS,74,57,2239,288,589,1,2,287,587,228,334,178,372,550,112,66,52,140,144,805
58,P.J. Brown,PF,34,NOH,80,80,2753,339,712,0,1,339,711,158,185,237,453,690,155,78,73,101,203,836
59,Tierre Brown,PG,24,NOH,3,0,17,2,4,0,0,2,4,2,4,0,1,1,2,0,0,7,1,6
60,Rick Brunson,PG,31,TOT,40,0,412,40,105,11,23,29,82,27,31,9,28,37,82,25,3,33,44,118
61,Kobe Bryant,SG,25,LAL,65,64,2447,516,1178,71,217,445,961,454,533,103,256,359,330,112,28,171,176,1557
62,Greg Buckner,SG,27,PHI,53,3,703,66,175,12,44,54,131,20,27,28,75,103,45,21,4,34,77,164
63,Rodney Buford,SF,26,SAC,22,0,141,19,56,0,2,19,54,3,6,6,9,15,7,6,1,4,9,41
64,Caron Butler,SF,23,MIA,68,56,2030,240,631,10,42,230,589,133,176,92,234,326,126,75,13,91,162,623
65,Mitchell Butler,SG,33,WAS,41,4,552,54,124,11,30,43,94,15,24,24,47,71,32,22,4,24,54,134
66,Rasual Butler,SF,24,MIA,45,0,675,119,250,50,108,69,142,16,21,4,57,61,23,10,13,28,72,304
67,Žarko Čabarkapa,PF,22,PHO,49,4,570,81,197,6,32,75,165,35,53,26,73,99,40,10,13,54,75,203
68,Marcus Camby,C,29,DEN,72,72,2162,262,549,0,2,262,547,98,136,211,516,727,132,86,187,98,239,622
69,Elden Campbell,C,35,DET,65,27,892,138,314,0,0,138,314,85,124,52,157,209,45,21,50,63,137,361
70,Brian Cardinal,PF,26,GSW,76,11,1634,220,466,55,124,165,342,238,271,100,217,317,103,66,20,84,206,733
71,Matt Carroll,SG,23,TOT,16,0,70,7,16,1,3,6,13,4,6,1,5,6,2,1,0,6,8,19
72,Anthony Carter,PG,28,SAS,5,2,87,11,37,0,3,11,34,0,0,2,9,11,12,4,0,12,9,22
73,Maurice Carter,SG,27,TOT,10,0,110,11,35,4,11,7,24,16,20,2,9,11,4,0,0,9,10,42
74,Vince Carter,SG,27,TOR,73,73,2785,608,1457,93,243,515,1214,336,417,95,254,349,348,88,65,223,212,1645
75,Sam Cassell,PG,34,MIN,81,81,2838,620,1270,74,186,546,1084,289,331,44,227,271,592,102,18,220,247,1603
76,Kelvin Cato,PF,29,HOU,69,67,1743,161,360,0,0,161,360,96,142,153,319,472,72,52,96,84,203,418
77,Tyson Chandler,PF,21,CHI,35,8,782,67,158,0,1,67,157,79,118,82,188,270,23,17,43,38,87,213
78,Calbert Cheaney,SF,32,GSW,79,7,2067,278,578,0,10,278,568,47,77,77,183,260,136,60,12,85,184,603
79,Doug Christie,SG,33,SAC,82,82,2780,317,688,49,142,268,546,148,172,69,260,329,347,151,41,155,186,831
80,Keon Clark,PF,28,UTA,2,0,27,2,6,0,0,2,6,0,0,1,6,7,1,1,0,0,1,4
81,Speedy Claxton,PG,25,GSW,60,29,1595,224,524,4,22,220,502,182,224,38,118,156,267,97,9,102,146,634
82,Mateen Cleaves,PG,26,CLE,4,2,92,7,23,0,1,7,22,1,2,1,6,7,19,4,2,5,13,15
83,Derrick Coleman,C,36,PHI,34,30,843,107,259,8,36,99,223,49,65,45,147,192,46,23,26,57,79,271
84,Bimbo Coles,PG,35,MIA,22,1,170,12,34,0,0,12,34,4,6,2,8,10,15,3,0,9,27,28
85,Jason Collier,C,26,ATL,20,16,545,79,165,1,4,78,161,67,85,36,75,111,17,11,11,31,71,226
86,Jarron Collins,C,25,UTA,81,31,1732,147,295,0,1,147,294,188,262,117,199,316,77,26,18,79,255,482
87,Jason Collins,C,25,NJN,78,78,2220,163,384,0,2,163,382,136,184,143,257,400,153,67,56,97,251,462
88,Brian Cook,C,23,LAL,35,2,442,67,141,0,5,67,136,21,28,31,70,101,20,16,16,17,64,155
89,Omar Cook,PG,22,POR,17,0,139,7,27,0,1,7,26,0,0,3,3,6,24,10,0,10,14,14
90,Chris Crawford,PF,28,ATL,56,25,1207,211,471,44,113,167,358,103,119,58,117,175,45,37,20,55,131,569
91,Jamal Crawford,SG,23,CHI,80,73,2811,509,1318,165,521,344,797,200,240,46,237,283,405,111,29,193,161,1383
92,Austin Croshere,PF,28,IND,77,0,1051,119,307,56,144,63,163,93,104,60,183,243,52,24,14,55,101,387
93,Eddy Curry,PF,21,CHI,73,63,2154,417,840,1,1,416,839,235,350,143,308,451,68,24,83,177,258,1070
94,Michael Curry,SF,35,TOR,70,15,1229,76,196,3,15,73,181,49,58,22,65,87,53,23,5,48,153,204
95,Samuel Dalembert,C,22,PHI,82,53,2197,270,499,0,1,270,498,112,174,194,432,626,21,44,189,86,273,652
96,Erick Dampier,C,28,GSW,74,74,2403,348,650,0,2,348,648,217,332,344,543,887,60,33,137,131,227,913
97,Antonio Daniels,PG,28,SEA,71,32,1512,187,398,42,116,145,282,155,184,23,119,142,298,45,6,61,64,571
98,Marquis Daniels,SG,23,DAL,56,15,1039,203,411,11,36,192,375,60,78,66,80,146,116,53,12,44,51,477
99,Antonio Davis,C,35,TOT,80,79,2570,266,660,0,0,266,660,176,230,207,464,671,137,37,65,114,206,708
100,Baron Davis,PG,24,NOH,67,66,2686,554,1402,187,582,367,820,237,352,66,221,287,501,158,27,215,178,1532
101,Dale Davis,C,34,POR,76,37,1682,133,281,0,0,133,281,65,106,158,240,398,72,43,62,40,154,331
102,Hubert Davis,SG,33,TOT,17,0,78,1,11,0,1,1,10,2,2,2,6,8,4,2,0,3,12,4
103,Josh Davis,PF,23,ATL,4,1,23,2,5,0,2,2,3,1,1,1,4,5,0,0,0,2,3,5
105,Andrew DeClercq,C,30,ORL,71,53,1211,93,195,0,0,93,195,44,54,131,186,317,44,47,32,54,217,230
106,Tony Delk,SG,30,DAL,33,11,509,70,184,20,66,50,118,37,44,16,43,59,28,27,7,17,46,197
107,Derrick Dial,SG,28,ORL,9,0,86,9,28,2,9,7,19,6,8,5,8,13,2,6,0,1,6,26
108,Boris Diaw,SG,21,ATL,76,37,1919,140,313,6,26,134,287,56,93,111,231,342,182,59,37,126,191,342
109,Dan Dickau,PG,25,TOT,43,0,294,37,98,10,30,27,68,11,14,7,19,26,38,17,0,26,44,95
110,Kaniel Dickens,PF,25,POR,3,0,12,3,3,0,0,3,3,1,2,2,0,2,0,0,0,1,3,7
111,DeSagana Diop,C,22,CLE,56,3,730,57,147,0,0,57,147,12,20,72,127,199,34,26,51,29,116,126
112,Vlade Divac*,C,35,SAC,81,81,2317,314,668,2,13,312,655,170,260,136,327,463,432,57,77,173,222,800
113,Juan Dixon,SG,25,WAS,71,16,1478,247,637,59,198,188,439,111,139,30,118,148,137,82,4,104,111,664
114,Michael Doleac,C,26,TOT,72,0,1029,140,322,0,0,140,322,45,52,88,177,265,44,23,36,48,142,325
115,Keyon Dooling,PG,23,LAC,58,24,1137,137,352,8,46,129,306,78,94,17,62,79,130,45,6,65,108,360
116,Bryce Drew,PG,29,NOH,15,0,78,4,18,1,7,3,11,3,3,0,6,6,13,4,0,8,1,12
117,Predrag Drobnjak,C,28,LAC,61,14,949,149,379,11,36,138,343,73,86,54,142,196,39,22,24,48,85,382
118,Tim Duncan,PF,27,SAS,69,68,2527,592,1181,2,12,590,1169,352,588,227,632,859,213,62,185,183,164,1538
119,Mike Dunleavy,SF,23,GSW,75,69,2336,323,720,94,254,229,466,137,185,87,355,442,220,68,13,143,169,877
120,Ronald Dupree,SF,23,CHI,47,8,893,111,282,4,9,107,273,66,105,55,112,167,55,32,18,51,134,292
121,Ndudi Ebi,SF,19,MIN,17,0,32,6,14,0,0,6,14,1,4,2,1,3,3,0,4,3,6,13
122,Howard Eisley,PG,31,TOT,67,23,1457,166,451,52,163,114,288,76,89,20,109,129,273,56,5,98,137,460
123,Francisco Elson,C,27,DEN,62,14,875,94,199,0,1,94,198,30,45,65,138,203,32,35,39,35,145,218
124,Melvin Ely,PF,25,LAC,42,2,510,66,153,0,1,66,152,25,42,48,53,101,22,9,17,20,68,157
125,Reggie Evans,PF,23,SEA,75,27,1280,67,165,0,3,67,162,83,148,156,252,408,33,54,10,65,176,217
126,Desmond Ferguson,SF,26,POR,7,0,32,5,12,3,8,2,4,0,2,0,4,4,1,0,0,1,0,13
127,Michael Finley,SG,30,DAL,72,72,2778,514,1159,150,370,364,789,164,193,78,247,325,212,84,39,83,118,1342
128,Derek Fisher,SG,29,LAL,82,3,1769,203,576,52,179,151,397,122,153,30,122,152,187,103,4,79,115,580
129,Marcus Fizer,SF,25,CHI,46,2,738,134,350,2,17,132,333,90,120,61,141,202,43,16,8,51,97,360
130,Alton Ford,PF,22,HOU,9,0,41,6,11,0,0,6,11,3,6,3,8,11,3,0,1,3,9,15
131,T.J. Ford,PG,20,MIL,55,55,1472,153,398,5,21,148,377,80,98,37,140,177,356,60,3,139,123,391
132,Danny Fortson,C,27,DAL,56,20,625,71,139,0,0,71,139,75,92,114,136,250,9,12,11,37,148,217
133,Jeff Foster,C,27,IND,82,79,1961,197,362,0,4,197,358,103,154,248,362,610,64,71,27,60,189,497
134,Tremaine Fowlkes,SF,27,DET,36,0,261,15,48,1,8,14,40,13,18,18,35,53,14,9,3,12,37,44
135,Rick Fox,SF,34,LAL,38,34,846,73,186,15,61,58,125,22,30,29,73,102,98,29,4,48,99,183
136,Adonal Foyle,C,28,GSW,44,8,572,59,130,0,0,59,130,19,35,54,113,167,17,6,46,21,68,137
137,Richie Frahm,SF,26,SEA,54,0,469,63,139,34,92,29,47,23,26,12,44,56,24,16,4,7,50,183
138,Steve Francis,PG,26,HOU,79,79,3194,450,1117,73,250,377,867,337,435,116,317,433,493,139,35,294,257,1310
139,Hiram Fuller,PF,22,ATL,4,0,43,3,8,0,0,3,8,2,6,4,7,11,2,0,1,4,5,8
140,Dan Gadzuric,C,25,MIL,75,0,1260,183,349,0,1,183,348,58,118,126,220,346,28,51,105,45,186,424
141,Reece Gaines,PG,23,ORL,38,1,364,25,86,3,10,22,76,16,25,8,31,39,40,11,2,18,22,69
142,Alex Garcia,SG,23,SAS,2,0,13,1,7,0,0,1,7,1,2,0,0,0,0,2,0,1,0,3
143,Kevin Garnett,PF,27,MIN,82,82,3231,804,1611,11,43,793,1568,368,465,245,894,1139,409,120,178,212,202,1987
144,Pat Garrity,PF,27,ORL,2,0,22,1,3,0,0,1,3,0,0,0,0,0,1,0,0,0,2,2
145,Pau Gasol,PF,23,MEM,78,78,2458,506,1049,4,15,502,1034,365,511,206,394,600,198,44,132,187,185,1381
146,Devean George,SF,26,LAL,82,48,1951,233,571,65,186,168,385,73,96,87,245,332,112,81,38,88,189,604
147,Eddie Gill,PG,25,POR,22,0,157,15,36,3,8,12,28,17,20,4,13,17,16,9,1,12,16,50
148,Kendall Gill,SG,35,CHI,56,35,1411,215,548,9,38,206,510,100,136,61,129,190,89,65,16,83,107,539
149,Manu Ginóbili,SG,26,SAS,77,38,2260,330,789,88,245,242,544,239,298,86,258,344,291,136,16,161,181,987
151,Dion Glover,SG,25,TOT,69,30,1643,230,589,40,119,190,470,120,156,58,208,266,130,50,19,102,123,620
152,Anthony Goldwire,PG,32,TOT,11,0,85,7,22,2,8,5,14,1,1,1,6,7,11,5,0,3,5,17
153,Drew Gooden,PF,22,ORL,79,17,2134,369,829,9,42,360,787,167,262,160,356,516,89,62,72,126,196,914
154,Brian Grant,C,31,MIA,76,76,2303,289,613,0,1,289,612,86,110,174,350,524,69,51,35,82,254,664
155,Horace Grant,PF,38,LAL,55,10,1106,92,224,0,1,92,223,39,54,79,154,233,71,24,21,29,70,223
156,Paul Grant,C,30,UTA,10,0,98,11,23,0,0,11,23,3,8,7,10,17,3,1,1,7,17,25
157,Willie Green,SG,22,PHI,53,0,767,143,357,19,61,124,296,59,81,16,49,65,53,26,5,59,83,364
158,Adrian Griffin,SG,29,HOU,19,1,133,5,18,1,2,4,16,0,4,1,18,19,10,7,2,3,17,11
159,Tom Gugliotta,PF,34,TOT,55,27,819,70,203,1,4,69,199,20,28,65,122,187,63,31,12,39,81,161
160,Marcus Haislip,PF,23,MIL,31,0,263,36,74,1,2,35,72,20,28,21,32,53,4,6,12,9,25,93
161,Darvin Ham,SF,30,DET,54,2,484,37,75,1,2,36,73,21,35,47,46,93,16,13,8,31,63,96
162,Richard Hamilton,SG,25,DET,78,78,2772,530,1166,18,68,512,1098,297,342,78,201,279,310,103,17,210,222,1375
163,Zendon Hamilton,C,28,PHI,46,0,473,51,95,0,0,51,95,67,96,49,97,146,13,8,8,27,74,169
164,Ben Handlogten,C,30,UTA,17,0,172,25,47,0,0,25,47,18,27,22,33,55,6,3,4,10,32,68
165,Travis Hansen,SF,25,ATL,41,4,507,46,130,9,30,37,100,22,27,30,40,70,19,10,9,15,67,123
166,Anfernee Hardaway,SG,32,TOT,76,14,2095,279,679,30,79,249,600,111,138,69,218,287,176,70,20,107,146,699
167,Matt Harpring,SF,27,UTA,31,31,1134,193,410,8,33,185,377,108,157,91,156,247,63,22,2,65,102,502
168,Al Harrington,PF,23,IND,79,15,2441,421,909,21,77,400,832,185,252,163,345,508,131,80,22,163,250,1048
169,Othella Harrington,PF,30,NYK,56,3,872,100,202,0,0,100,202,58,78,58,119,177,29,12,14,65,134,258
170,Lucious Harris,PG,33,NJN,69,15,1504,187,463,38,101,149,362,66,78,39,101,140,135,41,2,53,74,478
171,Jason Hart,PG,25,SAS,53,5,660,71,159,2,9,69,150,33,43,10,69,79,81,28,5,29,59,177
172,Donnell Harvey,PF,23,TOT,60,8,783,89,201,0,3,89,198,61,83,48,116,164,21,24,27,45,129,239
173,Udonis Haslem,PF,23,MIA,75,24,1795,205,447,0,3,205,444,140,183,189,284,473,51,33,24,74,197,550
174,Trenton Hassell,SG,24,MIN,81,74,2264,177,381,4,13,173,368,48,61,68,189,257,133,36,54,46,200,406
175,Jarvis Hayes,SF,22,WAS,70,42,2044,278,695,40,131,238,564,77,98,71,193,264,106,71,11,110,157,673
176,Brendan Haywood,C,24,WAS,77,59,1484,200,388,0,1,200,387,137,234,186,201,387,43,32,100,80,154,537
177,Shane Heal,PG,33,SAS,6,0,72,7,24,4,18,3,6,4,5,1,3,4,5,1,0,5,2,22
178,Alan Henderson,PF,31,ATL,6,0,68,10,21,0,0,10,21,4,6,11,10,21,2,1,2,3,1,24
179,Nenê Hilário,PF,21,DEN,77,77,2504,334,630,0,2,334,628,240,352,154,349,503,168,116,41,183,280,908
180,Tyrone Hill,PF,35,MIA,5,0,38,3,5,0,0,3,5,3,4,5,3,8,0,0,1,2,10,9
181,Kirk Hinrich,PG,23,CHI,76,66,2706,318,823,144,369,174,454,135,168,42,217,259,517,101,21,204,276,915
182,Fred Hoiberg,SG,31,MIN,79,3,1804,178,383,76,172,102,211,98,116,21,247,268,109,66,10,44,136,530
183,Robert Horry,PF,33,SAS,81,1,1290,141,348,41,108,100,240,69,107,108,164,272,101,48,49,55,165,392
184,Eddie House,SG,25,LAC,60,10,1188,161,449,51,136,110,313,36,45,28,110,138,148,65,4,63,92,409
185,Allan Houston,SG,32,NYK,50,50,1799,340,781,87,202,253,579,157,172,20,101,121,99,38,2,102,105,924
186,Josh Howard,SF,23,DAL,67,29,1589,229,532,20,66,209,466,97,138,149,219,368,97,69,54,67,168,575
187,Juwan Howard,PF,30,ORL,81,77,2877,529,1169,0,1,529,1168,318,393,171,399,570,158,54,22,178,284,1376
188,Troy Hudson,PG,27,MIN,29,1,503,80,207,31,77,49,130,27,33,4,31,35,70,7,0,34,32,218
189,Larry Hughes,SG,25,WAS,61,61,2061,401,1009,79,232,322,777,267,335,96,230,326,148,95,26,152,147,1148
190,Ryan Humphrey,PF,24,MEM,2,0,11,1,4,0,1,1,3,0,0,2,1,3,1,1,0,2,3,2
191,Brandon Hunter,PF,23,BOS,36,12,406,53,116,0,3,53,113,19,43,50,68,118,19,13,1,22,40,125
192,Lindsey Hunter,SG,33,DET,33,8,661,49,143,14,50,35,93,5,8,13,54,67,85,39,6,34,45,117
193,Steven Hunter,C,22,ORL,59,23,789,82,155,0,0,82,155,23,69,54,116,170,12,5,73,29,101,187
194,Zydrunas Ilgauskas,C,28,CLE,81,81,2539,466,965,2,7,464,958,303,406,279,374,653,109,39,201,163,277,1237
195,Allen Iverson*,SG,28,PHI,48,47,2040,435,1125,57,199,378,926,339,455,34,144,178,324,115,5,209,87,1266
196,Bobby Jackson,SG,30,SAC,50,0,1185,263,592,81,219,182,373,82,109,55,119,174,105,49,8,63,106,689
197,Jim Jackson,SF,33,HOU,80,80,3119,382,900,162,405,220,495,107,127,52,435,487,226,86,23,175,227,1033
198,Marc Jackson,PF,29,PHI,22,13,598,71,171,0,1,71,170,64,81,45,81,126,18,12,6,24,45,206
199,Mark Jackson,PG,38,HOU,42,3,577,34,100,7,41,27,59,28,39,10,60,70,119,17,1,53,41,103
200,Stephen Jackson,SF,25,ATL,80,78,2940,536,1261,145,427,391,834,233,297,97,273,370,244,142,20,223,216,1450
201,Casey Jacobsen,SF,22,PHO,78,13,1828,150,360,75,180,75,180,91,111,42,159,201,98,48,9,68,144,466
202,Jerome James,C,28,SEA,65,24,990,129,259,0,0,129,259,66,100,78,152,230,32,20,60,82,180,324
203,LeBron James,SG,19,CLE,79,79,3122,622,1492,63,217,559,1275,347,460,99,333,432,465,130,58,273,149,1654
204,Mike James,PG,28,TOT,81,55,2196,272,657,106,281,166,376,103,127,28,206,234,339,96,3,124,156,753
205,Antawn Jamison,SF,27,DAL,82,2,2376,488,913,16,40,472,873,220,294,233,287,520,70,83,30,81,174,1212
206,Marko Jarić,PG,25,LAC,58,50,1760,185,477,51,150,134,327,74,101,44,131,175,281,93,20,115,132,495
208,Richard Jefferson,SF,23,NJN,82,82,3133,555,1115,48,132,507,983,357,468,109,355,464,315,92,28,198,224,1515
209,Jared Jeffries,PF,22,WAS,82,38,1913,177,469,5,30,172,439,105,171,180,244,424,93,48,28,107,212,464
210,Britton Johnsen,C,24,ORL,20,4,290,17,59,1,12,16,47,7,16,15,30,45,12,7,1,14,28,42
211,Anthony Johnson,PG,29,IND,73,7,1598,167,411,41,122,126,289,75,94,28,102,130,202,64,8,75,138,450
212,Avery Johnson,PG,38,GSW,46,1,637,80,199,0,3,80,196,52,78,3,30,33,111,26,3,51,34,212
213,DerMarr Johnson,SF,23,NYK,21,1,287,36,97,13,36,23,61,28,31,5,34,39,11,8,7,16,32,113
214,Ervin Johnson,C,36,MIN,66,47,965,55,103,0,1,55,102,17,28,61,171,232,24,27,43,30,156,127
215,Joe Johnson,SG,22,PHO,82,77,3331,555,1291,83,272,472,1019,174,232,80,305,385,362,93,26,199,177,1367
216,Linton Johnson,SF,23,CHI,41,20,734,72,203,7,33,65,170,22,37,59,124,183,27,37,32,37,90,173
217,Dahntay Jones,SG,23,MEM,20,0,154,15,53,1,4,14,49,5,11,7,16,23,12,5,6,12,23,36
218,Damon Jones,PG,27,MIL,82,26,2016,210,524,98,273,112,251,55,72,15,155,170,478,30,4,103,92,573
219,Eddie Jones,SG,32,MIA,81,81,2998,473,1156,177,479,296,677,278,333,38,270,308,258,92,34,129,226,1401
220,Fred Jones,SG,24,IND,81,2,1508,123,311,27,89,96,222,124,149,25,101,126,173,65,18,73,132,397
221,James Jones,SF,23,IND,6,0,26,2,9,1,4,1,5,2,2,0,2,2,0,1,0,0,1,7
222,Jumaine Jones,SG,24,BOS,42,2,373,33,96,13,44,20,52,14,23,24,44,68,14,12,9,19,48,93
223,Popeye Jones,PF,33,GSW,5,0,10,0,2,0,0,0,2,0,0,1,0,1,0,0,0,0,2,0
224,Chris Kaman,C,21,LAC,82,61,1843,200,435,0,2,200,433,99,142,126,335,461,85,23,73,155,211,499
225,Jason Kapono,SF,22,CLE,41,3,427,52,129,21,44,31,85,20,24,19,36,55,14,13,2,21,41,145
226,Jason Kidd*,PG,30,NJN,67,66,2450,368,959,94,293,274,666,206,249,85,343,428,618,122,14,214,110,1036
227,Andrei Kirilenko,PF,22,UTA,78,78,2895,412,931,68,201,344,730,392,496,226,403,629,244,150,215,215,174,1284
228,Kerry Kittles,SG,29,NJN,82,82,2842,434,959,97,276,337,683,107,136,56,271,327,206,125,40,95,144,1072
229,Brevin Knight,PG,28,TOT,56,13,1037,105,246,2,8,103,238,49,65,14,98,112,204,84,1,72,107,261
230,Kyle Korver,SF,22,PHI,74,0,882,115,327,81,207,34,120,19,24,30,81,111,40,25,8,41,102,330
231,Toni Kukoč,PF,35,MIL,73,0,1522,211,506,49,168,162,338,145,199,60,211,271,200,59,21,110,110,616
232,Christian Laettner,PF,34,WAS,48,18,984,119,256,6,21,113,235,40,50,50,182,232,89,37,28,42,102,284
233,Raef LaFrentz,C,27,BOS,17,1,328,57,124,8,40,49,84,10,13,30,49,79,24,8,13,11,47,132
234,Maciej Lampe,C,18,PHO,21,0,224,43,88,0,4,43,84,10,13,9,35,44,9,3,3,15,28,96
235,Sean Lampley,SF,24,GSW,10,0,63,13,20,0,0,13,20,8,12,2,9,11,2,0,1,3,2,34
236,Dan Langhi,SF,26,TOT,6,0,37,5,14,1,2,4,12,2,2,0,4,4,0,0,0,2,7,13
237,Rusty LaRue,PG,30,GSW,4,0,22,1,3,1,1,0,2,1,2,0,3,3,2,2,0,4,2,4
238,Voshon Lenard,SG,30,DEN,73,70,2233,394,933,106,289,288,644,144,182,46,154,200,151,61,12,101,177,1038
239,Quincy Lewis,SF,26,MIN,14,0,65,7,20,2,5,5,15,0,0,1,6,7,2,2,2,3,10,16
240,Rashard Lewis,SF,24,SEA,80,80,2931,535,1229,145,386,390,843,206,270,133,385,518,175,99,54,135,233,1421
241,Randy Livingston,PG,28,LAC,4,0,48,2,10,0,3,2,7,4,6,2,5,7,4,2,0,4,7,8
242,Raül López,PG,23,UTA,82,11,1617,223,517,25,85,198,432,101,117,24,131,155,305,62,2,174,200,572
243,Tyronn Lue,PG,26,ORL,76,69,2332,309,714,80,209,229,505,101,131,26,161,187,317,61,5,124,185,799
244,George Lynch,SF,33,NOH,78,51,1701,149,375,43,139,106,236,34,51,96,216,312,117,48,18,64,159,375
245,Mark Madsen,C,28,MIN,72,12,1246,101,204,0,6,101,198,57,118,134,138,272,28,33,18,47,175,259
246,Corey Maggette,SF,24,LAC,73,72,2628,453,1013,76,231,377,782,526,620,96,334,430,224,65,16,207,217,1508
247,Jamaal Magloire,C,25,NOH,82,82,2777,383,809,0,1,383,808,353,470,268,579,847,86,43,101,201,278,1119
248,Karl Malone*,PF,40,LAL,42,42,1373,193,400,0,1,193,399,168,225,61,306,367,163,50,20,103,116,554
249,Stephon Marbury,PG,26,TOT,81,81,3254,598,1386,87,274,511,1112,356,436,58,205,263,719,129,9,249,172,1639
250,Shawn Marion,SF,25,PHO,79,79,3217,590,1341,90,265,500,1076,228,268,212,525,737,214,167,104,156,203,1498
251,Donyell Marshall,PF,30,TOT,82,74,2988,470,1020,131,325,339,695,134,182,210,598,808,122,93,124,117,247,1205
252,Darrick Martin,PG,32,MIN,16,0,172,20,67,6,26,14,41,9,9,2,5,7,23,2,1,7,23,55
253,Kenyon Martin,PF,26,NJN,65,62,2252,439,900,7,25,432,875,201,294,133,484,617,160,95,82,168,230,1086
254,Jamal Mashburn,SF,31,NOH,19,18,730,156,398,19,67,137,331,65,80,19,98,117,47,14,5,37,42,396
255,Desmond Mason,SF,26,MIL,82,31,2534,409,867,9,39,400,828,356,463,93,266,359,152,60,24,148,191,1183
256,Roger Mason,SG,23,TOT,26,3,328,32,98,13,39,19,59,19,22,1,30,31,26,11,6,20,36,96
257,Tony Massenburg,PF,36,SAC,59,0,789,104,219,0,1,104,218,43,63,57,131,188,29,14,18,45,144,251
258,Walter McCarty,PF,29,BOS,77,23,1900,203,523,137,366,66,157,62,82,28,211,239,124,72,22,91,179,605
259,Amal McCaskill,C,30,PHI,59,3,636,47,117,0,1,47,116,19,27,48,85,133,20,12,20,25,89,113
260,Jelani McCoy,C,26,CLE,2,0,12,0,0,0,0,0,0,0,0,1,3,4,0,0,0,1,4,0
261,Antonio McDyess,PF,29,TOT,42,20,927,126,268,0,0,126,268,38,69,70,187,257,36,37,24,57,117,290
262,Tracy McGrady*,SG,24,ORL,67,67,2675,653,1566,174,513,479,1053,398,500,95,307,402,370,93,42,179,129,1878
264,Aaron McKie,SF,31,PHI,75,41,2112,265,577,75,172,190,405,84,111,45,208,253,195,85,23,103,142,689
265,Keith McLeod,PG,24,MIN,33,0,391,27,82,1,10,26,72,33,43,5,29,34,59,16,1,29,39,88
266,Stanislav Medvedenko,PF,24,LAL,68,38,1442,237,537,0,3,237,534,89,116,148,195,343,57,38,18,59,191,563
267,Ron Mercer,SG,27,SAS,39,0,516,90,211,2,7,88,204,13,17,10,39,49,22,14,5,26,37,195
269,Darius Miles,SF,22,TOT,79,56,2079,365,753,7,40,358,713,124,193,112,247,359,162,67,61,130,168,861
270,Darko Miličić,C,18,DET,34,0,159,17,65,0,1,17,64,14,24,11,32,43,7,7,15,13,33,48
271,Andre Miller,PG,27,DEN,82,82,2838,430,941,12,65,418,876,342,411,127,239,366,501,142,25,215,194,1214
272,Brad Miller,PF,27,SAC,72,53,2621,373,731,12,38,361,693,256,329,191,552,743,312,68,86,144,247,1014
273,Mike Miller,SF,23,MEM,65,65,1770,270,616,80,215,190,401,102,141,42,174,216,232,59,14,107,162,722
274,Oliver Miller,C,33,MIN,48,1,506,53,100,0,1,53,99,15,23,46,84,130,36,19,26,33,91,121
275,Reggie Miller*,SG,38,IND,80,80,2254,260,594,134,334,126,260,146,165,18,170,188,249,65,11,68,96,800
276,Yao Ming*,C,23,HOU,82,82,2692,535,1025,0,2,535,1023,361,446,197,538,735,122,22,156,204,273,1431
277,Cuttino Mobley,SG,28,HOU,80,80,3229,460,1081,164,420,296,661,176,217,40,322,362,258,107,33,180,179,1260
278,Nazr Mohammed,C,26,TOT,80,24,1611,246,472,0,0,246,472,100,169,178,296,474,36,55,52,96,195,592
279,Jérôme Moïso,PF,25,TOR,35,1,417,40,84,0,1,40,83,22,38,41,72,113,8,17,12,25,42,102
281,Alonzo Mourning*,C,33,NJN,12,0,215,33,71,0,0,33,71,30,34,8,19,27,8,2,6,10,32,96
282,Troy Murphy,PF,23,GSW,28,0,610,107,243,5,17,102,226,60,80,48,125,173,20,12,17,34,58,279
283,Lamond Murray,SF,30,TOR,33,4,518,76,215,21,60,55,155,24,35,14,76,90,28,15,7,38,47,197
284,Ronald Murray,PG,24,SEA,82,18,2021,389,915,67,229,322,686,168,235,45,159,204,205,81,28,149,158,1013
285,Tracy Murray,SF,32,POR,7,0,35,3,12,2,5,1,7,0,1,3,2,5,1,1,0,2,3,8
286,Dikembe Mutombo*,C,37,NYK,65,56,1494,141,295,0,0,141,295,81,119,145,292,437,25,17,123,54,141,363
287,Mamadou N'Diaye,C,28,TOT,28,1,366,27,69,0,0,27,69,44,59,43,69,112,0,8,25,18,59,98
288,Boštjan Nachbar,SF,23,HOU,45,3,516,47,132,23,63,24,69,21,29,8,62,70,30,14,14,23,72,138
290,Eduardo Nájera,SF,27,DAL,58,7,720,72,162,2,4,70,158,30,46,67,89,156,25,35,19,29,90,176
291,Steve Nash*,PG,29,DAL,78,78,2612,397,845,104,257,293,588,230,251,59,173,232,687,67,8,209,139,1128
292,Rasho Nesterović,C,27,SAS,82,82,2353,328,700,0,0,328,700,54,114,257,376,633,114,51,165,107,247,710
293,Ira Newble,SF,29,CLE,64,25,1245,108,276,2,19,106,257,36,46,65,90,155,72,25,19,54,109,254
294,Moochie Norris,PG,30,TOT,66,0,847,80,217,20,58,60,159,54,71,10,55,65,121,44,5,64,51,234
295,Dirk Nowitzki,C,25,DAL,77,77,2915,605,1310,99,290,506,1020,371,423,90,580,670,207,92,104,135,216,1680
296,Jermaine O'Neal,PF,25,IND,78,78,2788,608,1400,2,18,606,1382,348,460,193,585,778,164,59,199,181,248,1566
297,Shaquille O'Neal*,C,31,LAL,67,67,2464,554,948,0,0,554,948,331,676,246,523,769,196,34,166,195,225,1439
298,Charles Oakley,PF,40,HOU,7,0,25,2,6,0,0,2,6,5,6,0,5,5,2,0,0,1,8,9
299,Lamar Odom,PF,24,MIA,80,80,3003,485,1127,61,205,424,922,340,458,160,616,776,327,85,71,236,273,1371
300,Mehmet Okur,PF,24,DET,71,33,1580,251,542,18,48,233,494,162,209,160,261,421,69,36,63,101,138,682
301,Kevin Ollie,PG,31,CLE,82,7,1401,95,257,4,9,91,248,147,176,23,147,170,234,51,8,81,119,341
302,Michael Olowokandi,C,28,MIN,43,25,925,121,285,0,0,121,285,36,61,78,167,245,24,16,68,54,137,278
303,Greg Ostertag,C,30,UTA,78,51,2153,208,437,0,1,208,436,113,195,221,357,578,123,30,139,99,228,529
304,Bo Outlaw,PF,32,MEM,82,1,1606,159,312,0,4,159,308,61,116,125,217,342,90,73,70,69,170,379
305,Travis Outlaw,PF,19,POR,8,0,19,3,7,0,0,3,7,2,4,2,2,4,1,1,0,1,1,8
306,Doug Overton,PG,34,TOT,61,11,1033,99,245,3,23,96,222,23,31,16,70,86,138,26,2,58,89,224
307,Zaza Pachulia,C,19,ORL,59,2,664,68,175,0,0,68,175,58,90,69,105,174,13,21,12,34,87,194
308,Robert Pack,PG,34,NJN,26,0,220,22,52,0,0,22,52,5,6,4,14,18,27,12,1,16,20,49
309,Scott Padgett,PF,27,HOU,58,5,547,74,167,28,65,46,102,24,32,46,93,139,23,12,13,22,73,200
310,Milt Palacio,PG,25,TOR,59,13,1211,104,298,4,26,100,272,45,68,15,87,102,184,41,11,87,90,257
311,Jannero Pargo,PG,24,TOT,31,1,479,81,199,22,62,59,137,23,27,8,29,37,70,13,6,47,50,207
312,Tony Parker,PG,21,SAS,75,75,2577,423,946,62,199,361,747,191,272,43,194,237,411,61,7,179,148,1099
313,Cherokee Parks,C,31,GSW,12,0,64,4,10,0,0,4,10,4,6,4,6,10,1,0,3,2,7,12
314,Ruben Patterson,SF,28,POR,73,1,1651,200,395,2,12,198,383,105,190,129,139,268,139,84,21,105,152,507
315,Sasha Pavlović,SF,20,UTA,79,14,1144,149,376,19,70,130,306,65,84,44,115,159,60,41,16,67,187,382
316,Gary Payton*,PG,35,LAL,82,82,2825,482,1024,55,165,427,859,180,252,72,270,342,449,96,19,151,169,1199
317,Anthony Peeler,SG,34,SAC,75,0,1391,156,348,68,141,88,207,51,61,31,122,153,120,56,10,77,103,431
318,Desmond Penigar,PF,22,ORL,10,0,89,14,28,0,0,14,28,4,4,6,18,24,3,2,2,6,14,32
319,Kirk Penney,SG,23,MIA,2,0,18,1,6,1,3,0,3,0,0,0,1,1,1,1,0,3,1,3
320,Kendrick Perkins,C,19,BOS,10,0,35,8,15,0,0,8,15,6,9,5,9,14,3,0,2,5,6,22
321,Wesley Person,SG,32,TOT,58,0,1037,126,314,55,138,71,176,31,39,16,101,117,66,19,9,38,38,338
322,Morris Peterson,SF,26,TOR,82,29,2148,238,587,126,340,112,247,76,94,35,226,261,113,88,14,69,206,678
323,Eric Piatkowski,SF,33,HOU,49,0,703,72,191,43,122,29,69,14,16,10,63,73,26,16,5,29,42,201
324,Paul Pierce,SG,26,BOS,80,80,3099,602,1497,115,384,487,1113,517,631,69,453,522,410,131,52,303,234,1836
325,Mickaël Piétrus,PG,21,GSW,53,22,748,96,231,35,105,61,126,52,75,48,71,119,27,32,12,40,100,279
326,Scottie Pippen*,SF,38,CHI,23,6,412,53,140,13,48,40,92,17,27,20,48,68,50,21,9,29,38,136
327,Zoran Planinić,SG,21,NJN,49,1,473,53,129,9,32,44,97,38,60,14,41,55,68,13,3,36,70,153
328,Scot Pollard,C,28,IND,61,3,678,47,114,0,0,47,114,12,21,67,97,164,10,23,26,22,110,106
329,Olden Polynice,C,39,LAC,2,0,12,0,0,0,0,0,0,0,0,1,1,2,1,1,0,4,2,0
330,Mark Pope,PF,31,DEN,4,0,20,1,2,0,0,1,2,0,1,0,3,3,0,1,0,3,8,2
331,James Posey,SG,27,MEM,82,82,2451,368,770,112,290,256,480,278,335,92,311,403,122,137,40,112,248,1126
332,Vitaly Potapenko,C,28,SEA,65,39,1419,200,409,0,0,200,409,59,92,101,188,289,53,22,28,77,161,459
333,Tayshaun Prince,SF,23,DET,82,80,2701,338,723,57,157,281,566,108,141,93,297,390,191,63,69,119,149,841
334,Joel Przybilla,C,24,TOT,17,12,347,18,50,0,0,18,50,13,31,32,79,111,7,5,17,18,53,49
335,Vladimir Radmanović,PF,23,SEA,77,38,2321,345,812,140,377,205,435,95,127,104,302,406,142,80,42,109,187,925
336,Zach Randolph,PF,22,POR,81,80,3067,663,1368,1,5,662,1363,299,393,242,609,851,163,68,41,247,227,1626
337,Theo Ratliff,C,30,TOT,85,83,2664,266,549,0,0,266,549,140,217,195,419,614,71,54,307,120,300,672
338,Željko Rebrača,C,31,TOT,24,2,273,34,77,0,0,34,77,23,30,23,35,58,6,5,11,17,52,91
339,Michael Redd,SG,24,MIL,82,82,3021,633,1439,127,363,506,1076,383,441,118,289,407,185,81,6,116,152,1776
340,Glen Rice,SF,36,LAC,18,0,262,22,76,5,28,17,48,17,17,9,32,41,24,6,0,13,22,66
341,Jason Richardson,SG,23,GSW,78,78,2936,563,1284,77,273,486,1011,258,377,124,400,524,226,86,41,196,182,1461
342,Quentin Richardson,SG,23,LAC,65,64,2338,425,1068,120,341,305,727,151,204,146,268,414,139,67,19,141,130,1121
343,Luke Ridnour,PG,22,SEA,69,6,1114,145,350,27,80,118,270,65,79,35,73,108,163,52,7,80,105,382
344,Clifford Robinson,PF,37,GSW,82,82,2846,366,945,112,314,254,631,123,173,54,268,322,271,68,73,173,237,967
345,Eddie Robinson,SF,27,CHI,51,4,1024,157,326,1,5,156,321,28,43,27,77,104,58,33,10,45,57,343
346,Glenn Robinson,SF,31,PHI,42,42,1336,275,614,34,100,241,514,114,137,46,143,189,57,42,9,106,96,698
347,Rodney Rogers,PF,32,NJN,69,15,1409,207,505,50,152,157,353,75,98,100,207,307,137,59,27,98,183,539
348,Sean Rooks,C,34,TOT,55,0,595,54,151,0,1,54,150,33,37,24,73,97,29,14,10,22,89,141
350,Malik Rose,PF,29,SAS,67,13,1256,173,404,0,3,173,401,183,225,110,210,320,69,36,24,112,164,529
351,Michael Ruffin,PF,27,UTA,41,23,733,38,117,0,0,38,117,16,38,78,129,207,41,22,21,42,103,92
352,Kareem Rush,SG,23,LAL,72,15,1244,190,432,48,138,142,294,31,52,20,77,97,59,33,20,48,109,459
353,Bryon Russell,SF,33,LAL,72,1,945,98,244,43,112,55,132,50,65,32,114,146,71,32,12,37,110,289
354,John Salmons,SG,24,PHI,77,24,1603,161,416,50,147,111,269,71,92,38,158,196,134,62,16,77,122,443
355,Jamal Sampson,C,20,LAL,10,2,130,11,23,0,0,11,23,7,12,23,29,52,7,2,4,6,16,29
356,Daniel Santiago,C,27,MIL,54,28,708,78,163,0,0,78,163,61,90,35,97,132,24,19,21,32,98,217
357,Brian Scalabrine,PF,25,NJN,69,2,928,86,218,10,41,76,177,58,70,42,131,173,65,21,14,42,113,240
358,Ansu Sesay,SF,27,SEA,57,2,583,81,178,6,21,75,157,32,46,43,49,92,19,19,20,23,66,200
359,Paul Shirley,PF,26,CHI,7,0,86,10,23,0,1,10,22,1,3,8,8,16,4,1,1,9,9,21
360,Bobby Simmons,SF,23,LAC,56,8,1376,147,373,2,12,145,361,141,169,115,147,262,96,51,17,73,169,437
361,Brian Skinner,C,27,MIL,56,54,1577,255,513,0,0,255,513,79,138,119,292,411,49,30,61,78,165,589
362,Tamar Slay,SG,23,NJN,22,0,165,21,60,4,12,17,48,7,14,10,15,25,14,7,1,11,20,53
363,Jabari Smith,C,26,SAC,31,0,168,26,70,0,3,26,67,12,20,11,20,31,11,2,6,7,25,64
364,Joe Smith,PF,28,MIL,76,76,2254,311,708,1,5,310,703,207,241,230,413,643,78,47,94,82,209,830
365,Leon Smith,C,23,SEA,1,0,4,1,2,0,0,1,2,0,0,1,1,2,0,0,0,0,1,2
366,Steve Smith,SG,34,NOH,71,4,929,119,293,43,107,76,186,77,83,27,54,81,56,15,6,42,91,358
367,Theron Smith,SF,23,MEM,20,0,178,16,43,6,12,10,31,6,8,13,28,41,7,5,5,14,18,44
368,Eric Snow,PG,30,PHI,82,82,2966,295,715,2,18,293,697,252,316,62,219,281,563,97,6,187,213,844
369,Darius Songaila,PF,25,SAC,73,7,976,133,273,0,0,133,273,71,88,91,134,225,48,42,12,43,126,337
370,Latrell Sprewell,SF,33,MIN,82,82,3100,518,1266,99,299,419,967,240,295,56,254,310,286,88,21,158,101,1375
371,Jerry Stackhouse,SF,29,WAS,26,17,774,128,321,23,65,105,256,83,103,16,78,94,103,24,3,88,49,362
372,Vladimir Stepania,C,27,POR,42,2,453,43,103,0,0,43,103,22,36,50,75,125,23,11,15,19,61,108
375,Peja Stojaković,SF,26,SAC,81,81,3264,665,1386,240,554,425,832,394,425,91,417,508,173,108,14,153,159,1964
376,Damon Stoudamire,PG,30,POR,82,82,3118,408,1018,156,427,252,591,127,145,52,256,308,500,99,9,180,173,1099
377,Amar'e Stoudemire,PF,21,PHO,55,53,2025,411,865,1,5,410,860,310,435,157,339,496,78,64,89,177,188,1133
378,Erick Strickland,PG,30,MIL,43,0,571,79,196,29,66,50,130,44,51,13,58,71,90,26,2,54,63,231
379,Rod Strickland,PG,37,TOT,61,10,1197,150,353,10,36,140,317,72,98,34,121,155,244,35,11,85,76,382
380,Bruno Šundov,C,23,TOT,5,0,33,4,10,0,0,4,10,3,6,2,8,10,1,0,0,3,9,11
381,Bob Sura,SG,30,TOT,80,18,1663,202,485,21,79,181,406,171,226,100,226,326,233,62,14,105,158,596
382,Mike Sweetney,PF,21,NYK,42,1,494,69,140,0,1,69,139,42,58,68,89,157,14,18,12,32,57,180
383,Stromile Swift,PF,24,MEM,77,10,1528,268,571,1,4,267,567,190,262,141,237,378,38,56,118,88,188,727
384,Wally Szczerbiak,SF,26,MIN,28,0,622,106,236,20,46,86,190,53,64,24,64,88,33,12,1,28,42,285
385,Maurice Taylor,PF,27,HOU,75,10,2081,367,765,0,2,367,763,128,174,131,253,384,107,43,47,149,253,862
386,Jason Terry,PG,26,ATL,81,78,3018,499,1196,146,421,353,775,215,260,49,287,336,437,124,16,229,192,1359
387,Etan Thomas,C,25,WAS,79,15,1901,257,526,0,0,257,526,191,295,183,345,528,68,36,123,113,219,705
388,Kenny Thomas,PF,26,PHI,74,72,2699,381,813,1,5,380,808,243,323,261,489,750,111,82,33,172,219,1006
389,Kurt Thomas,PF,31,NYK,80,75,2548,392,829,0,3,392,826,106,127,145,517,662,149,56,80,132,298,890
390,Tim Thomas,SF,26,TOT,66,65,2089,363,813,73,194,290,619,171,218,64,256,320,124,64,20,116,196,970
391,Jamaal Tinsley,PG,25,IND,52,43,1378,153,370,77,207,76,163,49,67,28,108,136,303,84,17,110,132,432
392,Robert Traylor,C,26,NOH,71,0,942,145,287,2,5,143,282,70,128,106,156,262,43,39,37,62,161,362
393,Gary Trent,C,29,MIN,68,2,1025,155,328,0,6,155,322,69,91,83,133,216,49,12,17,54,129,379
394,Jeff Trepagnier,SG,24,DEN,11,0,96,10,38,2,4,8,34,3,6,6,9,15,4,3,0,6,7,25
395,Cezary Trybański,C,24,TOT,7,0,15,0,4,0,0,0,4,1,2,0,1,1,0,1,1,2,3,1
396,Jake Tsakalidis,C,24,MEM,40,28,533,67,133,0,0,67,133,36,61,37,91,128,18,9,22,23,79,170
397,Nikoloz Tskitishvili,PF,20,DEN,39,0,307,40,122,3,11,37,111,23,29,24,39,63,10,6,8,17,50,106
398,Hedo Türkoğlu,SF,24,SAS,80,44,2073,262,645,101,241,161,404,114,161,52,306,358,154,80,32,94,165,739
399,Ime Udoka,SF,26,LAL,4,0,28,3,9,0,1,3,8,2,4,1,4,5,2,2,1,3,3,8
400,Nick Van Exel,PG,32,GSW,39,29,1255,187,479,46,150,141,329,70,99,16,88,104,206,20,2,78,57,490
401,Keith Van Horn,SF,28,TOT,72,62,2340,410,903,93,233,317,670,249,290,149,352,501,120,68,33,169,215,1162
402,Jacque Vaughn,PG,28,ATL,71,6,1271,107,277,3,20,104,257,53,68,12,104,116,195,44,2,84,126,270
403,Jake Voskuhl,C,26,PHO,66,43,1606,152,300,0,0,152,300,134,181,123,220,343,57,42,25,77,258,438
404,Slavko Vraneš,C,21,POR,1,0,3,0,1,0,0,0,1,0,0,0,0,0,0,0,0,0,1,0
405,Dwyane Wade,PG,22,MIA,61,56,2126,371,798,16,53,355,745,233,312,85,162,247,275,86,34,196,140,991
406,Dajuan Wagner,SG,20,CLE,44,4,708,112,306,31,86,81,220,32,47,9,49,58,51,26,7,41,89,287
407,Antoine Walker,PF,27,DAL,82,82,2840,483,1129,82,305,401,824,103,186,198,486,684,369,65,65,202,212,1151
408,Samaki Walker,PF,27,MIA,33,0,418,38,99,0,2,38,97,29,44,42,70,112,6,9,11,15,54,105
409,Ben Wallace,C,29,DET,81,81,3050,315,748,1,8,314,740,142,290,324,682,1006,138,143,246,123,162,773
410,Gerald Wallace,SF,21,SAC,37,1,337,32,89,0,2,32,87,11,24,35,39,74,19,14,14,8,37,75
411,John Wallace,SF,29,MIA,37,0,368,61,145,5,13,56,132,31,40,12,47,59,14,5,8,24,38,158
412,Rasheed Wallace,PF,29,TOT,68,66,2390,425,974,82,248,343,726,156,212,102,357,459,156,61,122,119,190,1088
413,Luke Walton,PF,23,LAL,72,2,730,65,153,13,39,52,114,31,44,39,88,127,113,28,8,44,70,174
414,Charlie Ward,PG,33,TOT,71,10,1252,160,390,84,206,76,184,20,27,12,132,144,215,64,11,96,107,424
415,Earl Watson,PG,24,MEM,81,14,1669,172,464,26,106,146,358,90,138,49,129,178,402,91,19,146,175,460
416,Clarence Weatherspoon,PF,33,TOT,52,1,868,104,211,0,1,104,210,53,72,74,130,204,30,30,15,35,75,261
417,Chris Webber,PF,30,SAC,23,23,831,174,421,1,5,173,416,81,114,48,152,200,105,31,20,60,76,430
418,Bonzi Wells,SG,27,TOT,72,27,1872,363,850,22,69,341,781,138,183,78,182,260,139,91,19,161,197,886
419,Jiří Welsch,SG,24,BOS,81,68,2179,262,612,69,181,193,431,153,206,60,236,296,183,101,7,129,176,746
420,David Wesley,SG,33,NOH,61,60,2001,311,800,92,285,219,515,137,182,28,106,134,175,71,14,100,147,851
421,David West,PF,23,NOH,71,1,930,108,228,0,2,108,226,57,80,117,180,297,60,27,28,48,117,273
422,Jahidi White,C,27,TOT,62,17,865,99,190,0,0,99,190,63,126,97,164,261,7,25,51,66,176,261
423,Rodney White,SF,23,DEN,72,0,985,215,468,33,87,182,381,78,104,44,121,165,60,32,20,78,105,541
424,Chris Whitney,PG,32,WAS,16,5,186,17,45,8,18,9,27,5,5,3,12,15,14,6,2,6,6,47
425,Chris Wilcox,C,21,LAC,65,17,1340,227,436,0,1,227,435,105,150,125,180,305,51,29,20,80,183,559
426,Mike Wilks,PG,24,HOU,26,0,145,17,36,6,10,11,26,10,12,3,13,16,17,3,0,7,15,50
427,Aaron Williams,C,32,NJN,72,7,1337,172,342,1,3,171,339,105,155,101,193,294,81,34,46,89,187,450
428,Alvin Williams,SG,29,TOR,56,54,1730,201,496,26,89,175,407,66,85,18,132,150,224,55,10,78,114,494
429,Eric Williams,SF,31,TOT,71,36,1886,231,598,35,127,196,471,215,283,65,221,286,120,70,9,88,180,712
430,Frank Williams,PG,23,NYK,56,3,714,80,208,18,60,62,148,41,48,8,45,53,121,25,6,63,58,219
431,Jason Williams,PG,28,MEM,72,68,2115,290,713,120,364,170,349,82,98,25,122,147,492,92,5,136,97,782
432,Jerome Williams,PF,30,TOT,68,44,1637,158,336,0,8,158,328,106,155,177,298,475,72,90,8,74,134,422
433,Mo Williams,SG,21,UTA,57,0,772,115,303,10,39,105,264,44,56,23,49,72,76,28,2,51,87,284
434,Scott Williams,C,35,TOT,43,21,527,90,186,2,3,88,183,16,27,38,94,132,17,20,16,16,95,198
436,Corliss Williamson,PF,30,DET,79,0,1574,304,602,0,0,304,602,144,197,88,168,256,57,30,20,113,204,752
437,Kevin Willis,C,41,SAS,48,0,373,70,150,0,1,70,149,24,39,37,61,98,11,21,9,32,61,164
438,Loren Woods,C,25,MIA,38,2,506,44,96,0,0,44,96,33,55,65,69,134,10,11,19,26,52,121
439,Qyntel Woods,SF,22,POR,62,8,673,88,237,10,29,78,208,38,60,46,90,136,46,20,14,52,88,224
440,Metta World Peace,SF,24,IND,73,71,2714,468,1112,75,242,393,870,322,439,100,285,385,272,152,50,202,194,1333
441,Lorenzen Wright,C,28,MEM,65,46,1674,257,586,0,5,257,581,96,131,144,301,445,71,45,58,77,192,610
442,Wang Zhizhi,C,26,TOT,16,0,114,17,46,4,14,13,32,9,10,4,14,18,2,3,5,6,13,47
