Rk,Player,Pos,Age,Tm,G,GS,MP,FG,FGA,3P,3PA,2P,2PA,FT,FTA,ORB,DRB,TRB,AST,STL,BLK,TOV,PF,PTS
1,Shareef Abdur-Rahim,PF,28,POR,54,49,1867,337,670,15,39,322,631,220,254,123,269,392,111,49,26,117,150,909
2,Cory Alexander,SG,31,CHA,16,1,201,16,49,8,19,8,30,9,12,8,21,29,37,9,1,19,29,49
3,Malik Allen,PF,26,TOT,36,1,519,84,177,0,0,84,177,26,28,40,59,99,18,9,22,18,53,194
4,Ray Allen*,SG,29,SEA,78,78,3064,640,1494,209,556,431,938,378,428,79,268,347,289,84,5,171,167,1867
5,Tony Allen,SG,23,BOS,77,34,1262,184,387,12,31,172,356,112,152,85,136,221,64,76,24,77,156,492
6,Rafer Alston,PG,28,TOR,80,78,2717,403,974,139,389,264,585,191,258,42,237,279,514,118,7,170,212,1136
7,Chris Andersen,C,26,NOH,67,2,1430,191,358,0,3,191,355,131,190,137,273,410,71,14,100,64,144,513
8,Derek Anderson,SG,30,POR,47,32,1239,152,391,58,151,94,240,70,87,25,103,128,143,36,4,70,89,432
9,Kenny Anderson,PG,34,TOT,43,20,743,85,201,6,13,79,188,27,37,24,64,88,103,33,0,49,87,203
11,Carmelo Anthony,SF,20,DEN,75,75,2608,530,1230,42,158,488,1072,456,573,141,285,426,194,68,30,224,229,1558
12,Rafael Araújo,C,24,TOR,59,41,736,76,175,1,3,75,172,43,55,59,126,185,16,21,8,52,157,196
13,Gilbert Arenas,PG,23,WAS,80,80,3274,656,1523,205,562,451,961,521,640,83,295,378,411,139,23,242,245,2038
14,Trevor Ariza,SF,19,NYK,80,12,1382,172,389,3,13,169,376,121,174,89,153,242,85,70,18,73,150,468
15,Darrell Armstrong,PG,36,TOT,66,16,988,89,277,28,111,61,166,58,68,35,80,115,178,45,8,67,92,264
16,Carlos Arroyo,PG,25,TOT,70,16,1448,167,429,8,30,159,399,119,149,26,78,104,280,44,4,107,143,461
17,Chucky Atkins,PG,30,LAL,82,82,2903,388,910,176,455,212,455,163,203,31,166,197,358,73,2,151,181,1115
18,Stacey Augmon,SF,36,ORL,55,7,663,68,167,0,0,68,167,57,77,45,54,99,36,23,8,31,83,193
19,Maurice Baker,PG,25,TOT,5,0,19,0,1,0,0,0,1,0,0,1,1,2,1,1,0,1,3,0
21,Marcus Banks,PG,23,BOS,81,2,1145,115,286,21,59,94,227,121,163,29,97,126,155,63,13,79,146,372
22,Leandro Barbosa,PG,22,PHO,63,6,1087,168,354,51,139,117,215,55,69,32,98,130,126,30,7,87,127,442
23,Matt Barnes,SF,24,SAC,43,9,715,62,151,5,22,57,129,35,58,49,84,133,57,30,7,45,80,164
24,Andre Barrett,PG,22,TOT,38,1,483,45,124,14,52,31,72,14,19,11,29,40,69,19,1,27,51,118
25,Brent Barry,SG,33,SAS,81,8,1742,194,459,100,280,94,179,113,135,29,161,190,178,39,20,64,123,601
26,Jon Barry,SG,35,TOT,69,2,1505,161,368,71,165,90,203,62,71,26,133,159,167,60,9,67,95,455
27,Tony Battie,C,28,ORL,81,32,1894,163,354,0,6,163,348,68,94,109,343,452,42,30,81,81,244,394
28,Shane Battier,SG,26,MEM,80,72,2516,271,613,70,177,201,436,180,228,158,255,413,126,91,77,75,201,792
29,Lonny Baxter,PF,26,NOH,4,0,36,3,11,0,0,3,11,0,2,4,4,8,0,0,0,4,10,6
30,Raja Bell,SG,28,UTA,63,32,1790,303,667,54,134,249,533,112,150,48,153,201,91,44,8,79,205,772
31,Jonathan Bender,SF,24,IND,7,0,93,16,40,1,5,15,35,3,6,5,9,14,4,1,2,10,9,36
32,Travis Best,PG,32,NJN,76,6,1461,190,452,26,85,164,367,108,122,19,88,107,143,66,9,67,148,514
33,Mike Bibby,PG,26,SAC,80,80,3084,560,1264,131,364,429,900,320,413,77,255,332,541,124,30,203,191,1571
34,Andris Biedriņš,C,18,GSW,30,1,384,45,78,0,1,45,77,19,40,47,71,118,12,12,24,12,87,109
35,Chauncey Billups,PG,28,DET,80,80,2866,404,913,165,387,239,526,343,382,48,223,271,464,81,9,180,194,1316
36,Steve Blake,PG,24,WAS,44,1,648,61,186,36,93,25,93,33,41,18,53,71,69,13,0,39,47,191
37,Mark Blount,C,29,BOS,82,57,2130,327,618,0,1,327,617,117,164,143,254,397,129,33,64,158,229,771
38,Tony Bobbitt,SG,25,LAL,2,0,12,2,5,1,2,1,3,0,0,0,3,3,0,0,0,0,1,5
39,Keith Bogans,SG,24,CHA,74,42,1791,262,688,57,173,205,515,133,183,76,150,226,135,68,8,122,167,714
40,Matt Bonner,C,24,TOR,82,0,1553,247,463,39,92,208,371,56,71,108,177,285,48,39,19,40,220,589
41,Calvin Booth,C,28,TOT,51,1,451,49,108,0,1,49,107,26,32,29,78,107,8,15,28,16,78,124
42,Carlos Boozer,PF,23,UTA,51,51,1772,361,693,0,1,361,692,187,268,141,316,457,144,41,24,137,179,909
43,Curtis Borchardt,C,24,UTA,67,23,859,74,172,0,0,74,172,52,71,86,138,224,49,10,32,52,160,200
44,Chris Bosh,PF,20,TOR,81,81,3017,473,1005,3,10,470,995,412,542,194,524,718,153,76,113,187,226,1361
45,Bruce Bowen,SF,33,SAS,82,82,2627,251,598,102,253,149,345,71,112,50,235,285,126,55,39,57,175,675
46,Ryan Bowen,SF,29,HOU,66,6,604,47,111,3,6,44,105,14,21,21,55,76,18,23,5,7,61,111
47,Earl Boykins,PG,28,DEN,82,5,2162,340,824,56,166,284,658,279,303,37,106,143,372,78,12,121,122,1015
48,Michael Bradley,PF,25,TOT,18,0,119,15,24,0,1,15,23,3,8,8,20,28,5,1,2,5,12,33
49,Shawn Bradley,C,32,DAL,77,14,885,84,186,0,0,84,186,43,63,70,144,214,15,25,63,33,153,211
50,Torraye Braggs,PF,28,HOU,7,0,24,3,7,0,0,3,7,0,0,7,5,12,0,0,0,2,4,6
51,Elton Brand,PF,25,LAC,81,81,3001,629,1251,0,3,629,1248,364,484,296,474,770,208,62,169,183,240,1622
52,Jamison Brewer,PG,24,NYK,18,0,185,11,37,3,15,8,22,6,13,6,16,22,12,8,1,13,11,31
53,Primož Brezec,C,25,CHA,72,72,2276,387,756,0,0,387,756,164,220,226,305,531,86,33,55,106,183,938
54,Damone Brown,SF,25,WAS,14,0,152,23,62,4,11,19,51,4,9,10,18,28,14,1,6,15,17,54
55,Devin Brown,SG,26,SAS,67,0,1238,173,409,45,121,128,288,103,130,37,139,176,92,39,12,53,83,494
56,Kedrick Brown,SF,23,PHI,8,0,55,2,6,0,3,2,3,8,10,1,10,11,4,3,1,5,4,12
57,Kwame Brown,PF,22,WAS,42,14,908,109,237,0,0,109,237,74,129,72,134,206,39,25,15,67,112,292
58,P.J. Brown,PF,35,NOH,82,78,2817,338,758,0,0,338,758,210,243,266,471,737,178,74,50,101,233,886
59,Tierre Brown,PG,25,LAL,76,0,1066,124,348,26,72,98,276,59,75,21,72,93,155,32,1,74,59,333
60,Rick Brunson,PG,32,LAC,80,39,1945,166,442,48,130,118,312,57,74,23,164,187,410,82,7,125,106,437
61,Kobe Bryant,SG,26,LAL,66,66,2689,573,1324,131,387,442,937,542,664,95,297,392,398,86,53,270,174,1819
62,Greg Buckner,SG,28,DEN,70,41,1522,160,303,49,121,111,182,63,81,66,142,208,133,75,6,49,169,432
63,Rodney Buford,SF,27,NJN,64,17,1313,187,489,34,108,153,381,37,45,33,156,189,63,40,4,35,101,445
64,Antonio Burks,PG,24,MEM,24,0,219,28,60,3,11,25,49,14,19,1,11,12,28,13,1,12,25,73
65,Caron Butler,SF,24,LAL,77,77,2746,441,991,38,125,403,866,275,319,146,304,450,146,110,23,125,213,1195
66,Jackie Butler,C,19,NYK,3,0,5,4,4,0,0,4,4,2,2,0,0,0,0,1,0,1,0,10
67,Rasual Butler,SF,25,MIA,65,15,1203,163,409,57,153,106,256,37,48,15,136,151,62,18,29,37,104,420
68,Žarko Čabarkapa,PF,23,TOT,40,0,475,86,177,13,36,73,141,53,65,35,67,102,25,10,5,30,59,238
69,Marcus Camby,C,30,DEN,66,66,2015,279,600,0,4,279,596,125,173,131,530,661,152,61,199,103,177,683
70,Elden Campbell,C,36,TOT,40,1,390,39,123,0,2,39,121,42,55,28,65,93,19,8,7,29,57,120
71,Brian Cardinal,PF,27,MEM,58,16,1433,160,432,44,125,116,307,158,181,63,162,225,114,88,19,83,172,522
72,Geno Carlisle,SG,28,POR,6,0,16,2,3,0,0,2,3,4,6,1,0,1,1,0,0,1,1,8
73,Matt Carroll,SG,24,CHA,25,0,430,70,180,13,39,57,141,71,83,13,47,60,17,17,2,25,37,224
74,Anthony Carter,PG,29,MIN,66,12,742,72,177,2,17,70,160,35,51,12,57,69,161,35,18,62,88,181
76,Sam Cassell,PG,35,MIN,59,38,1522,319,687,27,103,292,584,134,155,25,132,157,301,36,14,109,160,799
77,Kelvin Cato,C,30,ORL,62,50,1525,160,297,0,0,160,297,112,143,102,314,416,40,55,82,64,170,432
78,Lionel Chalmers,PG,24,LAC,36,0,433,42,125,12,49,30,76,15,24,4,27,31,51,13,0,24,30,111
79,Tyson Chandler,C,22,CHI,80,10,2189,207,419,0,2,207,417,226,336,261,514,775,65,69,141,118,268,640
80,Calbert Cheaney,SG,33,GSW,55,5,951,113,265,0,3,113,262,24,37,32,92,124,64,17,15,35,95,250
81,Josh Childress,SG,21,ATL,80,44,2376,302,642,13,56,289,586,190,231,195,287,482,151,74,35,106,184,807
82,Doug Christie,SG,34,TOT,52,44,1525,130,332,15,62,115,270,70,78,38,139,177,199,80,18,104,106,345
83,Speedy Claxton,PG,26,TOT,62,47,1866,257,611,11,61,246,550,187,254,37,147,184,374,109,8,119,184,712
84,Mateen Cleaves,PG,27,SEA,14,0,65,5,14,0,2,5,12,3,4,2,4,6,7,2,0,2,2,13
85,Derrick Coleman,C,37,DET,5,0,50,3,14,0,2,3,12,3,3,3,12,15,0,0,0,2,6,9
86,Jason Collier,C,27,ATL,70,44,942,174,376,6,14,168,362,48,71,84,100,184,18,15,13,63,147,402
87,Jarron Collins,C,26,UTA,50,38,961,65,157,0,1,65,156,83,119,57,107,164,61,11,6,34,146,213
88,Jason Collins,C,26,NJN,80,80,2542,186,451,2,6,184,445,137,209,153,335,488,105,71,71,91,322,511
89,Nick Collison,C,24,SEA,82,4,1396,190,354,0,3,190,351,83,118,156,220,376,32,34,50,62,252,463
90,Brian Cook,C,24,LAL,72,0,1087,176,422,78,199,98,223,28,37,63,153,216,35,23,26,29,139,458
91,Omar Cook,PG,23,TOR,5,0,74,10,24,0,4,10,20,3,6,2,5,7,22,6,1,6,6,23
92,Jamal Crawford,SG,24,NYK,70,67,2688,437,1097,185,512,252,585,182,216,33,170,203,302,92,19,148,135,1241
93,Austin Croshere,PF,29,IND,73,22,1827,188,497,45,174,143,323,226,256,103,272,375,98,48,17,104,154,647
94,Eddy Curry,C,22,CHI,63,60,1808,393,730,0,0,393,730,226,314,116,222,338,37,21,58,163,202,1012
95,Michael Curry,SF,36,IND,18,7,249,13,29,0,0,13,29,4,8,8,19,27,15,5,4,5,39,30
96,Samuel Dalembert,C,23,PHI,72,60,1785,250,477,0,0,250,477,89,148,187,355,542,35,46,121,114,241,589
97,Erick Dampier,C,29,DAL,59,56,1609,202,367,0,3,202,364,138,228,183,318,501,51,15,80,102,205,542
98,Antonio Daniels,PG,29,SEA,75,2,2026,273,623,49,165,224,458,248,304,20,149,169,309,51,3,78,78,843
99,Erik Daniels,SF,22,SAC,21,0,72,6,18,1,2,5,16,0,0,7,11,18,4,2,0,6,7,13
100,Marquis Daniels,SG,24,DAL,60,17,1412,220,504,7,35,213,469,98,133,87,129,216,128,83,14,86,124,545
101,Antonio Davis,PF,36,CHI,72,62,1843,193,419,0,0,193,419,115,152,152,276,428,80,27,41,96,147,501
102,Baron Davis,PG,25,TOT,46,32,1581,291,752,118,354,173,398,185,243,32,143,175,362,81,14,131,126,885
103,Dale Davis,C,35,TOT,61,28,1307,112,234,0,0,112,234,60,99,152,223,375,47,32,65,43,162,284
104,Josh Davis,PF,24,PHI,42,5,328,42,111,19,53,23,58,14,17,29,50,79,12,8,4,15,45,117
105,Ricky Davis,SG,25,BOS,82,11,2696,481,1041,61,180,420,861,286,351,66,183,249,246,89,27,205,174,1309
106,Andrew DeClercq,C,31,ORL,8,0,49,4,9,0,0,4,9,1,3,7,3,10,0,2,0,1,14,9
107,Carlos Delfino,SG,22,DET,30,4,459,42,117,9,35,33,82,23,40,13,42,55,38,22,6,23,44,116
108,Tony Delk,SG,31,ATL,56,1,1340,246,591,72,202,174,389,103,136,28,102,130,104,47,3,54,123,667
109,Luol Deng,SF,19,CHI,61,45,1663,280,645,31,117,249,528,120,162,92,230,322,135,48,27,118,98,711
110,Boris Diaw,SG,22,ATL,66,25,1201,124,294,9,50,115,244,57,77,54,116,170,149,37,18,87,123,314
111,Dan Dickau,PG,26,TOT,71,46,2090,306,756,85,245,221,511,190,228,34,146,180,347,76,4,145,201,887
112,Kaniel Dickens,SF,26,NJN,11,0,61,4,14,3,9,1,5,2,2,3,6,9,1,2,1,2,5,13
113,DeSagana Diop,C,23,CLE,39,0,306,20,69,0,2,20,67,0,5,30,40,70,15,8,27,12,53,40
114,Vlade Divac*,C,36,LAL,15,0,130,13,31,0,0,13,31,8,12,18,14,32,19,4,1,14,25,34
115,Juan Dixon,SG,26,WAS,63,4,1054,186,447,48,147,138,300,87,97,32,87,119,111,43,4,68,98,507
116,Michael Doleac,C,27,MIA,80,8,1175,148,331,0,2,148,329,25,41,74,185,259,47,23,22,36,160,321
117,Keyon Dooling,PG,24,MIA,74,0,1184,139,345,19,75,120,270,85,109,11,79,90,132,39,11,65,120,382
118,Predrag Drobnjak,C,29,ATL,71,1,1435,238,543,25,71,213,472,96,120,73,165,238,49,42,24,78,138,597
119,Chris Duhon,PG,22,CHI,82,73,2177,172,488,94,265,78,223,49,67,23,190,213,398,82,3,119,205,487
120,Tim Duncan,PF,28,SAS,66,66,2203,517,1042,3,9,514,1033,305,455,202,530,732,179,45,174,127,144,1342
121,Mike Dunleavy,SF,24,GSW,79,79,2570,408,905,107,276,301,629,134,172,97,338,435,203,79,26,132,198,1057
122,Ronald Dupree,SF,24,DET,47,0,472,61,127,1,2,60,125,29,47,34,61,95,24,7,10,22,60,152
123,Ndudi Ebi,SG,20,MIN,2,0,54,11,21,0,1,11,20,5,9,6,10,16,1,1,1,3,7,27
124,Corsley Edwards,C,25,NOH,10,0,110,10,31,0,0,10,31,7,12,12,13,25,3,3,4,2,19,27
125,John Edwards,C,23,IND,25,1,139,11,30,0,0,11,30,7,14,8,11,19,3,3,4,8,12,29
126,Howard Eisley,PG,32,UTA,74,1,1428,161,405,27,103,134,302,66,83,15,75,90,250,45,9,111,156,415
127,Obinna Ekezie,C,29,ATL,42,31,732,79,182,0,1,79,181,72,93,69,110,179,11,22,12,45,129,230
128,Francisco Elson,C,28,DEN,67,11,939,101,216,1,3,100,213,45,79,61,140,201,34,34,41,40,129,248
129,Melvin Ely,PF,26,CHA,79,17,1649,227,526,0,0,227,526,122,212,142,184,326,76,32,69,115,199,576
130,Andre Emmett,SG,22,MEM,8,0,28,2,6,0,0,2,6,3,5,0,2,2,0,0,0,1,4,7
131,Maurice Evans,SG,26,SAC,65,11,1233,165,373,27,82,138,291,59,78,88,113,201,45,37,8,34,104,416
132,Reggie Evans,PF,24,SEA,79,79,1881,131,275,0,2,131,273,125,234,254,482,736,58,58,15,104,202,387
133,Michael Finley,SG,31,DAL,64,64,2358,387,907,116,285,271,622,113,136,45,217,262,169,48,18,60,123,1003
134,Derek Fisher,PG,30,GSW,74,32,2222,297,755,108,291,189,464,175,203,38,180,218,301,76,4,129,176,877
135,Marcus Fizer,PF,26,MIL,54,0,903,133,292,0,6,133,286,70,103,29,146,175,64,25,13,63,96,336
136,Luis Flores,PG,23,TOT,16,0,77,14,29,5,10,9,19,2,2,1,2,3,11,2,0,11,9,35
137,Danny Fortson,C,28,SEA,62,0,1047,118,226,0,0,118,226,227,258,157,191,348,8,15,7,91,265,463
138,Jeff Foster,C,28,IND,61,43,1594,168,324,0,5,168,319,90,142,205,345,550,43,46,12,55,186,426
139,Tremaine Fowlkes,SF,28,IND,8,0,56,9,17,1,3,8,14,0,2,3,5,8,0,2,0,5,7,19
140,Adonal Foyle,C,29,GSW,78,50,1700,156,311,0,0,156,311,40,72,165,264,429,56,26,159,58,201,352
141,Richie Frahm,SG,27,POR,43,0,499,56,140,31,80,25,60,21,25,17,44,61,30,15,4,14,35,164
142,Steve Francis,PG,27,ORL,78,78,2978,563,1330,38,127,525,1203,499,606,126,324,450,547,112,28,317,273,1663
143,Matt Freije,PF,23,NOH,23,11,441,37,127,14,54,23,73,5,8,16,45,61,20,13,2,17,40,93
144,Lawrence Funderburke,PF,34,CHI,2,0,21,3,6,0,0,3,6,3,5,1,2,3,0,0,0,0,2,9
145,Dan Gadzuric,C,26,MIL,81,81,1783,243,451,0,0,243,451,107,199,261,413,674,30,47,106,81,224,593
146,Reece Gaines,PG,24,TOT,21,0,187,17,50,4,14,13,36,3,4,1,13,14,7,5,1,7,17,41
147,Alex Garcia,SG,24,NOH,8,3,146,18,52,5,18,13,34,3,4,7,8,15,18,4,1,8,15,44
148,Kevin Garnett,PF,28,MIN,82,82,3121,683,1360,6,25,677,1335,445,549,247,861,1108,466,121,112,222,207,1817
149,Pat Garrity,PF,28,ORL,71,0,955,123,306,49,147,74,159,29,33,21,103,124,30,19,9,30,107,324
150,Pau Gasol,PF,24,MEM,56,53,1790,357,695,1,6,356,689,282,367,130,280,410,135,37,93,137,146,997
151,Devean George,SF,27,LAL,15,3,306,37,104,21,58,16,46,15,20,13,40,53,14,8,2,12,32,110
152,Eddie Gill,PG,26,IND,73,3,1021,81,242,36,117,45,125,71,81,16,96,112,83,59,5,60,105,269
153,Kendall Gill,SG,36,MIL,14,0,284,32,80,3,9,29,71,18,20,11,26,37,27,14,4,9,37,85
154,Manu Ginóbili,SG,27,SAS,74,74,2193,367,780,97,258,270,522,355,442,75,254,329,288,119,27,172,190,1186
155,Gordan Giriček,SG,27,UTA,81,44,1660,283,632,38,105,245,527,111,137,25,157,182,137,46,11,90,155,715
156,Dion Glover,SG,26,SAS,7,0,68,8,22,1,8,7,14,8,10,3,8,11,4,3,3,2,9,25
157,Anthony Goldwire,PG,33,TOT,33,2,537,57,136,32,80,25,56,26,31,10,49,59,78,15,0,15,32,172
158,Drew Gooden,PF,23,CLE,82,80,2523,464,943,5,28,459,915,251,310,207,546,753,130,77,76,133,233,1184
159,Ben Gordon,SG,21,CHI,82,3,2002,434,1056,134,331,300,725,233,270,55,160,215,164,53,10,186,224,1235
160,Brian Grant,C,32,LAL,69,8,1136,103,209,0,0,103,209,57,79,101,156,257,34,23,23,43,175,263
161,Willie Green,SG,23,PHI,57,21,1066,155,423,30,105,125,318,97,125,22,111,133,100,34,6,75,121,437
162,Adrian Griffin,SF,30,CHI,69,1,667,58,161,2,9,56,152,33,44,52,94,146,53,43,4,30,78,151
163,Eddie Griffin,PF,22,MIN,70,0,1492,202,522,67,204,135,318,56,78,128,325,453,53,23,118,55,120,527
164,Tom Gugliotta,PF,35,TOT,47,9,966,99,241,8,26,91,215,33,43,56,135,191,68,41,17,57,104,239
165,Marcus Haislip,PF,24,IND,9,0,106,13,38,0,1,13,37,6,11,5,10,15,3,2,2,6,15,32
166,Darvin Ham,SF,31,DET,47,0,275,17,37,0,0,17,37,12,31,19,16,35,5,6,7,8,39,46
167,Richard Hamilton,SG,26,DET,76,76,2926,510,1160,36,118,474,1042,368,429,74,221,295,372,77,13,217,232,1424
168,Zendon Hamilton,C,29,MIL,16,0,159,11,32,0,0,11,32,29,48,18,24,42,6,5,2,12,26,51
169,Ben Handlogten,C,31,UTA,21,5,297,43,83,0,1,43,82,9,17,23,42,65,13,7,5,18,55,95
170,Anfernee Hardaway,SF,33,NYK,37,0,894,110,260,15,50,95,210,34,46,19,70,89,74,28,3,50,79,269
171,Matt Harpring,SF,28,UTA,78,55,2584,418,855,9,43,409,812,245,315,196,284,480,142,70,16,133,250,1090
172,Al Harrington,SF,24,ATL,66,66,2550,453,986,16,74,437,912,236,351,145,316,461,208,85,16,204,249,1158
173,Junior Harrington,SG,24,NOH,29,7,550,64,178,6,19,58,159,29,35,13,50,63,62,25,5,41,72,163
174,Othella Harrington,PF,31,CHI,70,28,1271,217,424,0,0,217,424,127,177,106,186,292,56,24,18,84,188,561
175,Devin Harris,PG,21,DAL,76,19,1173,157,366,44,131,113,235,78,103,28,74,102,169,77,19,82,139,436
176,Lucious Harris,SG,34,CLE,73,4,1128,118,299,21,65,97,234,56,69,39,82,121,49,27,6,29,68,313
177,David Harrison,C,22,IND,43,14,760,106,184,0,0,106,184,52,91,48,87,135,13,16,55,53,134,264
178,Jason Hart,PG,26,CHA,74,27,1887,257,573,35,95,222,478,157,200,18,185,203,367,99,14,102,167,706
179,Donnell Harvey,PF,24,NJN,3,0,16,2,2,0,0,2,2,4,4,2,5,7,1,1,1,1,2,8
180,Udonis Haslem,PF,24,MIA,80,80,2675,346,641,0,4,346,637,178,225,239,487,726,108,63,41,113,260,870
181,Trenton Hassell,SG,25,MIN,82,51,2068,225,475,1,11,224,464,90,114,80,139,219,128,30,30,64,200,541
182,Jarvis Hayes,SF,23,WAS,54,22,1560,206,530,42,123,164,407,99,118,41,186,227,90,49,9,62,107,553
183,Brendan Haywood,C,25,WAS,68,68,1865,239,427,0,0,239,427,159,261,202,262,464,57,52,114,96,218,637
184,Alan Henderson,PF,32,DAL,78,10,1203,116,220,0,2,116,218,41,76,164,184,348,21,29,37,49,149,273
185,Nenê Hilário,C,22,DEN,55,18,1317,194,386,0,2,194,384,140,212,104,221,325,84,50,48,94,167,528
186,Grant Hill*,SF,32,ORL,67,67,2338,517,1015,3,13,514,1002,280,341,77,241,318,220,97,28,161,144,1317
187,Kirk Hinrich,PG,24,CHI,77,77,2800,445,1122,145,408,300,714,171,216,32,272,304,494,122,21,176,244,1206
188,Fred Hoiberg,SG,32,MIN,76,0,1272,139,284,70,145,69,139,89,102,32,149,181,85,50,15,20,105,437
189,Robert Horry,PF,34,SAS,75,16,1396,157,375,51,138,106,237,86,109,91,177,268,80,67,60,69,138,451
191,Allan Houston,SG,33,NYK,20,11,532,85,205,31,80,54,125,36,43,4,19,23,42,8,2,21,40,237
192,Dwight Howard,PF,19,ORL,82,82,2670,352,677,0,2,352,675,277,413,287,536,823,75,77,136,165,232,981
193,Josh Howard,SF,24,DAL,76,76,2446,377,793,34,115,343,678,170,232,169,315,484,109,116,49,122,211,958
194,Juwan Howard,PF,31,HOU,61,47,1624,244,541,0,1,244,540,97,115,126,220,346,94,32,5,79,143,585
195,Troy Hudson,PG,28,MIN,79,32,1729,266,664,89,258,177,406,70,90,19,86,105,283,27,6,113,121,691
196,Larry Hughes,SG,26,WAS,61,61,2358,467,1086,59,209,408,877,352,453,74,308,382,285,176,18,153,168,1345
197,Ryan Humphrey,SF,25,MEM,35,0,317,42,103,0,2,42,101,18,37,50,37,87,6,10,1,23,35,102
198,Kris Humphries,PF,19,UTA,67,4,873,116,287,2,6,114,281,44,101,73,124,197,43,25,18,52,96,278
199,Brandon Hunter,PF,24,ORL,31,0,224,37,73,0,0,37,73,21,39,25,44,69,3,4,7,22,42,95
200,Lindsey Hunter,SG,34,DET,76,3,1144,108,302,23,84,85,218,46,58,38,85,123,130,68,13,68,125,285
201,Steven Hunter,C,23,PHO,76,3,1046,135,220,0,1,135,219,78,163,98,129,227,13,4,102,44,131,348
202,Andre Iguodala,SG,21,PHI,82,82,2686,269,546,47,142,222,404,156,210,89,375,464,246,138,48,139,204,741
203,Zydrunas Ilgauskas,C,29,CLE,78,78,2615,458,979,2,7,456,972,402,503,299,373,672,100,53,165,191,313,1320
204,Didier Ilunga-Mbenga,C,24,DAL,15,1,58,6,14,0,0,6,14,3,4,3,5,8,0,0,5,5,13,15
205,Allen Iverson*,PG,29,PHI,75,75,3174,771,1818,104,338,667,1480,656,786,51,248,299,596,180,9,344,140,2302
206,Royal Ivey,PG,23,ATL,62,5,809,85,198,3,9,82,189,47,67,19,65,84,103,39,7,58,140,220
207,Bobby Jackson,SG,31,SAC,25,0,536,109,255,33,96,76,159,50,58,23,62,85,59,14,2,28,58,301
208,Jermaine Jackson,SG,28,NYK,21,0,230,17,33,0,2,17,31,8,13,3,20,23,24,7,1,10,26,42
209,Jim Jackson,SF,34,TOT,64,27,1987,248,582,122,295,126,287,54,58,33,236,269,183,35,5,115,153,672
210,Luke Jackson,SF,23,CLE,10,0,43,10,27,4,6,6,21,5,6,2,4,6,3,0,0,2,4,29
211,Marc Jackson,C,30,PHI,81,23,1976,340,731,0,2,340,729,289,349,184,222,406,81,32,18,131,171,969
212,Stephen Jackson,SF,26,IND,51,49,1806,330,819,103,286,227,533,190,229,44,206,250,119,64,14,123,154,953
214,Jerome James,C,29,SEA,80,80,1330,174,342,0,2,174,340,47,65,81,160,241,19,23,111,88,279,395
215,LeBron James,SF,20,CLE,80,80,3388,795,1684,108,308,687,1376,477,636,111,477,588,577,177,52,262,146,2175
216,Mike James,PG,29,TOT,74,5,1859,331,751,100,259,231,492,109,145,35,173,208,263,65,6,106,174,871
217,Antawn Jamison,PF,28,WAS,68,68,2605,519,1189,71,208,448,981,225,296,160,359,519,154,55,16,118,151,1334
218,Marko Jarić,PG,26,LAC,50,41,1656,189,457,56,151,133,306,59,82,20,141,161,303,84,17,98,107,493
219,Al Jefferson,PF,20,BOS,71,1,1051,195,369,0,3,195,366,85,135,119,193,312,24,22,55,66,195,475
220,Richard Jefferson,SF,24,NJN,33,33,1355,238,564,30,89,208,475,227,269,49,191,240,133,33,17,132,109,733
221,Jared Jeffries,SF,23,WAS,77,71,2007,203,434,16,51,187,383,101,173,152,222,374,151,66,35,114,206,523
222,Horace Jenkins,PG,30,DET,15,0,104,15,45,0,9,15,36,12,13,3,6,9,9,5,1,7,6,42
223,Britton Johnsen,SF,25,IND,6,1,87,6,22,0,4,6,18,0,0,5,5,10,4,1,0,3,10,12
224,Anthony Johnson,PG,30,IND,63,36,1747,203,456,41,108,162,348,85,113,32,147,179,302,59,15,96,144,532
225,DerMarr Johnson,SG,24,DEN,71,40,1232,185,371,53,148,132,223,80,101,43,108,151,75,43,18,65,140,503
226,Ervin Johnson,C,37,MIN,46,23,410,28,54,1,1,27,53,16,25,43,70,113,6,7,13,18,86,73
227,Joe Johnson,SF,23,PHO,82,82,3240,544,1179,177,370,367,809,135,180,120,302,422,291,79,24,148,167,1400
228,Linton Johnson,SF,24,SAS,2,0,15,0,2,0,1,0,1,0,0,0,3,3,0,1,0,1,1,0
229,Dahntay Jones,SG,24,MEM,52,7,649,83,190,23,60,60,130,44,64,11,58,69,21,13,11,29,81,233
230,Damon Jones,PG,28,MIA,82,66,2576,331,726,225,521,106,205,68,86,14,217,231,350,44,5,98,121,955
231,Eddie Jones,SF,33,MIA,80,80,2839,351,820,142,382,209,438,174,216,38,367,405,212,86,38,99,251,1018
232,Fred Jones,SG,25,IND,77,14,2268,275,647,87,229,188,418,176,207,34,208,242,196,61,31,114,171,813
233,James Jones,SF,24,IND,75,24,1330,126,318,66,166,60,152,53,62,39,135,174,57,31,28,43,123,371
234,Jumaine Jones,SF,25,LAL,76,23,1830,210,486,102,261,108,225,55,75,107,291,398,65,44,24,49,165,577
235,Mark Jones,SF,29,ORL,10,0,116,9,31,0,4,9,27,5,10,6,7,13,6,5,2,3,16,23
236,Chris Kaman,C,22,LAC,63,50,1632,246,495,0,1,246,494,80,121,135,288,423,73,26,68,115,182,572
237,Jason Kapono,SF,23,CHA,81,14,1491,269,671,80,194,189,477,70,85,32,132,164,61,40,6,46,132,688
238,Mario Kasun,C,24,ORL,45,0,356,47,98,0,1,47,97,24,43,52,76,128,8,8,13,26,86,118
239,Viktor Khryapa,SF,22,POR,32,5,523,54,124,4,11,50,113,23,42,28,80,108,25,20,18,33,80,135
240,Jason Kidd*,PG,31,NJN,66,65,2435,340,855,129,358,211,497,142,192,94,394,488,545,123,9,167,110,951
241,Andrei Kirilenko,PF,23,UTA,41,37,1349,207,420,23,77,184,343,203,259,89,166,255,132,67,136,90,101,640
242,Kerry Kittles,SG,30,LAC,11,0,243,28,73,7,21,21,52,6,10,1,31,32,20,8,3,7,12,69
243,Brandin Knight,PG,23,HOU,1,0,3,0,1,0,0,0,1,0,0,0,0,0,1,0,0,0,0,0
244,Brevin Knight,PG,29,CHA,66,61,1944,248,587,3,20,245,567,167,196,21,149,170,591,131,5,147,192,666
245,Kyle Korver,SF,23,PHI,82,57,2667,317,759,226,558,91,201,82,96,40,339,379,182,103,33,106,265,942
246,Nenad Krstić,PF,21,NJN,75,57,1965,281,570,0,2,281,568,185,255,161,240,401,77,32,63,112,280,747
247,Toni Kukoč,SF,36,MIL,53,6,1099,105,256,42,116,63,140,44,61,31,129,160,160,39,13,64,70,296
248,Ibo Kutluay,SG,30,SEA,5,0,12,0,1,0,0,0,1,0,0,0,1,1,0,0,0,2,1,0
249,Christian Laettner,PF,35,MIA,49,0,739,107,184,1,7,106,177,45,59,36,95,131,41,32,15,29,78,260
250,Raef LaFrentz,PF,28,BOS,80,80,2196,341,688,82,225,259,463,120,148,154,399,553,98,42,99,70,262,884
251,Maciej Lampe,C,19,TOT,37,0,380,49,132,2,4,47,128,15,22,24,65,89,11,5,7,17,51,115
252,Voshon Lenard,SG,31,DEN,3,1,54,10,26,4,12,6,14,5,8,0,6,6,6,1,0,2,2,29
253,Rashard Lewis,SF,25,SEA,71,71,2697,532,1151,173,432,359,719,220,283,110,278,388,94,75,62,123,158,1457
254,Randy Livingston,PG,29,UTA,17,4,227,22,52,5,8,17,44,15,17,3,9,12,45,12,2,14,28,64
255,Shaun Livingston,PG,19,LAC,30,15,814,89,215,0,2,89,213,44,59,22,67,89,151,32,11,75,82,222
256,Raül López,PG,24,UTA,31,15,518,57,135,20,45,37,90,27,33,7,32,39,123,22,3,47,78,161
257,Tyronn Lue,PG,27,TOT,70,49,2007,295,654,55,155,240,499,142,165,14,135,149,322,33,0,105,168,787
258,George Lynch,SF,34,NOH,44,27,933,68,189,11,37,57,152,17,23,55,119,174,88,32,12,57,83,164
259,Mark Madsen,C,29,MIN,41,14,601,34,66,0,0,34,66,20,40,63,65,128,18,7,14,24,103,88
260,Corey Maggette,SG,25,LAC,66,60,2436,425,986,51,168,374,818,563,657,70,324,394,225,70,8,195,191,1464
261,Jamaal Magloire,C,26,NOH,23,22,703,98,227,0,0,98,227,74,123,79,126,205,29,8,23,59,74,270
262,Stephon Marbury,PG,27,NYK,82,82,3281,604,1308,115,325,489,983,458,549,50,198,248,668,122,6,233,186,1781
263,Shawn Marion,PF,26,PHO,81,81,3146,613,1289,114,341,499,948,229,275,235,680,915,154,163,119,125,199,1569
264,Sean Marks,PF,29,SAS,23,0,244,27,80,0,3,27,77,22,28,18,38,56,8,3,11,14,29,76
265,Donyell Marshall,PF,31,TOR,65,2,1645,262,592,151,363,111,229,72,91,95,333,428,81,57,46,42,136,747
266,Darrick Martin,PG,33,LAC,11,0,190,16,50,5,18,11,32,5,8,3,7,10,28,6,0,6,19,42
267,Kenyon Martin,PF,27,DEN,70,67,2272,444,907,0,12,444,895,199,308,146,365,511,170,100,78,149,228,1087
268,Kevin Martin,PG,21,SAC,45,0,455,45,117,5,25,40,92,36,55,29,29,58,22,16,3,24,35,131
269,Desmond Mason,SF,27,MIL,80,71,2893,478,1079,1,8,477,1071,420,524,85,227,312,217,58,27,164,198,1377
270,Tony Massenburg,PF,37,SAS,61,6,699,74,182,0,0,74,182,48,63,54,109,163,14,18,20,40,122,196
271,Walter McCarty,PF,30,TOT,72,0,906,95,235,55,155,40,80,15,29,29,109,138,37,25,15,36,144,260
272,Jelani McCoy,C,27,ATL,10,0,88,7,13,0,0,7,13,1,5,7,14,21,0,3,8,6,24,15
273,Antonio McDyess,PF,30,DET,77,8,1797,307,598,0,1,307,597,126,192,177,305,482,71,46,52,93,204,740
274,Tracy McGrady*,SF,25,HOU,78,78,3182,715,1660,142,435,573,1225,431,557,71,413,484,448,135,52,201,167,2003
275,Jeff McInnis,PG,30,CLE,76,69,2651,377,915,91,264,286,651,130,160,32,125,157,391,56,1,117,177,975
276,Aaron McKie,SG,32,PHI,68,3,1118,61,142,20,62,41,80,10,16,20,152,172,103,48,17,31,116,152
277,Keith McLeod,PG,25,UTA,53,47,1382,143,408,18,72,125,336,112,146,20,93,113,236,63,12,99,138,416
278,Stanislav Medvedenko,PF,25,LAL,43,4,423,71,156,0,1,71,155,23,28,31,48,79,13,9,2,13,64,165
279,Ron Mercer,SF,28,NJN,18,3,390,65,158,0,3,65,155,7,10,9,31,40,20,16,2,14,20,137
280,Chris Mihm,C,25,LAL,75,75,1870,280,552,0,2,280,550,175,258,197,305,502,50,14,108,110,237,735
281,Darius Miles,SF,23,POR,63,22,1699,336,697,8,23,328,674,129,215,71,228,299,129,75,78,157,189,809
282,Darko Miličić,C,19,DET,37,2,254,25,76,0,0,25,76,17,24,3,40,43,7,2,17,16,31,67
283,Andre Miller,PG,28,DEN,82,82,2852,427,895,6,39,421,856,253,302,100,238,338,569,121,8,220,204,1113
284,Anthony Miller,PF,33,ATL,2,0,9,2,3,0,0,2,3,0,0,0,1,1,1,1,0,1,2,4
285,Brad Miller,C,28,SAC,56,56,2089,319,609,5,19,314,590,233,287,139,382,521,220,69,68,82,181,876
286,Mike Miller,SF,24,MEM,76,51,2278,387,766,140,323,247,443,108,150,36,264,300,220,54,23,127,197,1022
287,Reggie Miller*,SG,39,IND,66,66,2105,314,719,96,298,218,421,250,268,18,138,156,146,50,5,77,109,974
288,Yao Ming*,C,24,HOU,80,80,2447,538,975,0,0,538,975,389,497,208,461,669,61,34,160,196,298,1465
289,Cuttino Mobley,SG,29,TOT,66,64,2388,408,932,150,342,258,590,168,205,45,184,229,188,74,30,133,152,1134
290,Nazr Mohammed,C,27,TOT,77,59,1933,289,602,0,1,289,601,153,227,247,339,586,34,58,86,108,236,731
292,Mikki Moore,PF,29,LAC,74,4,1178,144,287,1,5,143,282,107,136,97,149,246,47,19,32,63,173,396
294,Troy Murphy,PF,24,GSW,70,69,2375,392,947,59,148,333,799,233,319,251,505,756,97,53,33,108,190,1076
295,Lamond Murray,SF,31,TOR,62,1,918,132,310,46,105,86,205,61,80,44,120,164,47,32,16,54,85,371
296,Ronald Murray,SG,25,SEA,49,6,883,131,363,24,95,107,268,59,80,15,83,98,65,30,11,57,59,345
297,Dikembe Mutombo*,C,38,HOU,80,2,1212,108,217,0,0,108,217,106,143,150,276,426,10,16,101,51,135,322
298,Mamadou N'Diaye,C,29,LAC,11,0,72,8,20,0,1,8,19,4,7,9,9,18,1,1,5,0,20,20
300,Lee Nailon,SF,29,NOH,68,51,2017,415,869,0,2,415,867,133,165,128,170,298,109,36,16,110,190,963
301,Eduardo Nájera,PF,28,TOT,68,4,1185,145,322,6,21,139,301,58,91,102,141,243,65,41,24,61,148,354
302,Steve Nash*,PG,30,PHO,75,75,2573,430,857,94,218,336,639,211,238,57,192,249,861,74,6,245,136,1165
303,Jameer Nelson,PG,22,ORL,79,21,1612,286,628,44,141,242,487,73,107,52,141,193,237,78,3,117,199,689
304,Rasho Nesterović,C,28,SAS,70,70,1785,198,430,0,0,198,430,14,30,184,275,459,71,31,117,73,207,410
305,Ira Newble,SG,30,CLE,74,69,1832,182,424,19,53,163,371,55,69,78,142,220,91,50,18,61,144,438
306,Andrés Nocioni,SF,25,CHI,81,38,1892,241,601,25,97,216,504,170,222,69,317,386,122,37,34,135,208,677
307,Moochie Norris,PG,31,TOT,38,0,360,35,109,0,12,35,97,20,24,10,36,46,39,18,2,27,44,90
308,Dirk Nowitzki,PF,26,DAL,78,78,3020,663,1445,91,228,572,1217,615,708,96,661,757,240,97,119,176,219,2032
309,Jermaine O'Neal,PF,26,IND,44,41,1530,386,854,1,6,385,848,295,391,85,303,388,82,25,88,131,173,1068
310,Shaquille O'Neal*,C,32,MIA,73,73,2492,658,1095,0,0,658,1095,353,765,253,507,760,200,36,171,203,262,1669
311,Lamar Odom,PF,25,LAL,64,64,2320,366,774,36,117,330,657,207,298,134,519,653,238,42,65,161,211,975
312,Emeka Okafor,PF,22,CHA,73,73,2600,448,1003,0,1,448,1002,209,343,275,520,795,64,62,125,125,214,1105
313,Mehmet Okur,C,25,UTA,82,25,2304,354,756,17,63,337,693,329,387,194,422,616,166,32,68,141,227,1054
314,Kevin Ollie,PG,32,PHI,26,0,158,11,31,0,0,11,31,6,9,3,16,19,19,5,0,6,16,28
315,Michael Olowokandi,C,29,MIN,62,34,1215,161,353,0,0,161,353,46,69,106,218,324,29,15,56,68,193,368
316,Greg Ostertag,C,31,SAC,56,3,556,37,84,0,2,37,82,13,38,55,112,167,37,7,40,24,88,87
317,Bo Outlaw,PF,33,PHO,39,0,214,12,34,0,0,12,34,5,9,16,37,53,13,6,12,8,29,29
318,Travis Outlaw,SF,20,POR,59,2,793,133,267,4,10,129,257,49,75,40,81,121,35,30,40,39,77,319
319,Zaza Pachulia,C,20,MIL,74,4,1397,160,354,0,1,160,353,138,185,131,247,378,60,44,34,70,166,458
320,Scott Padgett,PF,28,HOU,66,0,942,98,233,50,126,48,107,29,40,47,138,185,55,33,10,30,119,275
321,Milt Palacio,PG,26,TOR,80,4,1533,175,392,2,12,173,380,115,155,26,108,134,279,48,13,104,126,467
322,Jannero Pargo,PG,25,CHI,32,0,453,82,213,23,66,59,147,17,23,12,35,47,76,16,1,45,53,204
323,Smush Parker,PG,23,TOT,16,1,144,18,43,3,13,15,30,9,13,4,8,12,15,5,0,19,16,48
324,Tony Parker,PG,22,SAS,80,80,2735,539,1118,43,156,496,962,210,323,47,251,298,491,98,4,215,167,1331
325,Ruben Patterson,SF,29,POR,70,36,1957,319,601,2,25,317,576,169,282,126,147,273,138,106,21,143,164,809
326,Sasha Pavlović,SG,21,CLE,65,9,862,120,276,30,78,90,198,44,64,15,56,71,49,29,4,47,121,314
327,Gary Payton*,PG,36,BOS,77,77,2541,339,725,42,129,297,596,153,201,48,188,236,469,88,12,148,121,873
328,Anthony Peeler,SG,35,WAS,40,0,529,56,150,25,65,31,85,16,18,14,51,65,57,18,2,28,39,153
329,Kirk Penney,SG,24,LAC,4,0,12,1,3,0,1,1,2,0,0,0,1,1,1,0,0,2,0,2
330,Kendrick Perkins,C,20,BOS,60,3,548,56,119,0,0,56,119,37,58,53,123,176,21,9,37,43,98,149
331,Wesley Person,SF,33,TOT,41,3,667,107,226,41,89,66,137,9,13,3,80,83,39,19,4,17,30,264
332,Morris Peterson,SG,27,TOR,82,61,2510,356,848,129,335,227,513,188,226,71,269,340,169,91,18,93,219,1029
333,Eric Piatkowski,SG,34,CHI,68,11,841,111,258,57,134,54,124,45,56,15,64,79,51,29,1,37,67,324
334,Paul Pierce,SF,27,BOS,82,82,2960,556,1223,108,292,448,931,549,668,78,461,539,348,133,39,230,255,1769
335,Mickaël Piétrus,SF,22,GSW,67,3,1340,214,501,67,195,147,306,141,202,65,124,189,82,46,18,92,139,636
336,Zoran Planinić,PG,22,NJN,43,8,515,78,174,15,40,63,134,46,66,19,50,69,44,25,0,41,76,217
337,Pavel Podkolzin,C,20,DAL,5,0,10,0,0,0,0,0,0,1,2,0,2,2,0,0,0,2,4,1
338,Scot Pollard,C,29,IND,49,17,865,79,167,0,0,79,167,33,49,85,120,205,18,30,24,31,123,191
339,Mark Pope,PF,32,DEN,9,0,27,2,6,0,0,2,6,0,0,5,3,8,1,1,2,1,5,4
340,James Posey,SF,28,MEM,50,18,1382,127,356,55,178,72,178,96,111,45,174,219,88,48,23,69,134,405
341,Vitaly Potapenko,C,29,SEA,33,1,335,45,87,0,1,45,86,27,31,30,48,78,9,7,3,12,53,117
342,Tayshaun Prince,SF,24,DET,82,82,3039,469,963,47,138,422,825,221,274,133,302,435,247,56,71,135,161,1206
343,Laron Profit,SF,27,WAS,42,4,428,56,128,8,28,48,100,16,25,24,52,76,37,16,5,27,44,136
344,Joel Przybilla,C,25,POR,76,50,1858,199,333,0,0,199,333,90,174,178,410,588,74,24,163,98,239,488
345,Vladimir Radmanović,PF,24,SEA,63,0,1856,266,650,128,329,138,321,81,103,52,237,289,86,57,31,80,172,741
346,Aleksandar Radojević,C,28,UTA,12,6,128,6,19,0,0,6,19,7,10,9,19,28,6,0,2,15,32,19
347,Peter John Ramos,C,19,WAS,6,0,20,5,10,0,0,5,10,1,2,1,3,4,0,0,1,3,4,11
348,Zach Randolph,PF,23,POR,46,37,1603,332,741,0,6,332,735,207,254,142,300,442,86,34,17,112,112,871
349,Theo Ratliff,C,31,POR,63,45,1731,115,257,0,0,115,257,74,107,111,220,331,34,23,158,56,183,304
350,Željko Rebrača,C,32,LAC,58,2,928,133,234,0,0,133,234,73,85,49,135,184,26,13,40,49,130,339
351,Michael Redd,SG,25,MIL,75,75,2848,625,1418,104,293,521,1125,369,432,72,240,312,172,63,8,133,152,1723
352,Justin Reed,SF,23,BOS,23,0,121,15,29,0,3,15,26,11,15,8,8,16,10,3,1,5,12,41
353,Jared Reiner,C,22,CHI,19,2,132,10,30,0,0,10,30,1,4,13,25,38,1,3,7,9,35,21
354,Jason Richardson,SG,24,GSW,72,72,2724,610,1368,125,370,485,998,214,309,125,299,424,281,105,32,169,156,1559
355,Quentin Richardson,SG,24,PHO,79,78,2839,407,1045,226,631,181,414,136,184,91,388,479,158,96,27,102,197,1176
356,Luke Ridnour,PG,23,SEA,82,82,2571,299,739,67,178,232,561,159,180,55,149,204,483,94,23,149,185,824
357,Bernard Robinson,SG,24,CHA,31,1,328,36,81,3,8,33,73,18,26,14,34,48,30,11,4,20,42,93
359,Glenn Robinson,SF,32,SAS,9,0,157,34,77,2,6,32,71,20,23,4,20,24,8,4,3,7,19,90
361,Jalen Rose,SF,32,TOR,81,65,2710,527,1159,108,274,419,885,333,390,44,232,276,209,63,10,180,190,1495
362,Malik Rose,PF,30,TOT,76,5,1475,198,441,1,10,197,431,137,186,129,212,341,59,46,16,102,208,534
363,Quinton Ross,SG,23,LAC,78,19,1659,161,373,1,4,160,369,74,110,59,151,210,109,51,22,54,165,397
364,Michael Ruffin,C,28,WAS,79,7,1262,41,99,0,1,41,98,29,67,157,175,332,64,43,41,44,193,111
365,Kareem Rush,SG,24,TOT,48,22,968,157,406,51,137,106,269,37,48,20,69,89,68,20,7,47,74,402
366,Bryon Russell,SF,34,DEN,70,2,1026,95,252,56,149,39,103,61,77,50,122,172,72,44,11,35,130,307
367,John Salmons,SG,25,PHI,58,8,993,85,210,31,91,54,119,35,48,12,109,121,114,40,13,51,92,236
368,Jamal Sampson,PF,21,CHA,23,0,329,28,62,0,0,28,62,23,39,36,86,122,8,4,17,17,53,79
369,Daniel Santiago,C,28,MIL,11,0,105,7,21,0,0,7,21,8,11,6,13,19,1,3,4,4,28,22
370,Brian Scalabrine,PF,26,NJN,54,14,1167,132,332,22,68,110,264,53,69,83,161,244,88,34,18,66,111,339
371,Ansu Sesay,SF,28,GSW,16,0,128,17,42,2,8,15,34,13,24,18,20,38,12,2,3,8,16,49
372,Ha Seung-Jin,C,19,POR,19,0,104,10,23,0,0,10,23,6,11,6,12,18,2,1,5,12,21,26
373,Paul Shirley,PF,27,PHO,9,0,30,5,11,0,0,5,11,2,4,1,1,2,3,0,0,1,3,12
374,Bobby Simmons,SF,24,LAC,75,74,2799,474,1017,50,115,424,902,231,273,128,318,446,205,106,16,135,227,1229
376,Tamar Slay,SG,24,CHA,8,0,78,13,39,2,12,11,27,0,2,6,8,14,3,5,0,8,20,28
377,Donta Smith,SG,21,ATL,38,0,433,44,113,6,22,38,91,33,48,19,33,52,39,23,5,25,50,127
378,J.R. Smith,SG,19,NOH,76,56,1859,295,748,81,281,214,467,111,161,39,113,152,142,55,11,109,135,782
379,Jabari Smith,PF,27,NJN,45,2,648,62,148,1,2,61,146,41,55,29,82,111,38,25,14,39,103,166
380,Joe Smith,PF,29,MIL,74,73,2265,319,621,0,1,319,620,175,228,179,362,541,67,43,38,79,222,813
381,Josh Smith,SF,19,ATL,74,59,2050,274,602,4,23,270,579,163,237,147,310,457,127,59,144,135,157,715
382,Steve Smith,SG,35,TOT,50,1,750,102,248,41,105,61,143,69,80,15,50,65,71,14,7,27,82,314
383,Theron Smith,SF,24,CHA,33,5,510,44,136,3,12,41,124,14,16,39,77,116,28,6,4,27,58,105
384,Eric Snow,SG,31,CLE,81,15,1844,125,327,13,45,112,282,59,80,37,118,155,317,67,16,89,189,322
385,Kirk Snyder,SG,21,UTA,68,7,906,122,328,30,85,92,243,64,96,50,71,121,36,26,19,58,116,338
386,Darius Songaila,PF,26,SAC,81,21,1668,257,488,0,3,257,485,94,111,125,219,344,114,51,18,70,206,608
387,Pape Sow,C,23,TOR,27,4,255,23,58,0,0,23,58,16,27,18,39,57,2,12,4,10,46,62
388,Latrell Sprewell,SF,34,MIN,80,79,2450,398,961,69,211,329,750,156,188,65,189,254,179,53,21,127,124,1021
389,Jerry Stackhouse,SG,30,DAL,56,7,1617,274,662,32,120,242,542,253,298,38,145,183,127,53,10,106,104,833
390,DeShawn Stevenson,SG,23,ORL,55,27,1089,174,426,25,67,149,359,56,101,38,64,102,69,16,9,57,73,429
391,Michael Stewart,PF,29,ATL,12,1,145,11,21,0,0,11,21,3,7,21,19,40,5,6,5,6,32,25
392,Peja Stojaković,SF,27,SAC,66,66,2534,451,1016,174,433,277,583,253,275,62,223,285,138,79,12,102,157,1329
393,Awvee Storey,SG,27,NJN,9,0,32,3,10,1,2,2,8,1,2,4,1,5,1,0,0,0,3,8
394,Damon Stoudamire,PG,31,POR,81,70,2762,457,1165,181,490,276,675,182,199,56,254,310,458,86,2,164,158,1277
395,Amar'e Stoudemire,C,22,PHO,80,80,2889,747,1336,3,16,744,1320,583,795,219,494,713,131,77,130,189,278,2080
396,Erick Strickland,SG,31,MIL,62,5,1014,114,304,21,83,93,221,52,64,11,92,103,115,30,1,64,103,301
397,Rod Strickland,PG,38,HOU,16,2,196,9,43,1,2,8,41,9,10,3,24,27,39,3,2,16,15,28
398,Bruno Šundov,C,24,NYK,21,0,73,11,37,1,3,10,34,2,2,6,7,13,2,2,2,6,16,25
399,Bob Sura,PG,31,HOU,61,59,1922,215,504,55,155,160,349,141,188,79,258,337,317,65,7,147,168,626
400,Mike Sweetney,C,22,NYK,77,28,1509,237,446,0,1,237,445,176,235,169,249,418,44,27,28,108,224,650
401,Robert Swift,C,19,SEA,16,0,72,5,11,0,0,5,11,5,9,1,4,5,2,1,7,4,16,15
402,Stromile Swift,PF,25,MEM,60,14,1279,219,488,0,4,219,484,166,219,92,181,273,43,41,92,90,182,604
403,Wally Szczerbiak,SF,27,MIN,81,37,2558,465,919,63,169,402,750,260,304,82,221,303,191,40,16,132,178,1253
404,Yuta Tabuse,PG,24,PHO,4,0,17,1,6,1,1,0,5,4,4,2,2,4,3,0,0,1,1,7
406,Sebastian Telfair,PG,19,POR,68,26,1330,169,430,17,69,152,361,105,133,10,94,104,224,35,4,125,120,460
407,Jason Terry,PG,27,DAL,80,57,2401,372,743,103,245,269,498,146,173,38,150,188,429,109,15,147,177,993
408,Billy Thomas,SF,29,NJN,25,0,356,34,94,17,56,17,38,7,9,7,29,36,17,14,1,9,29,92
409,Etan Thomas,C,26,WAS,47,10,976,128,255,0,0,128,255,76,144,85,159,244,20,17,51,50,133,332
410,James Thomas,PF,24,TOT,11,2,117,12,20,0,0,12,20,2,6,17,20,37,4,4,4,7,13,26
411,John Thomas,C,29,MIN,44,8,521,42,86,0,0,42,86,27,46,39,58,97,17,15,13,18,82,111
412,Kenny Thomas,PF,27,TOT,73,58,2167,367,781,1,5,366,776,173,227,184,351,535,152,67,17,131,227,908
413,Kurt Thomas,PF,32,NYK,80,80,2855,424,901,2,4,422,897,66,84,170,661,831,160,70,79,99,310,916
414,Tim Thomas,SF,27,NYK,71,68,1940,315,718,85,208,230,510,136,173,45,192,237,110,41,17,113,222,851
415,Jamaal Tinsley,PG,26,IND,40,40,1301,218,522,58,156,160,366,122,164,26,134,160,257,81,12,134,112,616
416,Robert Traylor,C,27,CLE,74,6,1327,177,399,0,8,177,391,55,102,136,196,332,61,54,50,73,215,409
417,Jake Tsakalidis,C,25,MEM,31,1,278,32,64,0,0,32,64,14,18,21,35,56,10,3,16,12,42,78
418,Nikoloz Tskitishvili,PF,21,TOT,35,0,220,22,74,2,17,20,57,4,7,12,29,41,10,8,11,19,33,50
419,Hedo Türkoğlu,SF,25,ORL,67,11,1757,328,782,93,245,235,537,188,225,62,171,233,153,41,18,119,140,937
420,Beno Udrih,PG,22,SAS,80,2,1149,173,390,58,142,115,248,67,89,16,67,83,150,41,10,77,96,471
421,Nick Van Exel,SG,33,POR,53,34,1619,214,561,100,257,114,304,58,74,20,141,161,227,44,0,92,70,586
423,Anderson Varejão,PF,22,CLE,54,0,863,99,193,0,2,99,191,68,127,109,148,257,27,41,38,26,122,266
424,Jacque Vaughn,SG,29,NJN,71,34,1410,146,325,5,15,141,310,76,91,17,90,107,135,41,1,62,138,373
425,Jake Voskuhl,C,27,PHO,38,1,360,27,59,0,0,27,59,26,38,30,62,92,17,4,11,20,60,80
427,Sasha Vujačić,SG,20,LAL,35,3,403,33,117,17,63,16,54,18,19,13,49,62,51,12,2,15,41,101
428,Dwyane Wade,SG,23,MIA,77,77,2974,630,1318,13,45,617,1273,581,762,110,287,397,520,121,82,321,230,1854
429,Dajuan Wagner,SG,21,CLE,11,0,102,18,55,5,26,13,29,3,4,0,2,2,13,5,0,9,15,44
430,Antoine Walker,PF,28,TOT,77,77,2955,581,1377,110,341,471,1036,201,373,182,513,695,265,89,58,253,217,1473
431,Samaki Walker,PF,28,WAS,14,0,134,11,31,0,0,11,31,2,3,8,10,18,4,3,7,8,25,24
432,Ben Wallace,C,30,DET,74,74,2671,295,651,1,9,294,642,130,304,292,610,902,123,106,176,82,159,721
433,Gerald Wallace,SF,22,CHA,70,68,2147,286,637,17,62,269,575,191,289,118,268,386,137,117,91,159,182,780
434,Rasheed Wallace,PF,30,DET,79,79,2687,467,1062,75,236,392,826,136,195,174,470,644,142,65,115,127,236,1145
435,Luke Walton,SF,24,LAL,61,5,768,74,180,16,61,58,119,34,48,55,87,142,93,26,11,58,70,198
436,Charlie Ward,PG,34,HOU,14,13,360,24,77,16,51,8,26,11,13,6,33,39,43,15,0,18,22,75
437,Earl Watson,PG,25,MEM,80,14,1808,236,554,52,163,184,391,91,138,35,129,164,359,83,19,167,184,615
438,Clarence Weatherspoon,PF,34,HOU,40,18,525,47,114,0,0,47,114,29,35,35,87,122,17,9,6,15,74,123
439,Chris Webber,PF,31,TOT,67,67,2370,555,1283,15,44,540,1239,181,228,130,482,612,318,94,53,182,214,1306
440,Bonzi Wells,SG,28,MEM,69,19,1489,272,617,36,104,236,513,141,188,49,180,229,80,85,27,90,165,721
442,David Wesley,SG,34,TOT,80,79,2774,334,840,118,315,216,525,162,189,38,190,228,265,96,9,113,215,948
443,David West,SF,24,NOH,30,8,552,75,172,2,5,73,167,34,50,40,89,129,23,12,16,37,62,186
444,Delonte West,SG,21,BOS,39,7,507,66,155,24,67,42,88,19,27,14,51,65,53,21,8,24,69,175
445,Jahidi White,C,28,CHA,17,0,135,14,31,0,0,14,31,14,40,11,23,34,1,2,12,11,31,42
446,Rodney White,SF,24,TOT,58,2,677,121,289,24,60,97,229,27,44,24,65,89,44,32,11,37,64,293
447,Chris Wilcox,C,22,LAC,54,25,1005,169,329,0,0,169,329,88,144,63,165,228,38,26,24,77,129,426
448,Damien Wilkins,SF,25,SEA,29,7,520,73,168,16,59,57,109,21,34,29,37,66,26,22,10,16,55,183
449,Mike Wilks,PG,25,SAS,48,0,278,32,77,5,16,27,61,12,16,4,21,25,33,14,1,14,26,81
450,Aaron Williams,C,33,TOT,42,4,315,29,63,0,0,29,63,15,17,17,43,60,8,5,8,17,70,73
451,Eric Williams,SG,32,TOT,55,39,1322,142,330,28,73,114,257,112,161,44,128,172,92,38,4,60,147,424
452,Frank Williams,SG,24,CHI,9,0,71,3,20,0,4,3,16,0,0,2,4,6,11,2,3,3,9,6
453,Jason Williams,PG,29,MEM,71,68,1952,266,644,107,330,159,314,80,101,19,103,122,399,75,5,130,91,719
454,Jerome Williams,SF,31,NYK,79,4,1211,122,243,0,5,122,238,115,172,115,168,283,41,55,10,65,155,359
455,Mo Williams,PG,22,MIL,80,80,2254,323,737,32,99,291,638,136,160,50,194,244,484,74,11,196,221,814
456,Scott Williams,C,36,CLE,19,0,152,12,41,0,1,12,40,9,11,15,15,30,8,4,6,5,30,33
457,Corliss Williamson,PF,31,TOT,72,9,1527,273,584,0,2,273,582,195,244,104,155,259,78,38,15,86,218,741
458,Kevin Willis,C,42,ATL,29,5,344,35,90,0,2,35,88,17,23,29,47,76,9,8,7,15,53,87
459,Loren Woods,C,26,TOR,45,30,712,71,164,0,1,71,163,34,59,81,139,220,17,8,39,37,78,176
460,Qyntel Woods,SF,23,MIA,3,0,40,5,12,0,0,5,12,0,0,2,4,6,0,4,0,2,6,10
461,Metta World Peace,SF,25,IND,7,7,291,59,119,7,17,52,102,47,51,8,37,45,22,12,6,17,27,172
462,Dorell Wright,SF,19,MIA,3,0,27,3,11,0,4,3,7,1,1,0,1,1,3,4,0,3,2,7
463,Lorenzen Wright,C,29,MEM,80,77,2287,320,683,0,3,320,680,131,198,177,436,613,87,58,69,100,251,771
464,Wang Zhizhi,C,27,MIA,20,0,92,17,36,2,3,15,33,7,12,6,12,18,5,3,2,5,9,43
