Rk,Player,Pos,Age,Tm,G,GS,MP,FG,FGA,3P,3PA,2P,2PA,FT,FTA,ORB,DRB,TRB,AST,STL,BLK,TOV,PF,PTS
1,Shareef Abdur-Rahim,PF,29,SAC,72,30,1961,332,632,5,22,327,610,218,278,106,251,357,149,48,42,108,227,887
2,Alex Acker,SG,23,DET,5,0,35,4,16,1,5,3,11,0,0,1,4,5,4,1,0,4,4,9
3,Malik Allen,PF,27,CHI,54,20,701,121,247,1,1,120,246,23,38,44,96,140,20,14,16,34,92,266
4,Ray Allen*,SG,30,SEA,78,78,3022,681,1500,269,653,412,847,324,359,71,261,332,286,105,16,188,151,1955
5,Tony Allen,PG,24,BOS,51,9,978,129,274,11,34,118,240,100,134,32,79,111,67,51,18,67,126,369
6,Rafer Alston,PG,29,HOU,63,63,2431,280,738,102,312,178,426,99,143,36,219,255,425,101,15,157,194,761
7,Chris Andersen,C,27,NOK,32,2,570,56,98,0,0,56,98,49,103,61,94,155,6,8,41,26,84,161
8,Alan Anderson,SF,23,CHA,36,7,564,75,181,24,58,51,123,33,41,23,47,70,32,11,4,32,48,207
9,Derek Anderson,SG,31,TOT,43,11,1047,108,303,40,134,68,169,93,111,21,122,143,101,23,6,54,98,349
10,Shandon Anderson,SF,32,MIA,48,1,638,54,126,5,19,49,107,13,18,18,63,81,30,17,6,24,75,126
11,Martynas Andriuškevičius,C,19,CLE,6,0,9,0,1,0,0,0,1,0,0,1,3,4,0,2,0,0,1,0
12,Carmelo Anthony,SF,21,DEN,80,80,2941,756,1572,37,152,719,1420,573,709,122,272,394,216,88,42,218,229,2122
13,Rafael Araújo,C,25,TOR,52,34,601,53,145,0,1,53,144,15,28,43,101,144,15,24,6,42,104,121
14,Gilbert Arenas,PG,24,WAS,80,80,3384,746,1668,199,540,547,1128,655,799,59,221,280,484,161,25,297,286,2346
15,Trevor Ariza,SF,20,TOT,57,10,999,93,226,1,5,92,221,77,127,78,140,218,61,57,11,62,100,264
16,Darrell Armstrong,PG,37,DAL,62,2,622,43,128,11,48,32,80,33,42,18,63,81,86,27,3,58,71,130
19,Stacey Augmon,SF,37,ORL,36,3,385,25,73,0,0,25,73,21,30,18,35,53,23,12,6,11,40,71
20,Vin Baker,C,34,LAC,8,1,85,7,15,0,0,7,15,13,18,2,17,19,4,4,4,9,13,27
21,Marcus Banks,PG,24,TOT,58,29,1497,219,468,22,63,197,405,118,147,23,112,135,220,54,11,119,162,578
22,Leandro Barbosa,SG,23,PHO,57,11,1592,273,567,87,196,186,371,111,147,31,119,150,158,48,6,89,145,744
24,Andre Barrett,PG,23,TOT,19,0,282,38,104,2,14,36,90,9,12,9,16,25,52,10,0,15,13,87
25,Earl Barron,C,24,MIA,8,0,45,5,16,0,0,5,16,3,4,2,8,10,0,0,0,5,10,13
26,Brent Barry,SG,34,SAS,74,5,1259,156,345,80,202,76,143,39,59,29,130,159,123,39,27,52,99,431
27,Jon Barry,SG,36,HOU,20,0,342,25,65,12,32,13,33,24,29,1,30,31,26,13,1,22,25,86
28,Eddie Basden,SF,22,CHI,19,0,141,15,37,1,7,14,30,8,10,7,21,28,8,9,2,9,17,39
29,Brandon Bass,PF,20,NOK,29,1,268,28,70,0,0,28,70,12,19,18,50,68,3,3,7,11,18,68
30,Esteban Batista,PF,22,ATL,57,3,495,34,80,0,1,34,79,33,53,61,83,144,7,15,11,38,111,101
31,Tony Battie,C,29,ORL,82,82,2215,280,552,0,6,280,546,89,134,145,312,457,49,46,69,88,250,649
32,Shane Battier,SF,27,MEM,81,81,2839,303,621,65,165,238,456,147,208,164,265,429,136,92,114,90,223,818
34,Charlie Bell,SG,26,MIL,59,6,1283,180,410,71,168,109,242,63,89,21,99,120,130,59,5,41,126,494
35,Raja Bell,SG,29,PHO,79,79,2959,425,930,197,446,228,484,115,146,44,209,253,207,76,22,89,248,1162
36,Jonathan Bender,SF,25,IND,2,0,21,4,5,0,0,4,5,2,2,0,4,4,2,0,1,0,2,10
37,Mike Bibby,PG,27,SAC,82,82,3167,597,1382,192,497,405,885,342,403,29,211,240,444,82,10,199,169,1728
38,Andris Biedriņš,C,19,GSW,68,2,1000,118,185,0,0,118,185,22,72,124,159,283,24,23,47,34,190,258
39,Chauncey Billups,PG,29,DET,81,81,2925,423,1012,184,425,239,587,465,520,41,211,252,699,71,8,170,160,1495
40,Steve Blake,PG,25,POR,68,57,1781,206,470,76,184,130,286,72,91,26,120,146,306,42,5,83,107,560
41,Andray Blatche,PF,19,WAS,29,0,175,26,67,3,13,23,54,10,12,12,26,38,10,5,7,12,36,65
42,Mark Blount,C,30,TOT,81,55,2240,373,734,0,0,373,734,168,222,96,269,365,99,40,76,194,254,914
44,Andrew Bogut,PF,21,MIL,82,77,2348,323,606,0,3,323,603,122,194,189,384,573,192,49,68,125,259,768
45,Matt Bonner,PF,25,TOR,78,6,1710,209,467,102,243,107,224,63,76,86,198,284,56,49,31,32,216,583
46,Calvin Booth,C,29,WAS,33,2,250,20,47,1,2,19,45,5,9,19,33,52,12,9,9,8,44,46
47,Carlos Boozer,PF,24,UTA,33,19,1025,219,399,0,0,219,399,99,137,73,212,285,88,30,8,69,105,537
48,Chris Bosh,C,21,TOR,70,70,2751,549,1087,0,13,549,1074,474,581,204,443,647,181,50,79,157,209,1572
49,Bruce Bowen,SF,34,SAS,82,82,2755,232,536,104,245,128,291,51,84,35,285,320,126,79,30,67,191,619
50,Ryan Bowen,SF,30,HOU,68,19,652,37,124,3,22,34,102,11,14,31,57,88,24,21,6,13,85,88
51,Earl Boykins,PG,29,DEN,60,0,1542,271,661,62,179,209,482,152,174,21,60,81,230,48,4,83,73,756
52,Michael Bradley,PF,26,PHI,46,1,367,32,79,1,5,31,74,2,3,40,67,107,17,5,7,19,39,67
53,Elton Brand,PF,26,LAC,79,79,3099,756,1435,1,3,755,1432,440,568,236,554,790,208,81,201,173,227,1953
54,Primož Brezec,C,26,CHA,79,79,2165,409,791,0,2,409,789,164,224,181,259,440,45,19,32,85,227,982
55,Devin Brown,SG,27,UTA,81,14,1711,207,527,39,118,168,409,158,212,73,134,207,104,44,14,99,153,611
56,Kwame Brown,C,23,LAL,72,49,1978,204,388,0,1,204,387,128,235,182,291,473,72,27,46,100,196,536
57,P.J. Brown,C,36,NOK,75,73,2380,269,583,0,0,269,583,139,168,182,365,547,90,46,50,90,216,677
58,Rick Brunson,PG,33,TOT,27,0,246,21,54,5,13,16,41,7,12,1,21,22,35,8,1,22,22,54
59,Kobe Bryant,SG,27,LAL,80,80,3277,978,2173,180,518,798,1655,696,819,71,354,425,360,147,30,250,233,2832
60,Greg Buckner,SG,29,DEN,73,27,1758,181,417,86,243,95,174,43,55,31,178,209,127,87,20,52,180,491
61,Pat Burke,C,32,PHO,42,0,346,63,127,2,7,61,120,13,21,21,52,73,16,6,13,33,62,141
62,Antonio Burks,PG,25,MEM,57,1,570,51,144,1,6,50,138,10,23,4,33,37,76,20,0,36,45,113
63,Kevin Burleson,PG,26,CHA,39,1,340,22,88,10,54,12,34,16,17,4,22,26,48,26,2,25,63,70
64,Caron Butler,SF,25,WAS,75,54,2708,494,1086,41,120,453,966,289,332,114,352,466,186,127,18,175,238,1318
65,Jackie Butler,C,20,NYK,55,0,740,117,215,0,0,117,215,58,77,67,116,183,25,17,31,62,127,292
66,Rasual Butler,SF,26,NOK,79,20,1875,257,633,92,242,165,391,79,114,51,181,232,40,33,45,65,142,685
67,Andrew Bynum,C,18,LAL,46,0,338,33,82,0,0,33,82,8,27,34,46,80,9,4,22,17,56,74
68,Will Bynum,PG,23,GSW,15,0,162,21,52,2,9,19,43,10,16,3,9,12,19,7,0,14,10,54
69,Žarko Čabarkapa,PF,24,GSW,61,0,505,67,174,5,20,62,154,60,84,37,74,111,20,13,7,35,87,199
70,José Calderón,SG,24,TOR,64,11,1487,132,312,7,43,125,269,78,92,30,111,141,288,42,4,101,93,349
71,Marcus Camby,C,31,DEN,56,54,1857,302,649,1,11,301,638,111,156,132,536,668,115,79,184,92,158,716
72,Brian Cardinal,PF,28,MEM,36,0,402,46,111,13,29,33,82,19,27,11,44,55,33,23,0,27,65,124
73,Matt Carroll,SG,25,CHA,78,6,1275,192,476,72,185,120,291,138,168,34,123,157,35,47,11,48,120,594
74,Anthony Carter,PG,30,MIN,45,8,589,53,137,4,15,49,122,40,55,9,53,62,101,24,9,40,71,150
75,Vince Carter,SG,29,NJN,79,79,2906,653,1518,125,367,528,1151,480,601,135,327,462,338,94,53,213,235,1911
76,Sam Cassell,PG,36,LAC,78,75,2653,493,1112,70,190,423,922,289,335,40,247,287,491,74,11,175,225,1345
77,Kelvin Cato,C,31,TOT,27,0,333,36,84,0,0,36,84,26,35,20,50,70,4,6,12,18,52,98
78,Tyson Chandler,C,23,CHI,79,50,2121,160,283,0,1,160,282,97,193,265,449,714,81,41,104,123,298,417
79,Calbert Cheaney,SF,34,GSW,42,0,448,42,108,0,8,42,100,8,8,20,41,61,19,13,2,17,38,92
80,Josh Childress,SF,22,ATL,74,10,2249,278,504,32,65,246,439,154,201,134,253,387,131,86,39,101,184,742
81,Doug Christie,SG,35,DAL,7,7,185,9,26,0,1,9,25,8,12,2,11,13,14,9,1,6,10,26
82,Speedy Claxton,PG,27,NOK,71,3,2019,304,736,17,63,287,673,246,320,39,154,193,339,108,6,154,177,871
83,Mateen Cleaves,PG,28,SEA,27,0,230,25,71,4,16,21,55,19,24,2,12,14,42,3,2,14,30,73
84,Jarron Collins,C,27,UTA,79,41,1730,129,280,0,0,129,280,157,219,134,199,333,97,36,27,61,252,415
85,Jason Collins,C,27,NJN,71,70,1895,104,262,3,12,101,250,44,86,93,249,342,70,46,40,61,251,255
86,Nick Collison,PF,25,SEA,66,27,1448,207,394,0,3,207,391,79,113,143,225,368,74,21,35,77,213,493
87,Brian Cook,PF,25,LAL,81,46,1535,261,511,36,84,225,427,84,101,88,186,274,74,37,32,61,205,642
88,Jamal Crawford,SG,25,NYK,79,27,2555,366,879,101,293,265,586,295,357,36,212,248,301,87,15,175,150,1128
89,Austin Croshere,PF,30,IND,50,26,1148,132,285,54,140,78,145,90,102,62,203,265,62,22,7,48,105,408
90,Eddy Curry,C,23,NYK,72,69,1865,336,597,0,0,336,597,307,486,145,287,432,19,28,56,179,239,979
91,Samuel Dalembert,C,24,PHI,66,52,1761,196,369,0,1,196,368,93,132,159,382,541,25,34,160,107,244,485
92,Erick Dampier,C,30,DAL,82,36,1934,171,347,0,0,171,347,127,215,273,367,640,51,27,106,115,263,469
93,Antonio Daniels,SG,30,WAS,80,17,2283,230,550,23,101,207,449,284,336,19,153,172,284,52,8,89,96,767
94,Marquis Daniels,SG,25,DAL,62,29,1766,246,512,4,19,242,493,138,183,81,143,224,172,67,13,100,143,634
96,Baron Davis,PG,26,GSW,54,48,1971,335,861,102,324,233,537,195,289,45,191,236,480,89,14,159,165,967
97,Dale Davis,C,36,DET,28,2,178,9,24,0,1,9,23,8,15,21,32,53,6,0,9,4,23,26
98,Josh Davis,PF,25,TOT,6,0,17,2,7,0,2,2,5,2,3,3,1,4,1,2,0,1,3,6
100,Carlos Delfino,SG,23,DET,68,1,726,91,226,20,60,71,166,45,67,28,85,113,44,21,15,36,86,247
102,Luol Deng,SF,20,CHI,78,56,2604,442,954,21,78,421,876,207,276,127,389,516,147,72,50,105,128,1112
103,Boris Diaw,PF,23,PHO,81,70,2874,449,853,8,30,441,823,174,238,159,399,558,503,58,85,189,260,1080
104,Dan Dickau,PG,27,BOS,19,0,234,17,46,10,20,7,26,18,18,5,11,16,40,11,1,18,40,62
105,Travis Diener,PG,23,ORL,23,0,246,29,69,25,57,4,12,5,6,4,17,21,16,7,0,10,22,88
106,Ike Diogu,PF,22,GSW,69,14,1031,175,334,0,0,175,334,136,168,95,134,229,29,15,30,78,164,486
107,DeSagana Diop,C,24,DAL,81,45,1510,75,154,1,2,74,152,39,72,145,229,374,23,44,146,36,253,190
108,Juan Dixon,SG,27,POR,76,42,1920,357,821,65,170,292,651,156,194,30,147,177,149,58,6,113,157,935
109,Michael Doleac,C,28,MIA,31,3,371,37,88,0,0,37,88,24,30,23,62,85,8,10,7,14,45,98
110,Keyon Dooling,PG,25,ORL,50,7,1137,178,405,13,43,165,362,101,121,11,67,78,109,49,4,82,116,470
111,Chris Duhon,PG,23,CHI,74,38,2155,215,538,100,278,115,260,117,143,28,192,220,373,70,3,117,152,647
112,Tim Duncan,PF,29,SAS,80,80,2784,574,1185,2,5,572,1180,335,533,231,650,881,253,70,162,198,219,1485
113,Mike Dunleavy,SF,25,GSW,81,68,2578,331,816,74,260,257,556,196,252,78,321,399,237,60,32,120,199,932
114,Ronald Dupree,SF,25,MIN,36,0,265,33,63,0,1,33,62,14,41,21,28,49,14,12,0,14,44,80
115,John Edwards,C,24,ATL,40,4,296,31,64,0,0,31,64,8,11,18,30,48,5,3,15,12,76,70
116,Howard Eisley,PG,33,TOT,32,0,394,34,103,13,42,21,61,20,24,3,30,33,69,11,2,21,34,101
117,Monta Ellis,SG,20,GSW,49,3,886,132,318,28,82,104,236,42,59,22,83,105,78,32,11,58,69,334
118,Francisco Elson,C,29,DEN,72,54,1579,151,284,1,5,150,279,49,74,99,240,339,47,54,45,65,211,352
119,Melvin Ely,PF,27,CHA,57,22,1348,216,425,0,2,216,423,128,192,94,183,277,76,29,44,100,160,560
120,Maurice Evans,SG,27,DET,80,1,1139,154,341,43,116,111,225,52,65,76,87,163,60,41,15,39,122,403
121,Reggie Evans,PF,25,TOT,67,25,1393,131,268,0,1,131,267,115,217,171,331,502,38,40,10,85,166,377
122,Daniel Ewing,SG,22,LAC,66,5,971,97,255,22,78,75,177,36,46,23,62,85,84,37,6,57,86,252
123,Noel Felix,SF,24,SEA,12,0,82,6,25,1,3,5,22,5,8,3,10,13,2,2,3,8,13,18
124,Raymond Felton,PG,21,CHA,80,54,2406,345,883,97,271,248,612,161,222,77,188,265,446,102,8,182,181,948
125,Michael Finley,SG,32,SAS,77,18,2038,286,695,110,279,176,416,98,115,31,216,247,116,37,7,62,97,780
126,Derek Fisher,PG,31,GSW,82,36,2589,364,887,117,295,247,592,244,293,36,175,211,352,125,8,156,237,1089
127,Gerald Fitch,PG,23,MIA,18,1,239,30,89,7,26,23,63,17,23,7,23,30,33,7,5,15,28,84
128,Marcus Fizer,PF,27,NOK,3,0,39,9,17,1,1,8,16,1,2,1,6,7,1,0,0,2,5,20
129,Sharrod Ford,PF,24,PHO,3,0,13,2,3,0,0,2,3,0,0,1,2,3,0,0,1,2,7,4
130,T.J. Ford,PG,22,MIL,72,70,2557,328,789,35,104,293,685,187,248,63,248,311,473,104,7,219,196,878
131,Danny Fortson,C,29,SEA,23,1,276,27,51,0,0,27,51,33,43,31,47,78,2,4,2,26,76,87
132,Jeff Foster,C,29,IND,63,37,1581,138,250,0,4,138,246,96,159,224,350,574,50,41,27,64,191,372
133,Adonal Foyle,C,30,GSW,77,72,1824,152,300,0,0,152,300,41,67,143,281,424,33,44,125,80,215,345
134,Richie Frahm,SG,28,TOT,33,0,342,39,100,23,70,16,30,7,10,3,30,33,21,4,2,8,30,108
136,Channing Frye,C,22,NYK,65,14,1572,305,640,3,9,302,631,189,229,138,236,374,53,30,47,97,200,802
137,Dan Gadzuric,C,27,MIL,74,0,885,171,309,0,1,171,308,41,89,91,141,232,24,25,43,35,171,383
138,Deng Gai,C,23,PHI,2,0,5,0,0,0,0,0,0,0,0,0,0,0,0,0,0,0,0,0
139,Reece Gaines,PG,25,MIL,12,0,54,6,12,0,2,6,10,1,4,0,0,0,3,1,0,1,1,13
140,Francisco García,SF,24,SAC,67,11,1301,130,325,39,137,91,188,78,101,39,146,185,94,41,47,75,135,377
141,Kevin Garnett,PF,29,MIN,76,76,2957,626,1191,8,30,618,1161,396,489,214,752,966,308,104,107,180,206,1656
142,Pat Garrity,PF,29,ORL,57,0,938,101,242,50,129,51,113,30,37,31,77,108,38,12,9,38,108,282
143,Pau Gasol,PF,25,MEM,80,80,3135,600,1194,3,12,597,1182,425,617,191,522,713,371,46,153,235,184,1628
144,Devean George,SF,28,LAL,71,5,1542,170,425,50,160,120,265,58,86,82,192,274,68,66,34,54,159,448
145,Eddie Gill,PG,27,IND,41,0,122,10,45,7,23,3,22,18,23,0,15,15,12,11,1,9,13,45
146,Manu Ginóbili,SG,28,SAS,65,56,1813,309,669,83,217,226,452,280,360,42,188,230,235,101,26,121,156,981
147,Gordan Giriček,SG,28,UTA,37,36,956,166,383,18,59,148,324,43,57,15,55,70,63,16,4,63,87,393
148,Anthony Goldwire,PG,34,LAC,3,0,22,1,7,0,2,1,5,0,0,0,1,1,2,0,0,1,0,2
149,Ryan Gomes,PF,23,BOS,61,33,1376,173,355,3,9,170,346,112,149,102,196,298,58,35,5,55,83,461
150,Drew Gooden,PF,24,CLE,79,79,2174,334,652,1,3,333,649,176,258,237,428,665,56,52,49,106,190,845
151,Ben Gordon,SG,22,CHI,80,47,2482,486,1152,166,382,320,770,211,268,43,176,219,240,75,5,180,238,1349
152,Joey Graham,SF,23,TOR,80,24,1581,198,414,29,87,169,327,108,133,57,187,244,60,37,13,92,228,533
153,Stephen Graham,SG,23,TOT,22,0,175,21,54,2,10,19,44,14,15,5,22,27,7,5,2,13,31,58
154,Danny Granger,SF,22,IND,78,17,1765,221,478,30,93,191,385,115,148,131,253,384,90,58,62,80,211,587
155,Brian Grant,C,33,PHO,21,2,248,27,65,0,0,27,65,7,8,11,46,57,7,5,3,7,45,61
156,Devin Green,SG,23,LAL,27,0,135,6,28,0,2,6,26,13,21,10,14,24,7,3,0,5,13,25
157,Gerald Green,SG,20,BOS,32,3,374,66,138,6,20,60,118,29,37,10,31,41,18,13,4,22,41,167
158,Willie Green,SG,24,PHI,10,2,153,28,66,10,19,18,47,4,5,1,14,15,5,2,0,12,13,70
159,Orien Greene,PG,23,BOS,80,5,1235,100,253,9,40,91,213,45,68,37,108,145,129,77,10,109,181,254
160,Adrian Griffin,SG,31,DAL,52,45,1245,98,204,0,2,98,202,41,53,75,152,227,89,51,9,39,113,237
161,Eddie Griffin,C,23,MIN,70,27,1359,130,370,16,82,114,288,44,74,107,282,389,40,13,148,43,125,320
162,Anthony Grundy,SG,26,ATL,12,0,108,19,38,5,15,14,23,9,14,1,16,17,9,7,0,9,14,52
163,Richard Hamilton,SG,27,DET,80,80,2825,649,1322,55,120,594,1202,256,303,84,172,256,275,52,16,173,207,1609
164,Zendon Hamilton,C,30,TOT,12,0,49,7,14,0,0,7,14,12,18,3,8,11,0,4,0,6,5,26
165,Anfernee Hardaway,SF,34,NYK,4,0,72,4,14,0,1,4,13,2,2,0,10,10,8,2,0,6,7,10
166,Matt Harpring,SF,29,UTA,71,32,1944,322,678,14,39,308,639,227,313,158,210,368,98,59,14,109,202,885
167,Al Harrington,PF,25,ATL,76,76,2782,551,1220,66,191,485,1029,243,350,132,391,523,238,85,14,195,301,1411
168,Othella Harrington,C,32,CHI,72,23,824,135,273,0,0,135,273,77,123,54,100,154,39,7,13,61,131,347
169,Devin Harris,PG,22,DAL,56,4,1275,190,405,5,21,185,384,169,236,26,99,125,177,53,16,84,121,554
170,David Harrison,C,23,IND,67,17,1034,148,294,0,0,148,294,89,174,84,170,254,14,23,59,79,193,385
171,Jason Hart,PG,27,SAC,66,0,818,86,221,9,31,77,190,37,56,12,59,71,70,31,5,43,85,218
172,Udonis Haslem,PF,25,MIA,81,80,2491,300,591,0,2,300,589,157,199,167,467,634,95,50,17,80,216,757
173,Trenton Hassell,SG,26,MIN,77,67,2514,286,616,7,23,279,593,131,176,82,134,216,203,43,29,124,201,710
174,Chuck Hayes,PF,22,HOU,40,0,535,59,105,0,1,59,104,29,45,67,112,179,14,26,14,12,76,147
175,Jarvis Hayes,SG,24,WAS,21,13,516,77,183,17,47,60,136,25,30,19,57,76,27,16,1,22,38,196
176,Brendan Haywood,C,26,WAS,79,70,1879,222,432,0,0,222,432,131,224,200,267,467,46,30,104,97,232,575
177,Luther Head,SG,23,HOU,80,27,2310,254,630,113,313,141,317,86,123,33,233,266,215,89,9,119,169,707
178,Alan Henderson,C,33,CLE,51,3,531,47,91,0,0,47,91,33,49,60,77,137,10,9,12,22,58,127
179,Nenê Hilário,PF,23,DEN,1,0,3,0,1,0,0,0,1,0,0,0,0,0,0,0,0,2,1,0
180,Grant Hill*,SF,33,ORL,21,17,613,119,243,2,8,117,235,78,102,15,65,80,48,24,6,35,50,318
181,Kirk Hinrich,PG,25,CHI,81,81,2955,451,1078,126,341,325,737,256,314,29,259,288,514,94,21,188,251,1284
182,Julius Hodge,SG,22,DEN,14,0,33,5,13,0,0,5,13,3,8,5,2,7,6,2,0,8,7,13
183,Randy Holcomb,SF,26,CHI,4,0,11,1,1,0,0,1,1,0,0,1,0,1,0,0,0,0,2,2
184,Robert Horry,PF,35,SAS,63,3,1182,112,292,53,144,59,148,44,68,71,171,242,79,43,51,41,115,321
185,Eddie House,PG,27,PHO,81,0,1421,320,759,123,316,197,443,33,41,15,117,132,148,42,12,76,96,796
186,Dwight Howard,PF,20,ORL,82,81,3021,468,881,0,2,468,879,356,598,288,734,1022,125,65,115,217,277,1292
187,Josh Howard,SF,25,DAL,59,58,1915,350,743,27,63,323,680,196,267,123,248,371,111,68,26,79,167,923
188,Juwan Howard,PF,32,HOU,80,80,2537,394,859,0,4,394,855,154,191,168,367,535,112,49,8,133,235,942
189,Troy Hudson,PG,29,MIN,36,0,800,127,333,40,101,87,232,48,52,8,36,44,106,12,4,40,55,342
190,Larry Hughes,SG,27,CLE,36,31,1281,192,469,28,76,164,393,146,193,26,135,161,131,53,21,99,117,558
191,Kris Humphries,PF,20,UTA,62,2,619,77,203,0,5,77,198,34,65,56,101,157,30,23,16,31,82,188
192,Lindsey Hunter,PG,35,DET,30,1,353,37,100,11,43,26,57,2,4,10,30,40,62,19,1,20,44,87
193,Steven Hunter,C,24,PHI,69,35,1312,175,291,0,0,175,291,71,138,110,161,271,17,12,76,64,120,421
194,Andre Iguodala,SF,22,PHI,82,82,3086,344,688,56,158,288,530,263,349,117,364,481,255,135,21,153,198,1007
195,Zydrunas Ilgauskas,C,30,CLE,78,78,2283,450,889,0,5,450,884,317,380,245,346,591,91,38,136,155,280,1217
196,Didier Ilunga-Mbenga,C,25,DAL,43,1,237,32,60,0,1,32,59,10,20,19,37,56,2,6,25,16,47,74
197,Allen Iverson*,PG,30,PHI,72,72,3103,815,1822,72,223,743,1599,675,829,44,188,232,532,140,10,248,121,2377
198,Royal Ivey,PG,24,ATL,73,66,978,116,264,4,10,112,254,24,33,31,65,96,74,24,7,23,147,260
199,Jarrett Jack,SG,22,POR,79,4,1599,189,428,20,76,169,352,128,160,18,142,160,219,41,2,102,138,526
200,Bobby Jackson,PG,32,MEM,71,15,1775,286,748,129,332,157,416,107,146,44,179,223,195,61,1,101,155,808
201,Jermaine Jackson,PG,29,MIL,30,2,202,11,26,1,4,10,22,12,14,8,19,27,25,4,1,13,19,35
202,Jim Jackson,SF,35,TOT,40,1,512,47,160,18,74,29,86,9,13,11,65,76,35,12,6,35,51,121
203,Luke Jackson,SF,24,CLE,36,0,315,29,85,12,36,17,49,26,33,16,24,40,25,11,2,31,30,96
204,Marc Jackson,C,31,TOT,64,10,1027,174,369,1,2,173,367,66,82,86,131,217,44,13,8,65,126,415
205,Stephen Jackson,SG,27,IND,81,81,2910,472,1148,117,339,355,809,268,341,48,264,312,225,104,43,203,195,1329
206,Jerome James,C,30,NYK,45,9,406,56,121,0,0,56,121,25,40,39,52,91,12,3,23,51,104,137
207,LeBron James,SF,21,CLE,79,79,3361,875,1823,127,379,748,1444,601,814,75,481,556,521,123,66,260,181,2478
208,Mike James,PG,30,TOR,79,79,2925,576,1228,169,382,407,846,283,338,45,217,262,460,72,3,206,214,1604
209,Antawn Jamison,SF,29,WAS,82,80,3288,660,1494,147,373,513,1121,217,297,167,598,765,158,90,12,137,189,1684
210,Marko Jarić,PG,27,MIN,75,49,2102,226,566,40,133,186,433,95,138,60,173,233,293,108,21,127,189,587
211,Šarūnas Jasikevičius,PG,29,IND,75,15,1557,170,429,86,236,84,193,121,133,19,134,153,227,40,4,116,108,547
212,Al Jefferson,PF,21,BOS,59,7,1062,189,379,0,4,189,375,86,134,97,202,299,30,30,46,62,166,464
213,Richard Jefferson,SF,25,NJN,78,78,3059,495,1005,60,188,435,817,471,580,95,439,534,297,59,17,174,193,1521
214,Jared Jeffries,PF,24,WAS,77,77,1951,187,415,16,50,171,365,99,168,164,215,379,148,58,50,99,223,489
215,Amir Johnson,SF,18,DET,3,0,39,7,10,2,3,5,7,4,4,3,1,4,3,0,2,4,7,20
216,Anthony Johnson,PG,31,IND,75,53,1981,267,603,51,155,216,448,106,141,31,137,168,324,63,22,115,132,691
217,DerMarr Johnson,SG,25,DEN,58,21,924,132,306,56,160,76,146,34,42,19,77,96,55,25,26,46,86,354
218,Ervin Johnson,C,38,MIL,18,0,81,7,17,0,0,7,17,1,2,5,19,24,2,1,2,5,23,15
219,Joe Johnson,SG,24,ATL,82,82,3340,632,1395,128,360,504,1035,261,330,98,237,335,536,103,31,267,187,1653
220,Linton Johnson,SF,25,TOT,36,7,524,61,149,13,36,48,113,18,27,40,82,122,14,12,12,28,61,153
221,Dahntay Jones,SF,25,MEM,71,4,967,109,263,3,21,106,242,60,93,20,84,104,39,38,15,50,108,281
222,Damon Jones,PG,29,CLE,82,7,2089,190,491,140,371,50,120,32,50,14,119,133,169,37,1,55,112,552
223,Dwayne Jones,PF,22,BOS,14,0,87,4,10,0,0,4,10,6,13,10,21,31,2,1,3,3,14,14
224,Eddie Jones,SG,34,MEM,75,75,2437,292,722,133,374,159,348,168,215,35,244,279,177,131,27,93,201,885
225,Fred Jones,SG,26,IND,68,2,1837,233,559,63,187,170,372,122,160,18,152,170,154,55,20,107,142,651
226,James Jones,SF,25,PHO,75,24,1772,243,581,110,285,133,296,103,121,44,209,253,57,38,49,35,142,699
227,Jumaine Jones,PF,26,CHA,76,42,2089,298,736,115,335,183,401,88,121,105,271,376,63,68,22,74,200,799
228,Chris Kaman,C,23,LAC,78,78,2560,369,706,0,2,369,704,194,252,187,563,750,79,45,108,176,269,932
229,Jason Kapono,SF,24,MIA,51,2,665,79,177,21,53,58,124,28,33,12,59,71,37,7,3,20,89,207
230,Mario Kasun,C,25,ORL,28,0,213,31,69,0,0,31,69,18,23,24,36,60,3,2,3,15,69,80
231,Viktor Khryapa,SF,23,POR,69,53,1492,158,342,10,30,148,312,77,111,114,193,307,88,50,29,84,209,403
232,Jason Kidd*,PG,32,NJN,80,80,2975,366,905,139,395,227,510,194,244,86,494,580,672,150,29,192,157,1065
233,Andrei Kirilenko,SF,24,UTA,69,63,2604,336,730,36,117,300,613,346,495,161,391,552,299,102,220,203,162,1054
234,Linas Kleiza,PF,21,DEN,61,2,519,77,173,2,13,75,160,57,81,38,78,116,15,10,13,16,87,213
235,Brevin Knight,PG,30,CHA,69,67,2351,308,772,3,13,305,759,252,314,35,188,223,610,157,4,164,202,871
236,Yaroslav Korolev,SF,18,LAC,24,0,127,9,30,2,7,7,23,7,10,5,8,13,9,3,0,6,11,27
237,Kyle Korver,SF,24,PHI,82,43,2563,327,761,184,438,143,323,101,119,27,243,270,163,65,26,98,224,939
238,Nenad Krstić,PF,22,NJN,80,80,2469,447,881,1,4,446,877,185,265,182,331,513,88,32,63,133,297,1080
239,Toni Kukoč,PF,37,MIL,65,0,1018,116,298,45,147,71,151,40,56,26,124,150,139,33,17,66,87,317
240,Raef LaFrentz,PF,29,BOS,82,63,2033,238,552,112,286,126,266,51,75,80,326,406,115,29,72,65,273,639
241,Maciej Lampe,C,20,TOT,6,0,28,2,11,0,0,2,11,0,2,4,5,9,2,0,0,3,2,4
242,David Lee,SF,22,NYK,67,14,1129,137,230,0,0,137,230,71,123,109,194,303,43,30,20,51,124,345
243,Voshon Lenard,SG,32,TOT,26,6,458,75,191,25,78,50,113,16,31,5,42,47,41,21,4,31,39,191
244,Rashard Lewis,SF,26,SEA,78,77,2876,538,1151,142,370,396,781,350,428,111,279,390,182,102,50,141,191,1568
245,Randy Livingston,PG,30,CHI,5,0,22,0,2,0,0,0,2,0,0,1,3,4,1,1,0,1,6,0
246,Shaun Livingston,PG,20,LAC,61,14,1525,149,349,1,8,148,341,53,77,41,142,183,273,46,32,111,160,352
247,John Lucas III,PG,23,HOU,13,0,107,14,36,2,9,12,27,0,0,2,3,5,12,5,0,7,6,30
248,Tyronn Lue,PG,28,ATL,51,10,1234,192,418,58,127,134,291,118,138,13,69,82,157,26,3,75,113,560
249,Arvydas Macijauskas,SG,26,NOK,19,0,135,14,41,3,12,11,29,13,15,3,7,10,5,7,0,8,10,44
250,Mark Madsen,C,30,MIN,62,7,676,27,66,0,7,27,59,20,47,50,91,141,11,23,17,26,114,74
251,Corey Maggette,SF,26,LAC,32,13,943,167,375,24,71,143,304,212,256,28,141,169,66,19,4,78,95,570
252,Jamaal Magloire,C,27,MIL,82,82,2465,287,615,0,0,287,615,178,333,220,558,778,56,29,80,166,276,752
253,Stephon Marbury,PG,28,NYK,60,60,2193,349,774,33,104,316,670,246,326,25,150,175,382,63,4,157,143,977
254,Shawn Marion,PF,27,PHO,81,81,3263,716,1365,96,290,620,1075,241,298,249,710,959,143,160,137,125,223,1769
255,Sean Marks,PF,30,SAS,25,0,181,37,71,0,3,37,68,7,12,12,31,43,7,5,7,7,21,81
256,Donyell Marshall,PF,32,CLE,81,0,2077,265,671,128,395,137,276,92,123,105,387,492,60,59,41,90,160,750
257,Rawle Marshall,SF,23,DAL,23,9,241,24,60,1,3,23,57,22,29,8,23,31,10,8,7,15,17,71
258,Darrick Martin,PG,34,TOR,40,0,339,34,97,16,40,18,57,18,24,2,18,20,57,17,0,15,42,102
259,Kenyon Martin,PF,28,DEN,56,49,1546,297,600,5,22,292,578,121,170,93,260,353,79,43,52,72,171,720
260,Kevin Martin,SG,22,SAC,72,41,1913,262,546,66,179,196,367,188,222,58,203,261,97,55,9,81,138,778
261,Desmond Mason,SF,28,NOK,70,55,2102,275,690,1,6,274,684,206,302,64,234,298,66,42,17,113,136,757
262,Jason Maxiell,PF,22,DET,26,0,159,23,54,0,0,23,54,14,42,12,16,28,3,4,5,11,14,60
263,Sean May,PF,21,CHA,23,1,398,70,171,0,5,70,166,49,64,42,67,109,22,17,12,33,58,189
264,Rashad McCants,SG,21,MIN,79,12,1362,241,535,67,180,174,355,78,106,29,114,143,63,44,22,86,176,627
265,Walter McCarty,SF,31,LAC,36,1,353,33,99,10,45,23,54,12,21,15,53,68,23,8,5,19,52,88
266,Antonio McDyess,PF,31,DET,82,0,1733,285,560,0,2,285,558,68,122,156,280,436,90,46,48,76,220,638
267,Tracy McGrady*,SF,26,HOU,47,47,1745,410,1011,73,234,337,777,254,340,46,261,307,225,59,41,120,88,1147
268,Jeff McInnis,SG,31,NJN,28,1,486,63,143,3,16,60,127,20,29,11,39,50,52,11,2,29,37,149
269,Aaron McKie,PG,33,LAL,14,0,121,3,12,0,2,3,10,1,2,3,17,20,11,5,0,2,7,7
270,Keith McLeod,PG,26,UTA,66,32,1232,120,340,24,82,96,258,106,133,11,67,78,151,42,9,76,131,370
271,Stanislav Medvedenko,PF,26,LAL,2,0,6,1,2,0,0,1,2,0,0,0,0,0,1,0,0,0,1,2
272,Chris Mihm,C,26,LAL,59,56,1541,230,459,0,0,230,459,144,201,137,236,373,61,16,73,83,214,604
273,Aaron Miles,PG,22,GSW,19,0,118,6,18,0,0,6,18,4,4,0,14,14,24,4,1,11,13,16
274,C.J. Miles,PG,18,UTA,23,0,203,28,76,5,20,23,56,18,24,18,20,38,16,7,2,9,20,79
275,Darius Miles,SF,24,POR,40,23,1286,235,510,2,10,233,500,87,163,24,158,182,73,42,39,99,100,559
276,Darko Miličić,C,20,TOT,55,1,767,119,234,0,2,119,232,28,50,44,107,151,41,14,77,51,92,266
277,Andre Miller,PG,29,DEN,82,82,2937,404,872,5,27,399,845,313,424,92,259,351,674,106,18,256,213,1126
278,Brad Miller,C,29,SAC,79,79,2923,434,877,34,88,400,789,280,338,122,493,615,374,61,62,180,234,1182
279,Mike Miller,SG,25,MEM,74,9,2268,354,760,138,339,216,421,168,210,42,355,397,200,52,27,140,173,1014
280,Yao Ming*,C,25,HOU,57,57,1949,467,900,0,1,467,899,337,395,148,433,581,85,30,94,147,195,1271
281,Cuttino Mobley,SG,30,LAC,79,74,2979,429,1008,83,245,346,763,229,273,50,291,341,238,93,36,145,208,1170
282,Nazr Mohammed,C,28,SAS,80,30,1389,190,377,0,0,190,377,113,144,163,255,418,40,21,49,91,220,493
283,Sergei Monia,SF,22,TOT,26,15,343,29,87,9,34,20,53,10,14,11,41,52,19,7,5,12,41,77
284,Mikki Moore,C,30,SEA,47,1,583,54,124,0,2,54,122,46,62,44,86,130,27,7,15,40,92,154
285,Terence Morris,SF,27,ORL,22,0,192,16,49,0,2,16,47,3,3,6,32,38,4,6,5,7,19,35
286,Alonzo Mourning*,C,35,MIA,65,20,1302,188,315,0,1,188,314,133,224,125,234,359,11,13,173,79,177,509
287,Troy Murphy,PF,25,GSW,74,74,2516,363,838,58,181,305,657,251,319,195,548,743,101,47,26,108,191,1035
288,Lamond Murray,SF,32,NJN,57,1,576,72,181,27,78,45,103,25,40,29,103,132,13,17,7,22,66,196
289,Ronald Murray,SG,26,TOT,76,27,2112,321,768,37,141,284,627,172,242,33,120,153,197,68,11,135,133,851
290,Dikembe Mutombo*,C,39,HOU,64,23,955,50,95,0,0,50,95,69,91,100,206,306,4,17,57,35,128,169
291,Boniface N'Dong,C,28,LAC,23,1,152,22,53,0,1,22,52,6,9,15,22,37,7,2,5,6,23,50
293,Lee Nailon,PF,30,PHI,22,0,237,40,80,0,0,40,80,13,15,23,19,42,7,8,4,10,32,93
294,Eduardo Nájera,PF,29,DEN,64,3,1449,127,301,4,12,123,289,89,114,128,197,325,52,53,34,54,165,347
295,Steve Nash*,PG,31,PHO,79,79,2796,541,1056,150,342,391,714,257,279,47,286,333,826,61,12,276,120,1489
296,Jameer Nelson,PG,23,ORL,62,33,1784,347,719,70,165,277,554,141,181,39,141,180,302,70,9,148,174,905
297,Rasho Nesterović,C,29,SAS,80,51,1515,172,334,0,2,172,332,18,30,114,195,309,33,21,88,53,209,362
298,Ira Newble,SG,31,CLE,36,3,353,17,57,3,13,14,44,11,16,21,35,56,9,5,10,12,47,48
299,Andrés Nocioni,PF,26,CHI,82,43,2239,383,831,93,238,290,593,204,242,89,411,500,117,40,52,120,252,1063
300,Moochie Norris,PG,32,TOT,45,0,424,46,112,4,14,42,98,29,42,12,42,54,50,20,1,33,49,125
301,Dirk Nowitzki,PF,27,DAL,81,81,3089,751,1564,110,271,641,1293,539,598,115,613,728,226,58,83,156,164,2151
302,Jermaine O'Neal,PF,27,IND,51,47,1802,380,805,3,10,377,795,261,368,102,374,476,133,27,117,151,177,1024
303,Shaquille O'Neal*,C,33,MIA,59,58,1806,480,800,0,0,480,800,221,471,172,369,541,113,23,104,168,230,1181
304,Fabricio Oberto,C,30,SAS,59,0,490,44,93,0,2,44,91,15,27,57,66,123,27,9,11,28,91,103
305,Lamar Odom,PF,26,LAL,80,80,3221,445,925,80,215,365,710,216,313,181,557,738,443,75,64,213,256,1186
306,Emeka Okafor,PF,23,CHA,26,25,874,131,316,0,0,131,316,82,125,94,167,261,31,22,50,53,88,344
307,Mehmet Okur,PF,26,UTA,82,82,2945,519,1128,80,234,439,894,354,454,211,535,746,194,40,73,163,285,1472
308,Kevin Ollie,SG,33,PHI,70,23,1069,75,174,1,3,74,171,41,49,13,85,98,101,33,3,29,103,192
309,Michael Olowokandi,C,30,TOT,48,24,919,107,240,0,0,107,240,24,47,50,170,220,23,22,33,55,122,238
310,Greg Ostertag,C,32,UTA,60,22,807,61,124,0,0,61,124,24,48,82,143,225,58,6,66,46,129,146
311,Bo Outlaw,PF,34,ORL,32,0,355,35,58,0,0,35,58,5,8,31,46,77,14,10,12,17,50,75
312,Travis Outlaw,PF,21,POR,69,11,1153,162,368,14,53,148,315,62,89,48,141,189,34,31,46,37,112,400
313,Andre Owens,PG,25,UTA,23,2,210,27,74,3,16,24,58,12,18,11,10,21,8,5,0,13,25,69
314,Zaza Pachulia,C,21,ATL,78,78,2452,307,681,0,2,307,679,297,404,264,349,613,129,89,39,180,286,911
315,Scott Padgett,PF,29,NJN,62,1,718,71,201,42,121,29,80,27,34,56,109,165,41,28,12,21,90,211
316,Milt Palacio,PG,27,UTA,71,18,1376,171,403,1,16,170,387,98,150,17,117,134,190,47,14,110,125,441
317,Jannero Pargo,PG,26,CHI,57,0,646,109,292,39,103,70,189,17,21,8,53,61,94,24,2,61,57,274
318,Smush Parker,PG,24,LAL,82,82,2773,348,779,120,328,228,451,125,180,37,234,271,302,140,16,147,213,941
319,Tony Parker,PG,23,SAS,80,80,2715,623,1136,11,36,612,1100,253,358,38,223,261,460,83,4,249,161,1510
321,Chris Paul,PG,20,NOK,78,78,2808,407,947,50,177,357,770,394,465,61,339,400,611,175,6,183,218,1258
322,Sasha Pavlović,SG,22,CLE,53,19,813,87,212,35,96,52,116,32,49,16,64,80,25,19,6,42,103,241
323,Gary Payton*,PG,37,MIA,81,25,2305,230,547,66,230,164,317,100,126,34,199,233,257,71,10,102,169,626
324,Kendrick Perkins,C,21,BOS,68,40,1332,137,266,0,2,137,264,80,130,140,264,404,69,21,105,107,199,354
325,Morris Peterson,SG,28,TOR,82,77,3140,478,1096,177,448,301,648,241,294,65,316,381,190,104,15,126,223,1374
326,Johan Petro,C,20,SEA,68,41,1282,153,300,0,0,153,300,47,75,109,187,296,15,25,51,60,213,353
327,Eric Piatkowski,SG,35,CHI,29,1,228,24,61,9,33,15,28,2,5,4,19,23,13,6,1,11,20,59
328,Paul Pierce,SF,28,BOS,79,79,3084,689,1462,111,314,578,1148,627,812,77,453,530,375,107,34,273,223,2116
329,Mickaël Piétrus,SF,23,GSW,52,18,1179,169,418,56,176,113,242,87,143,58,105,163,44,33,10,78,132,481
330,Zoran Planinić,PG,23,NJN,56,1,596,66,183,13,56,53,127,46,66,14,60,74,53,20,4,43,91,191
331,Pavel Podkolzin,C,21,DAL,1,0,18,0,2,0,0,0,2,3,6,0,7,7,0,0,1,2,0,3
332,Scot Pollard,C,30,IND,45,32,771,70,154,0,0,70,154,29,38,73,145,218,24,37,20,26,115,169
333,James Posey,SF,29,MIA,67,63,1914,159,395,117,290,42,105,48,61,33,286,319,89,54,20,58,196,483
334,Vitaly Potapenko,C,30,TOT,33,12,353,37,71,0,0,37,71,10,17,27,37,64,9,2,2,16,50,84
335,Josh Powell,PF,23,DAL,37,2,429,37,81,0,0,37,81,36,45,28,53,81,9,7,4,22,52,110
336,Ronnie Price,PG,22,SAC,29,0,150,21,58,6,27,15,31,12,12,5,10,15,11,6,0,10,10,60
337,Tayshaun Prince,SF,25,DET,82,82,2898,455,999,64,183,391,816,182,238,104,242,346,186,62,39,91,96,1156
338,Laron Profit,SG,28,LAL,25,1,279,40,84,3,18,37,66,21,24,8,35,43,15,11,5,24,25,104
339,Joel Przybilla,C,26,POR,56,52,1395,131,239,0,0,131,239,82,154,146,245,391,43,20,130,76,149,344
340,Vladimir Radmanović,PF,25,TOT,77,27,1974,262,643,138,354,124,289,93,114,64,294,358,136,61,29,93,210,755
341,Shavlik Randolph,PF,22,PHI,57,1,487,44,97,0,0,44,97,43,71,55,78,133,19,19,12,21,83,131
342,Zach Randolph,PF,24,POR,74,71,2545,536,1229,16,55,520,1174,245,343,193,399,592,144,57,14,165,185,1333
343,Theo Ratliff,C,32,POR,55,19,1301,108,189,0,0,108,189,54,83,89,190,279,28,18,88,47,143,270
344,Željko Rebrača,C,33,LAC,29,2,412,52,96,0,0,52,96,31,41,13,51,64,9,5,19,24,59,135
345,Michael Redd,SG,26,MIL,80,80,3130,682,1516,163,413,519,1103,501,571,78,264,342,229,95,5,170,157,2028
346,Justin Reed,SF,24,TOT,72,6,997,119,295,0,1,119,294,87,120,53,71,124,41,23,15,52,163,325
347,Jason Richardson,SG,25,GSW,75,75,2877,641,1438,183,477,458,961,276,410,105,333,438,232,97,37,167,206,1741
348,Quentin Richardson,SF,25,NYK,55,43,1442,163,459,64,188,99,271,61,91,65,165,230,88,39,6,56,134,451
349,Luke Ridnour,PG,24,SEA,79,77,2625,334,799,43,149,291,650,199,227,47,188,235,550,123,22,162,178,910
350,Anthony Roberson,PG,22,MEM,16,0,88,14,31,5,10,9,21,2,2,0,6,6,5,1,0,3,6,35
351,Lawrence Roberts,C,23,MEM,33,0,181,20,44,0,2,20,42,11,23,26,23,49,5,8,2,5,30,51
352,Bernard Robinson,SF,25,CHA,66,18,1303,157,365,2,21,155,344,106,134,62,157,219,77,81,10,74,141,422
353,Clifford Robinson,PF,39,NJN,80,13,1863,219,513,60,175,159,338,52,79,55,212,267,89,44,40,62,206,550
354,Nate Robinson,PG,21,NYK,72,26,1544,230,565,58,146,172,419,152,202,56,111,167,147,59,1,114,201,670
356,Malik Rose,PF,31,NYK,72,35,1119,105,281,1,1,104,280,107,137,84,175,259,67,43,14,80,145,318
357,Quinton Ross,SF,24,LAC,67,45,1515,130,308,0,7,130,301,57,75,38,132,170,79,51,16,47,155,317
358,Michael Ruffin,C,29,WAS,76,4,1010,34,77,0,2,34,75,37,74,122,149,271,27,33,31,38,179,105
359,Kareem Rush,SG,25,CHA,47,25,1111,181,469,57,164,124,305,55,77,18,85,103,50,38,13,65,79,474
360,Bryon Russell,SF,35,DEN,1,0,3,0,0,0,0,0,0,0,0,0,1,1,1,0,0,0,0,0
361,John Salmons,SG,26,PHI,82,24,2059,219,521,26,87,193,434,155,200,48,172,220,223,73,13,125,178,619
362,Jamal Sampson,PF,22,SAC,12,0,39,5,7,0,0,5,7,0,2,5,13,18,5,0,4,0,5,10
363,Melvin Sanders,SG,25,SAS,16,0,113,16,33,2,3,14,30,7,10,4,19,23,3,5,0,8,20,41
364,Brian Scalabrine,PF,27,BOS,71,1,938,74,193,31,87,43,106,26,36,27,87,114,51,21,19,50,127,205
365,Alex Scales,SG,27,SAS,1,0,0,0,0,0,0,0,0,0,0,0,0,0,0,0,0,0,0,0
366,Luke Schenscher,C,23,CHI,20,0,149,16,26,0,0,16,26,4,13,8,21,29,7,1,3,5,21,36
367,Ha Seung-Jin,C,20,POR,27,4,212,18,31,0,0,18,31,8,17,14,35,49,1,3,8,14,41,44
368,Wayne Simien,PF,22,MIA,43,2,414,58,120,0,0,58,120,30,34,38,50,88,7,13,1,24,70,146
369,Bobby Simmons,SF,25,MIL,75,74,2538,366,808,105,250,261,558,165,200,91,242,333,172,86,21,123,254,1002
370,James Singleton,SF,24,LAC,59,10,753,77,151,10,20,67,131,39,50,63,134,197,29,19,21,28,95,203
372,Charles Smith,SG,30,TOT,22,4,210,30,72,15,38,15,34,5,8,3,13,16,9,5,6,4,28,80
373,Donta Smith,SG,22,ATL,23,0,127,15,27,2,4,13,23,6,12,3,11,14,9,8,0,4,20,38
374,J.R. Smith,SG,20,NOK,55,25,989,144,366,52,140,92,226,83,101,19,91,110,58,37,4,54,90,423
375,Joe Smith,PF,30,MIL,44,5,887,145,305,0,2,145,303,89,115,83,147,230,31,24,13,40,120,379
376,Josh Smith,SF,20,ATL,80,73,2559,329,774,34,110,295,664,210,292,176,355,531,191,64,208,162,260,902
377,Eric Snow,PG,32,CLE,82,82,2351,163,399,1,10,162,389,64,93,38,160,198,346,76,19,116,218,391
378,Kirk Snyder,SG,22,NOK,68,45,1310,205,453,46,129,159,324,86,117,55,106,161,102,29,23,70,106,542
379,Darius Songaila,PF,27,CHI,62,7,1329,236,491,2,5,234,486,94,115,76,170,246,88,35,16,85,157,568
380,Pape Sow,C,24,TOR,42,25,590,53,123,0,0,53,123,41,57,54,92,146,8,21,19,30,118,147
381,Jerry Stackhouse,SG,31,DAL,55,11,1525,242,603,36,130,206,473,195,221,32,121,153,160,37,10,121,96,715
382,DeShawn Stevenson,SG,24,ORL,82,82,2648,359,781,2,15,357,766,180,242,59,182,241,160,58,17,123,178,900
383,Peja Stojaković,SF,28,TOT,71,71,2601,445,1018,162,404,283,614,238,260,79,336,415,136,45,10,103,171,1290
384,Awvee Storey,SF,28,WAS,25,1,116,16,41,3,7,13,34,8,14,8,14,22,4,3,1,5,22,43
385,Damon Stoudamire,PG,32,MEM,27,27,862,114,287,36,104,78,183,53,62,23,72,95,128,19,1,55,49,317
386,Salim Stoudamire,SG,23,ATL,61,1,1236,204,492,82,216,122,276,99,110,12,104,116,75,27,3,82,118,589
387,Amar'e Stoudemire,C,23,PHO,3,3,50,9,27,0,1,9,26,8,9,6,10,16,2,1,3,1,4,26
388,Mike Sweetney,C,23,CHI,66,44,1222,200,444,0,0,200,444,133,204,118,232,350,59,19,56,95,209,533
389,Robert Swift,C,20,SEA,47,20,987,124,241,0,0,124,241,53,91,94,170,264,8,15,56,49,142,301
390,Stromile Swift,C,26,HOU,66,5,1344,225,458,0,2,225,456,136,209,103,188,291,25,38,50,91,198,586
391,Wally Szczerbiak,SF,28,TOT,72,71,2729,493,1012,102,255,391,757,278,310,77,236,313,213,40,19,136,150,1366
392,Chris Taft,C,20,GSW,17,0,144,23,38,0,0,23,38,1,6,19,17,36,2,2,7,2,25,47
393,Donell Taylor,SG,23,WAS,51,1,465,53,136,4,17,49,119,30,43,16,37,53,45,30,4,34,47,140
394,Maurice Taylor,PF,29,NYK,67,13,1210,182,389,0,1,182,388,58,83,65,164,229,53,21,14,103,177,422
395,Sebastian Telfair,PG,20,POR,68,30,1641,228,578,57,162,171,416,130,175,19,101,120,247,66,6,115,167,643
396,Jason Terry,PG,28,DAL,80,80,2798,516,1099,171,416,345,683,168,210,31,127,158,306,100,27,135,196,1371
397,Billy Thomas,SG,30,WAS,17,0,131,13,40,10,30,3,10,2,2,5,9,14,9,10,1,6,19,38
398,Etan Thomas,C,27,WAS,71,9,1121,131,246,0,0,131,246,75,125,99,180,279,14,20,68,51,148,337
399,James Thomas,PF,25,TOT,22,0,150,10,19,0,0,10,19,8,14,12,27,39,1,0,3,7,35,28
400,John Thomas,C,30,TOT,16,0,127,6,15,0,0,6,15,3,4,10,10,20,2,3,2,8,17,15
401,Kenny Thomas,PF,28,SAC,82,55,2293,305,604,0,1,305,603,138,204,199,419,618,168,72,39,135,196,748
402,Kurt Thomas,C,33,PHO,53,50,1411,190,391,0,0,190,391,75,92,102,313,415,57,23,54,57,193,455
404,Dijon Thompson,SG,22,PHO,10,0,43,11,25,4,11,7,14,2,2,4,7,11,1,3,1,2,6,28
405,Jamaal Tinsley,PG,27,IND,42,27,1122,158,386,16,70,142,316,58,91,35,98,133,211,49,6,109,96,390
406,Jake Tsakalidis,C,26,MEM,51,19,732,100,165,0,0,100,165,57,87,78,134,212,13,14,32,39,107,257
408,Ronny Turiaf,C,23,LAL,23,1,161,15,30,0,0,15,30,15,27,11,26,37,8,3,10,7,30,45
409,Hedo Türkoğlu,SF,26,ORL,78,59,2615,398,877,114,283,284,594,255,296,70,263,333,216,70,21,130,234,1165
410,Ime Udoka,SF,28,NYK,8,0,114,9,24,1,3,8,21,3,6,3,14,17,6,1,0,2,8,22
411,Beno Udrih,PG,23,SAS,54,3,586,106,233,24,70,82,163,39,50,18,34,52,92,14,2,53,55,275
412,Nick Van Exel,PG,34,SAS,65,2,986,136,343,55,154,81,189,28,41,6,85,91,123,16,3,57,60,355
413,Keith Van Horn,SF,30,DAL,53,0,1090,164,387,50,136,114,251,94,113,54,138,192,37,31,11,71,121,472
414,Anderson Varejão,C,23,CLE,48,4,760,79,150,0,1,79,149,61,119,77,158,235,19,31,19,27,118,219
415,Jacque Vaughn,SG,30,NJN,80,6,1234,107,245,1,6,106,239,59,81,16,75,91,123,42,1,52,140,274
416,Charlie Villanueva,PF,21,TOR,81,36,2361,435,940,70,214,365,726,113,160,181,340,521,88,60,63,99,247,1053
417,Jake Voskuhl,C,28,CHA,51,2,818,114,261,1,3,113,258,41,60,62,121,183,39,26,23,33,157,270
418,Jackson Vroman,PF,24,NOK,41,2,406,26,66,0,0,26,66,21,44,33,53,86,11,12,11,21,78,73
419,Sasha Vujačić,PG,21,LAL,82,4,1449,108,312,59,172,49,140,46,52,33,126,159,139,48,3,50,150,321
420,Dwyane Wade,SG,24,MIA,75,75,2892,699,1413,13,76,686,1337,629,803,107,323,430,503,146,58,268,217,2040
421,Von Wafer,SG,20,LAL,16,0,73,6,38,2,17,4,21,6,8,5,3,8,4,3,0,1,12,20
422,Antoine Walker,PF,29,MIA,82,19,2199,391,898,137,383,254,515,81,129,103,318,421,166,47,30,150,187,1000
423,Samaki Walker,PF,29,IND,7,0,22,0,2,0,0,0,2,2,2,0,3,3,0,0,1,2,7,2
424,Ben Wallace,C,31,DET,82,82,2890,237,465,0,4,237,461,123,296,301,622,923,158,146,181,88,164,597
425,Gerald Wallace,SF,23,CHA,55,52,1895,317,589,14,50,303,539,188,306,123,289,412,96,138,115,99,150,836
426,Rasheed Wallace,PF,31,DET,80,80,2780,459,1067,155,434,304,633,136,183,90,457,547,182,82,130,85,232,1209
427,Matt Walsh,SG,23,MIA,2,0,3,1,1,0,0,1,1,0,2,0,0,0,0,0,0,1,0,2
428,Luke Walton,SF,25,LAL,69,6,1333,135,328,18,55,117,273,57,76,88,159,247,156,41,15,78,119,345
429,Hakim Warrick,PF,23,MEM,68,2,724,101,228,0,0,101,228,76,115,43,101,144,30,14,21,56,113,278
430,Earl Watson,PG,26,TOT,70,10,1578,219,509,110,272,109,237,75,111,24,134,158,289,68,10,136,159,623
431,Chris Webber,PF,32,PHI,75,75,2893,617,1422,21,77,596,1345,263,348,184,557,741,256,103,62,182,219,1518
432,Martell Webster,SF,19,POR,61,18,1070,139,348,65,182,74,166,61,71,29,101,130,34,21,14,43,90,404
433,Bonzi Wells,SG,29,SAC,52,41,1684,284,613,10,45,274,568,129,190,142,259,401,144,94,25,126,156,707
434,Jiří Welsch,SF,26,MIL,58,2,866,86,222,14,49,72,173,65,87,22,89,111,62,34,1,41,65,251
435,David Wesley,SG,35,HOU,71,59,2372,226,561,99,271,127,290,151,187,24,154,178,204,59,6,120,212,702
436,David West,PF,25,NOK,74,74,2526,530,1036,3,11,527,1025,199,236,168,380,548,92,61,64,105,214,1262
437,Delonte West,PG,22,BOS,71,71,2418,333,684,84,218,249,466,86,101,57,232,289,329,84,46,133,197,836
438,Robert Whaley,C,23,UTA,23,0,212,23,57,0,0,23,57,3,6,16,27,43,17,7,8,14,41,49
440,Damien Wilkins,SF,26,SEA,82,12,1525,193,435,14,56,179,379,136,162,79,113,192,107,72,12,85,144,536
441,Mike Wilks,PG,26,TOT,47,0,348,29,90,3,19,26,71,25,41,9,30,39,32,14,1,24,34,86
442,Aaron Williams,C,34,TOT,48,5,791,91,176,0,0,91,176,40,58,64,117,181,17,17,21,30,138,222
443,Alvin Williams,PG,31,TOR,1,0,10,0,3,0,2,0,1,1,2,0,3,3,0,0,0,0,0,1
444,Deron Williams,PG,21,UTA,80,47,2307,339,805,91,219,248,586,95,135,35,159,194,359,60,17,145,233,864
445,Eric Williams,SF,33,TOR,28,11,352,29,75,5,18,24,57,28,38,10,40,50,15,7,2,15,55,91
446,Jason Williams,PG,30,MIA,59,56,1874,268,606,107,288,161,318,85,98,6,133,139,287,53,5,100,101,728
447,Lou Williams,PG,19,PHI,30,0,145,23,52,2,9,21,43,8,13,3,16,19,10,5,0,13,13,56
448,Marvin Williams,PF,19,ATL,79,7,1952,235,531,13,53,222,478,189,253,122,261,383,63,48,24,83,227,672
449,Mo Williams,PG,23,MIL,58,12,1531,267,629,73,191,194,438,96,113,30,113,143,230,52,7,105,146,703
450,Corliss Williamson,SF,32,SAC,37,0,362,43,103,2,2,41,101,38,49,21,46,67,14,7,4,30,56,126
451,Loren Woods,C,27,TOR,27,4,324,28,59,0,1,28,58,6,14,44,66,110,4,9,23,16,49,62
452,Qyntel Woods,SF,24,NYK,49,16,1013,129,254,22,60,107,194,49,76,44,146,190,47,32,13,61,96,329
453,Metta World Peace,SF,26,TOT,56,56,2207,350,867,78,253,272,614,206,305,75,211,286,203,122,41,131,164,984
454,Antoine Wright,SG,21,NJN,39,0,370,29,81,1,15,28,66,11,22,8,22,30,12,4,3,21,42,70
455,Bracey Wright,SG,21,MIN,7,0,135,21,51,6,17,15,34,14,16,3,15,18,5,1,0,8,8,62
456,Dorell Wright,SF,20,MIA,20,2,132,20,43,3,6,17,37,15,17,2,30,32,8,3,1,14,12,58
457,Lorenzen Wright,C,30,MEM,78,58,1689,194,406,0,2,194,404,66,117,142,253,395,48,52,46,67,201,454
458,Derrick Zimmerman,PG,24,NJN,2,0,32,2,3,0,0,2,3,0,0,1,3,4,7,0,0,4,4,4
