Rk,Player,Pos,Age,Tm,G,GS,MP,FG,FGA,3P,3PA,2P,2PA,FT,FTA,ORB,DRB,TRB,AST,STL,BLK,TOV,PF,PTS
1,Shareef Abdur-Rahim,C,30,SAC,80,45,2015,310,654,3,20,307,634,170,234,122,276,398,109,53,40,116,243,793
2,Hassan Adams,SG,22,NJN,61,8,495,75,135,0,1,75,134,24,36,35,42,77,13,17,4,22,47,174
3,Maurice Ager,SG,22,DAL,32,1,214,22,70,5,15,17,55,20,33,1,20,21,7,4,3,15,27,69
4,LaMarcus Aldridge,C,21,POR,63,22,1392,241,479,0,2,241,477,83,115,144,168,312,24,22,73,43,186,565
5,Malik Allen,PF,28,CHI,60,1,638,107,258,0,1,107,257,28,34,42,77,119,16,17,16,21,85,242
6,Ray Allen*,SG,31,SEA,55,55,2219,505,1153,165,443,340,710,279,309,57,190,247,228,82,11,154,113,1454
7,Tony Allen,SG,25,BOS,33,18,805,133,259,8,33,125,226,105,134,35,89,124,56,49,12,75,87,379
8,Rafer Alston,PG,30,HOU,82,82,3040,383,1020,192,529,191,491,130,177,29,253,282,444,129,10,170,195,1088
9,Lou Amundson,PF,24,TOT,11,0,89,6,15,0,0,6,15,4,10,13,15,28,1,1,8,5,15,16
10,Alan Anderson,SG,24,CHA,17,0,256,37,81,5,20,32,61,19,23,11,21,32,21,7,0,22,33,98
11,Derek Anderson,SF,32,CHA,50,32,1190,126,294,54,152,72,142,93,106,29,84,113,133,52,7,56,115,399
12,Carmelo Anthony,SF,22,DEN,65,65,2486,691,1453,40,149,651,1304,459,568,143,248,391,249,77,23,234,203,1881
13,Rafael Araújo,C,26,UTA,28,0,248,27,65,0,0,27,65,18,29,22,44,66,10,6,2,17,39,72
14,Gilbert Arenas,PG,25,WAS,74,73,2942,647,1548,205,584,442,964,606,718,61,277,338,443,139,13,236,249,2105
15,Trevor Ariza,SG,21,ORL,57,7,1278,200,371,0,7,200,364,106,171,98,151,249,65,59,19,84,134,506
16,Darrell Armstrong,PG,38,IND,81,4,1275,156,377,72,214,84,163,73,93,34,101,135,191,70,6,76,102,457
17,Hilton Armstrong,C,22,NOK,56,5,634,68,125,0,0,68,125,40,67,58,91,149,10,12,26,35,79,176
18,Carlos Arroyo,PG,27,ORL,72,5,1304,203,478,14,51,189,427,132,166,31,103,134,202,39,2,90,131,552
19,Chucky Atkins,PG,32,MEM,75,23,2064,310,715,116,306,194,409,252,311,18,121,139,346,50,4,127,136,988
20,James Augustine,PF,22,ORL,2,0,7,1,3,0,0,1,3,0,0,1,2,3,2,0,0,0,2,2
21,Kelenna Azubuike,SG,23,GSW,41,9,669,98,220,34,79,64,141,61,78,26,68,94,28,22,10,39,49,291
22,Renaldo Balkman,SF,22,NYK,68,1,1064,139,275,5,27,134,248,51,90,97,197,294,44,57,44,49,146,334
23,Marcus Banks,PG,25,PHO,45,1,503,84,196,5,29,79,167,48,60,10,28,38,60,23,3,40,70,221
24,Leandro Barbosa,SG,24,PHO,80,18,2613,529,1111,190,438,339,673,196,232,22,192,214,317,96,15,146,210,1444
25,J.J. Barea,PG,22,DAL,33,1,191,28,78,6,21,22,57,16,24,7,18,25,24,1,1,14,19,78
26,Andrea Bargnani,PF,21,TOR,65,2,1629,267,625,100,268,167,357,117,142,52,203,255,50,32,53,107,180,751
27,Matt Barnes,PF,26,GSW,76,23,1813,275,628,106,290,169,338,90,123,91,259,350,156,73,41,105,188,746
28,Andre Barrett,PG,24,CHI,6,0,29,4,8,0,0,4,8,0,0,1,4,5,7,0,0,4,4,8
29,Earl Barron,C,25,MIA,28,0,203,24,83,0,1,24,82,17,18,19,22,41,5,6,4,11,21,65
30,Brent Barry,SG,35,SAS,75,28,1631,202,425,128,287,74,138,103,117,17,143,160,138,56,12,61,88,635
31,Brandon Bass,PF,21,NOK,21,3,162,15,44,0,1,15,43,12,16,13,30,43,3,2,3,10,16,42
32,Maceo Baston,PF,31,IND,47,2,405,49,76,3,7,46,69,37,47,21,53,74,16,12,18,32,65,138
33,Esteban Batista,PF,23,ATL,13,0,81,8,16,0,0,8,16,4,7,7,23,30,4,3,0,4,13,20
34,Tony Battie,PF,30,ORL,66,66,1575,176,360,0,1,176,359,52,77,92,252,344,35,29,30,61,185,404
35,Shane Battier,SF,28,HOU,82,82,2988,292,654,157,373,135,281,88,113,67,271,338,175,79,60,72,190,829
36,Charlie Bell,SG,27,MIL,82,64,2848,426,974,127,361,299,613,131,168,57,181,238,247,97,4,104,213,1110
37,Raja Bell,SG,30,PHO,78,78,2917,410,950,205,496,205,454,118,152,48,203,251,196,50,22,83,233,1143
38,Mike Bibby,PG,28,SAC,82,82,2784,471,1166,173,481,298,685,288,347,39,224,263,388,88,6,197,139,1403
39,Andris Biedriņš,C,20,GSW,82,63,2382,348,581,0,0,348,581,87,167,251,511,762,88,67,136,119,304,783
40,Chauncey Billups,PG,30,DET,70,70,2533,348,815,109,316,239,499,386,437,23,214,237,502,84,17,140,161,1191
41,Steve Blake,PG,26,TOT,82,42,2225,209,509,67,208,142,301,43,64,21,148,169,408,61,8,129,121,528
42,Will Blalock,PG,23,DET,14,0,166,9,30,1,5,8,25,6,6,6,9,15,17,5,0,12,9,25
43,Andray Blatche,PF,20,WAS,56,13,682,86,197,4,27,82,170,30,49,77,114,191,39,17,32,49,94,206
44,Mark Blount,C,31,MIN,82,81,2544,427,839,9,31,418,808,147,195,136,369,505,67,43,58,159,239,1010
45,Keith Bogans,SG,26,ORL,59,18,990,99,245,53,137,46,108,47,63,16,77,93,59,28,2,46,98,298
46,Andrew Bogut,C,22,MIL,66,66,2258,348,629,1,5,347,624,112,194,168,416,584,198,49,35,150,216,809
47,Matt Bonner,PF,26,SAS,56,0,653,106,237,36,94,70,143,27,38,64,92,156,22,17,11,25,67,275
48,Josh Boone,PF,22,NJN,61,0,669,99,171,0,0,99,171,56,103,64,112,176,10,11,21,33,94,254
49,Calvin Booth,C,30,WAS,44,1,380,31,66,1,2,30,64,6,10,27,54,81,18,4,29,9,71,69
50,Carlos Boozer,PF,25,UTA,74,74,2557,647,1154,0,0,647,1154,255,372,235,632,867,221,70,21,194,217,1549
51,Chris Bosh,C,22,TOR,69,69,2658,543,1094,12,35,531,1059,463,590,186,555,741,175,39,90,179,163,1561
52,Bruce Bowen,SF,35,SAS,82,82,2464,189,467,89,232,100,235,43,73,23,200,223,117,62,25,65,175,510
53,Earl Boykins,PG,30,TOT,66,23,2031,323,769,95,239,228,530,220,245,49,90,139,291,56,2,120,92,961
54,Cedric Bozeman,SG,23,ATL,23,5,199,11,39,2,13,9,26,2,6,3,20,23,9,5,2,9,32,26
55,Elton Brand,PF,27,LAC,80,80,3077,645,1211,1,1,644,1210,351,461,268,476,744,235,77,179,202,238,1642
56,Ronnie Brewer,SG,21,UTA,56,14,675,102,193,0,9,102,184,56,83,37,38,75,24,37,6,24,44,260
57,Primož Brezec,C,27,CHA,58,40,838,122,274,1,3,121,271,43,68,80,104,184,23,11,23,38,161,288
58,Andre Brown,PF,25,SEA,38,0,271,42,74,0,1,42,73,9,15,26,48,74,2,6,4,29,26,93
59,Dee Brown,PG,22,UTA,49,0,450,32,98,6,28,26,70,24,37,8,32,40,83,22,7,31,51,94
60,Devin Brown,SG,28,NOK,58,49,1662,233,555,81,227,152,328,123,155,55,196,251,149,44,9,91,139,670
61,Kwame Brown,C,24,LAL,41,28,1132,143,242,0,1,143,241,59,134,81,163,244,75,39,49,76,124,345
62,P.J. Brown,PF,37,CHI,72,49,1456,170,418,0,2,170,416,96,122,129,218,347,48,24,52,85,187,436
63,Shannon Brown,SG,21,CLE,23,5,202,28,74,7,25,21,49,10,14,6,15,21,10,7,3,14,24,73
64,Kobe Bryant,SG,28,LAL,77,77,3140,813,1757,137,398,676,1359,667,768,75,364,439,413,111,36,255,205,2430
65,Greg Buckner,SG,30,DAL,76,11,1372,123,299,32,103,91,196,27,34,35,123,158,70,47,7,40,152,305
66,Pat Burke,C,33,PHO,23,0,164,23,65,6,22,17,43,8,13,12,35,47,5,3,2,7,19,60
67,Caron Butler,SF,26,WAS,63,63,2474,451,975,18,72,433,903,283,328,147,320,467,233,134,17,181,188,1203
68,Jackie Butler,C,21,SAS,11,2,103,16,35,0,0,16,35,9,10,6,16,22,5,2,0,10,16,41
69,Rasual Butler,SF,27,NOK,81,38,2223,314,788,134,363,180,425,56,87,42,214,256,63,40,54,67,148,818
70,Andrew Bynum,C,19,LAL,82,53,1793,247,443,0,3,247,440,143,214,139,345,484,94,12,128,115,249,637
71,José Calderón,PG,25,TOR,77,11,1614,263,505,25,75,238,430,117,143,21,113,134,387,63,5,110,136,668
72,Marcus Camby,C,32,DEN,70,70,2369,312,659,0,2,312,657,161,221,164,652,816,223,87,231,122,183,785
73,Brian Cardinal,PF,29,MEM,28,1,313,42,85,18,44,24,41,25,27,13,46,59,31,22,1,23,42,127
74,Rodney Carney,SF,22,PHI,67,35,1169,182,392,25,72,157,320,53,87,39,89,128,26,38,23,43,118,442
75,Matt Carroll,SG,26,CHA,72,47,1878,285,658,111,267,174,391,188,208,35,172,207,91,53,9,73,176,869
76,Anthony Carter,PG,31,DEN,2,0,37,3,8,0,2,3,6,0,0,0,3,3,11,0,1,6,4,6
77,Vince Carter,SG,30,NJN,82,82,3126,726,1598,156,437,570,1161,462,576,114,378,492,393,82,30,217,266,2070
78,Sam Cassell,PG,37,LAC,58,30,1407,261,625,32,109,229,516,160,182,27,140,167,270,28,8,101,126,714
79,Kelvin Cato,C,32,NYK,18,0,95,7,22,0,0,7,22,8,12,12,19,31,0,3,10,6,10,22
80,Tyson Chandler,C,24,NOK,73,73,2525,292,468,0,1,292,467,106,201,320,584,904,66,37,129,126,244,690
81,Josh Childress,SG,23,ATL,55,13,2024,261,518,26,77,235,441,167,210,123,217,340,127,58,36,80,118,715
82,Doug Christie,SG,36,LAC,7,0,82,5,17,1,6,4,11,2,3,3,8,11,8,3,1,5,11,13
83,Speedy Claxton,PG,28,ATL,42,31,1054,91,278,6,28,85,250,33,60,12,69,81,185,72,4,75,131,221
84,Jarron Collins,C,28,UTA,82,9,913,75,170,0,0,75,170,54,83,71,100,171,60,13,8,37,147,204
85,Jason Collins,PF,28,NJN,80,78,1844,55,151,0,2,55,149,59,127,90,226,316,46,40,38,73,273,169
86,Mardy Collins,SF,22,NYK,52,9,777,87,228,13,47,74,181,48,82,28,76,104,83,32,3,57,75,235
87,Nick Collison,C,26,SEA,82,56,2378,318,636,0,2,318,634,154,199,229,437,666,82,48,66,123,289,790
89,Brian Cook,PF,26,LAL,65,24,1018,185,408,46,115,139,293,34,47,61,154,215,65,25,27,51,134,450
90,Jamal Crawford,SG,26,NYK,59,36,2198,354,886,103,322,251,564,228,272,44,145,189,259,57,8,162,114,1039
91,Austin Croshere,PF,31,DAL,61,2,727,78,222,26,91,52,131,45,52,33,153,186,44,14,6,33,68,227
92,Eddy Curry,C,24,NYK,81,81,2849,585,1016,1,1,584,1015,405,659,195,376,571,68,34,40,295,265,1576
93,Samuel Dalembert,C,25,PHI,82,82,2535,356,658,0,2,356,656,167,224,239,494,733,64,47,159,161,287,879
94,Erick Dampier,C,31,DAL,76,73,1915,209,334,0,0,209,334,119,191,217,349,566,44,24,82,107,239,537
95,Antonio Daniels,SG,31,WAS,80,8,1761,172,389,19,63,153,326,208,250,18,133,151,290,39,9,69,79,571
96,Marquis Daniels,SG,26,IND,45,4,800,129,281,6,26,123,255,56,80,26,56,82,57,27,7,55,56,320
97,Baron Davis,PG,27,GSW,63,62,2221,452,1030,85,280,367,750,275,369,51,225,276,509,135,29,193,181,1264
98,Dale Davis,C,37,DET,46,6,464,33,74,0,0,33,74,17,26,59,78,137,12,10,34,15,59,83
99,Paul Davis,C,22,LAC,31,0,180,22,52,0,0,22,52,7,10,21,23,44,7,6,5,8,28,51
100,Ricky Davis,SF,27,MIN,81,81,3021,506,1089,123,310,383,779,239,285,54,261,315,385,80,23,210,189,1374
101,Carlos Delfino,SG,24,DET,82,1,1372,156,376,46,138,110,238,70,89,67,199,266,88,46,8,61,97,428
102,Luol Deng,SF,21,CHI,82,82,3071,630,1218,1,7,629,1211,279,359,148,431,579,204,97,48,153,167,1540
103,Boris Diaw,PF,24,PHO,73,59,2268,306,569,15,45,291,524,82,120,91,226,317,352,28,38,154,177,709
104,Yakhouba Diawara,SG,24,DEN,64,19,1177,100,292,49,170,51,122,35,53,27,83,110,55,30,7,37,132,284
105,Dan Dickau,PG,28,POR,50,3,444,54,151,16,61,38,90,42,53,7,36,43,70,14,1,27,55,166
106,Travis Diener,PG,24,ORL,26,0,288,34,80,18,50,16,30,12,15,3,15,18,35,4,0,13,27,98
107,Ike Diogu,PF,23,TOT,59,2,760,127,266,0,0,127,266,112,140,75,128,203,25,8,26,67,122,366
108,DeSagana Diop,C,25,DAL,81,9,1480,71,151,0,1,71,150,48,86,166,272,438,30,40,113,63,244,190
109,Juan Dixon,SG,28,TOT,81,6,1926,299,703,79,226,220,477,101,116,27,131,158,123,76,9,101,177,778
110,Michael Doleac,C,29,MIA,56,0,698,82,175,0,1,82,174,36,41,44,111,155,22,18,15,30,96,200
111,Keyon Dooling,SG,26,ORL,66,2,1435,188,458,31,96,157,362,114,141,22,64,86,112,52,15,72,125,521
112,Quincy Douby,PG,22,SAC,42,0,359,48,126,12,50,36,76,11,15,11,26,37,15,15,4,15,21,119
113,Chris Duhon,PG,24,CHI,78,30,1906,197,483,88,245,109,238,76,101,23,146,169,310,69,6,105,150,558
114,Tim Duncan,C,30,SAS,80,80,2726,618,1131,1,9,617,1122,362,568,213,633,846,273,66,190,224,203,1599
116,Ronald Dupree,SF,26,DET,19,0,94,11,31,0,0,11,31,3,9,5,12,17,5,5,1,3,12,25
117,Monta Ellis,SG,21,GSW,77,53,2638,480,1010,39,143,441,867,273,358,62,181,243,319,132,21,221,210,1272
118,Francisco Elson,C,30,SAS,70,41,1332,144,282,0,2,144,280,62,80,81,255,336,55,31,59,86,184,350
120,Maurice Evans,SG,28,LAL,76,10,1732,234,542,48,133,186,409,122,155,93,128,221,74,38,14,57,126,638
121,Reggie Evans,PF,26,DEN,66,11,1127,117,215,0,0,117,215,91,183,156,304,460,45,42,16,95,144,325
122,Daniel Ewing,PG,23,LAC,61,3,712,65,161,14,44,51,117,35,45,9,64,73,90,32,4,50,62,179
123,Jordan Farmar,PG,20,LAL,72,2,1090,124,294,45,137,79,157,27,38,22,97,119,137,44,7,73,77,320
124,Desmon Farmer,SG,25,SEA,8,0,32,5,15,2,8,3,7,1,1,0,1,1,9,1,0,1,2,13
125,Raymond Felton,PG,22,CHA,78,75,2832,393,1024,103,312,290,712,204,256,51,216,267,545,118,10,230,180,1093
126,Michael Finley,SF,33,SAS,82,16,1823,273,663,104,286,169,377,90,98,34,189,223,108,32,16,46,76,740
127,Derek Fisher,SG,32,UTA,82,61,2287,258,675,48,156,210,519,262,307,30,119,149,274,83,6,120,234,826
128,T.J. Ford,PG,23,TOR,75,71,2243,393,902,21,69,372,833,240,293,53,183,236,595,101,8,231,186,1047
129,Danny Fortson,C,30,SEA,14,6,158,15,30,0,1,15,29,10,13,13,30,43,1,1,0,15,38,40
130,Jeff Foster,C,30,IND,75,43,1740,122,260,0,1,122,259,78,122,253,356,609,57,62,37,70,202,322
131,Randy Foye,PG,23,MIN,82,12,1879,300,691,68,185,232,506,164,192,49,169,218,232,53,21,152,184,832
132,Adonal Foyle,C,31,GSW,48,6,475,48,85,0,0,48,85,11,25,51,75,126,19,11,50,23,61,107
133,Steve Francis,SG,29,NYK,44,30,1237,140,343,42,111,98,232,175,211,33,124,157,170,41,12,100,126,497
134,Matt Freije,PF,25,ATL,19,0,147,16,54,3,22,13,32,5,6,8,16,24,7,3,1,3,13,40
135,Channing Frye,PF,23,NYK,72,59,1896,298,689,3,18,295,671,85,108,91,304,395,67,36,42,100,216,684
136,Dan Gadzuric,C,28,MIL,54,8,840,108,228,0,1,108,227,42,90,94,152,246,29,22,32,49,141,258
137,Jorge Garbajosa,PF,29,TOR,67,60,1909,222,529,66,193,156,336,57,78,48,282,330,125,78,15,64,90,567
138,Francisco García,SF,25,SAC,79,5,1410,163,380,53,149,110,231,95,114,53,152,205,87,45,43,70,190,474
139,Kevin Garnett,PF,30,MIN,76,76,2995,638,1341,12,56,626,1285,416,498,183,792,975,313,89,126,205,184,1704
140,Pat Garrity,PF,30,ORL,33,0,277,22,70,11,32,11,38,16,18,12,30,42,14,7,0,14,37,71
141,Pau Gasol,C,26,MEM,59,59,2133,462,858,3,11,459,847,299,400,149,432,581,201,29,126,162,137,1226
142,Rudy Gay,SF,20,MEM,78,43,2103,321,760,52,143,269,617,152,209,93,255,348,100,71,74,140,192,846
143,Mickaël Gelabale,SF,23,SEA,70,14,1239,122,264,11,47,111,217,66,82,59,114,173,56,24,22,49,108,321
144,Devean George,SF,29,DAL,60,17,1283,146,370,53,150,93,220,36,48,57,156,213,33,46,23,51,143,381
145,Daniel Gibson,PG,20,CLE,60,16,988,98,231,52,124,46,107,28,39,28,64,92,69,23,8,44,94,276
146,Manu Ginóbili,SG,29,SAS,75,36,2060,396,854,128,323,268,531,320,372,59,268,327,263,109,27,157,155,1240
147,Gordan Giriček,SG,29,UTA,61,6,1188,176,381,52,122,124,259,71,87,24,105,129,63,28,5,64,122,475
148,Andreas Glyniadakis,C,25,SEA,13,4,81,8,17,0,0,8,17,1,2,2,6,8,1,0,0,9,19,17
149,Ryan Gomes,PF,24,BOS,73,60,2275,338,723,16,42,322,681,189,233,125,282,407,119,48,13,105,169,881
150,Drew Gooden,PF,25,CLE,80,80,2238,371,784,1,6,370,778,142,199,263,418,681,88,70,28,115,210,885
151,Ben Gordon,SG,23,CHI,82,51,2704,609,1338,155,375,454,963,380,440,35,223,258,296,64,17,249,252,1753
152,Joey Graham,SF,24,TOR,79,21,1319,192,388,9,31,183,357,110,131,55,193,248,44,30,4,49,161,503
153,Stephen Graham,SG,24,POR,14,1,165,17,40,3,11,14,29,8,9,6,15,21,5,4,1,13,25,45
154,Danny Granger,SF,23,IND,82,57,2785,398,868,110,288,288,580,236,294,114,267,381,114,67,61,135,245,1142
155,Gerald Green,SF,21,BOS,81,26,1780,310,739,95,258,215,481,128,159,68,140,208,83,41,24,120,198,843
156,Willie Green,SG,25,PHI,74,36,1842,357,868,51,157,306,711,74,111,42,116,158,112,56,4,106,144,839
157,Orien Greene,SG,24,IND,41,0,254,23,62,2,11,21,51,15,25,12,32,44,22,17,4,28,38,63
158,Lynn Greer,SG,27,MIL,41,0,432,61,141,18,52,43,89,27,32,2,25,27,53,17,1,18,32,167
159,Adrian Griffin,SF,32,CHI,54,1,585,61,129,0,6,61,123,15,19,40,69,109,59,32,4,38,78,137
160,Eddie Griffin,PF,24,MIN,13,0,92,7,27,0,1,7,26,4,5,7,18,25,4,0,7,6,8,18
161,Mike Hall,SF,22,WAS,2,0,13,1,4,0,0,1,4,0,0,1,1,2,1,0,0,0,1,2
162,Richard Hamilton,SG,28,DET,75,75,2763,547,1170,44,129,503,1041,347,403,75,207,282,285,59,15,159,232,1485
163,Matt Harpring,SF,30,UTA,77,2,1965,322,656,13,39,309,617,237,309,117,236,353,99,52,11,118,232,894
164,Al Harrington,PF,26,TOT,78,78,2563,495,1083,127,293,368,790,168,242,151,345,496,149,65,24,169,269,1285
165,Junior Harrington,PG,26,MEM,29,8,543,57,137,7,26,50,111,31,46,12,56,68,89,21,5,52,79,152
166,Othella Harrington,PF,33,CHA,26,0,220,25,56,0,0,25,56,17,22,13,25,38,6,1,1,15,49,67
167,Devin Harris,PG,23,DAL,80,61,2081,292,593,14,50,278,543,215,261,45,151,196,296,96,21,146,242,813
168,David Harrison,C,24,IND,24,2,190,30,58,0,0,30,58,11,22,9,33,42,6,5,12,26,47,71
169,Jason Hart,PG,28,TOT,36,22,846,100,224,7,29,93,195,42,47,14,84,98,103,44,1,38,83,249
170,Udonis Haslem,PF,26,MIA,79,79,2483,353,717,0,4,353,713,138,203,188,466,654,97,49,26,110,236,844
171,Trenton Hassell,SG,27,MIN,76,68,2223,217,443,6,25,211,418,72,92,83,160,243,203,22,26,80,144,512
172,Chuck Hayes,PF,23,HOU,78,43,1714,192,335,0,0,192,335,55,89,204,317,521,47,70,18,64,281,439
173,Jarvis Hayes,SF,25,WAS,81,17,1626,224,546,66,183,158,363,71,84,42,168,210,80,48,13,56,160,585
174,Brendan Haywood,C,27,WAS,77,49,1740,198,355,0,0,198,355,115,210,195,282,477,47,34,88,90,208,511
175,Luther Head,SG,24,HOU,80,10,2211,306,700,177,401,129,299,83,105,31,221,252,194,76,5,137,133,872
176,Alan Henderson,PF,34,PHI,38,5,418,43,67,0,0,43,67,33,47,48,59,107,10,9,12,12,62,119
177,Walter Herrmann,PF,27,CHA,48,12,936,174,330,53,115,121,215,41,53,28,111,139,26,17,7,32,76,442
178,Nenê Hilário,C,24,DEN,64,42,1715,294,516,0,1,294,515,195,283,150,299,449,77,62,59,127,209,783
179,Grant Hill*,SG,34,ORL,65,64,2009,342,660,2,12,340,648,248,324,53,184,237,138,61,25,144,146,934
180,Kirk Hinrich,PG,26,CHI,80,80,2839,475,1061,140,337,335,724,237,284,32,242,274,500,100,23,191,274,1327
181,Robert Hite,SG,23,MIA,12,0,136,19,60,5,23,14,37,8,12,4,12,16,8,3,2,6,8,51
182,Julius Hodge,SG,23,TOT,9,1,65,6,12,0,0,6,12,3,4,2,6,8,12,4,0,3,6,15
183,Ryan Hollins,C,22,CHA,27,0,185,20,36,0,0,20,36,24,40,11,20,31,1,4,7,16,40,64
184,Robert Horry,PF,36,SAS,68,8,1124,90,251,50,149,40,102,38,64,73,156,229,77,45,41,44,105,268
185,Eddie House,SG,28,NJN,56,1,946,180,421,75,175,105,246,33,36,14,78,92,67,27,3,27,69,468
186,Dwight Howard,C,21,ORL,82,82,3023,526,873,1,2,525,871,390,666,283,725,1008,158,70,156,317,245,1443
187,Josh Howard,SF,26,DAL,70,69,2455,493,1075,92,239,401,836,243,294,130,345,475,127,82,56,123,180,1321
188,Juwan Howard,PF,33,HOU,80,38,2123,309,665,0,0,309,665,155,188,138,332,470,131,29,8,112,205,773
189,Troy Hudson,PG,30,MIN,34,6,554,74,195,28,80,46,115,26,32,8,40,48,73,14,2,40,23,202
190,Larry Hughes,SG,28,CLE,70,68,2596,381,953,74,222,307,731,209,309,41,226,267,256,89,26,154,164,1045
191,Kris Humphries,PF,21,TOR,60,2,670,87,185,0,0,87,185,53,79,78,109,187,18,14,21,32,98,227
192,Lindsey Hunter,PG,36,DET,52,0,745,94,244,38,119,56,125,30,33,9,38,47,93,34,7,35,56,256
193,Steven Hunter,PF,25,PHI,70,41,1605,188,326,0,0,188,326,74,151,114,221,335,26,13,76,65,137,450
194,Andre Iguodala,SG,23,PHI,76,76,3062,443,991,48,155,395,836,452,551,77,357,434,432,152,33,261,200,1386
195,Zydrunas Ilgauskas,C,31,CLE,78,78,2130,385,793,0,1,385,792,155,192,242,357,599,123,48,98,141,257,925
196,Mile Ilić,C,22,NJN,5,0,6,0,3,0,0,0,3,0,0,0,1,1,0,0,0,3,1,0
197,Didier Ilunga-Mbenga,C,26,DAL,21,0,79,5,16,0,0,5,16,7,8,3,8,11,6,3,5,5,17,17
198,Ersan İlyasova,PF,19,MIL,66,14,973,139,363,54,148,85,215,70,89,58,131,189,49,27,17,51,147,402
200,Royal Ivey,PG,25,ATL,53,18,539,64,143,5,16,59,127,24,35,15,36,51,45,24,4,31,62,157
201,Jarrett Jack,PG,23,POR,79,79,2651,320,705,63,180,257,525,243,279,18,190,208,417,86,9,187,202,946
202,Bobby Jackson,SG,33,NOK,56,2,1330,204,518,54,165,150,353,130,168,42,136,178,141,50,6,78,98,592
203,Luke Jackson,SF,25,TOT,13,2,138,19,43,5,17,14,26,5,9,2,8,10,13,5,1,7,15,48
204,Marc Jackson,PF,32,NOK,56,25,1025,159,388,0,1,159,387,90,103,62,130,192,58,21,7,65,89,408
206,Jerome James,C,31,NYK,41,11,273,33,79,0,0,33,79,10,18,21,45,66,3,6,15,23,73,76
207,LeBron James,SF,22,CLE,78,78,3190,772,1621,99,310,673,1311,489,701,83,443,526,470,125,55,250,171,2132
208,Mike James,PG,31,MIN,82,65,2069,297,703,80,215,217,488,154,184,25,138,163,297,55,7,129,171,828
209,Antawn Jamison,PF,30,WAS,70,70,2662,512,1139,138,379,374,760,226,307,134,428,562,136,80,36,104,194,1388
210,Marko Jarić,SG,28,MIN,70,13,1555,136,325,32,85,104,240,67,88,54,130,184,145,75,16,88,172,371
212,Al Jefferson,C,22,BOS,69,60,2319,453,882,0,1,453,881,201,295,237,519,756,88,48,106,136,232,1107
213,Richard Jefferson,SF,26,NJN,55,53,1956,303,665,52,145,251,520,239,326,48,192,240,148,34,8,120,123,897
214,Jared Jeffries,SF,25,NYK,55,43,1307,95,206,2,20,93,186,31,68,111,127,238,67,44,30,61,150,223
215,Alexander Johnson,PF,23,MEM,59,19,753,91,169,0,0,91,169,78,118,50,131,181,17,25,35,47,137,260
216,Amir Johnson,PF,19,DET,8,0,124,18,33,0,3,18,30,11,14,15,22,37,3,5,13,9,19,47
217,Anthony Johnson,PG,32,TOT,67,17,1301,142,343,25,73,117,270,46,61,22,79,101,201,33,3,76,119,355
218,DerMarr Johnson,SF,26,DEN,39,7,419,50,154,19,88,31,66,16,21,10,47,57,17,16,12,27,39,135
219,Joe Johnson,SG,25,ATL,57,57,2359,536,1139,119,312,417,827,235,314,53,186,239,249,60,11,176,115,1426
220,Linton Johnson,PF,26,NOK,54,0,720,93,190,10,30,83,160,30,37,52,111,163,18,33,18,27,101,226
221,Bobby Jones,SF,23,PHI,44,5,336,43,93,1,9,42,84,23,41,22,35,57,16,11,1,18,59,110
222,Dahntay Jones,SG,26,MEM,78,25,1671,220,461,5,12,215,449,138,174,47,106,153,68,39,22,92,192,583
223,Damon Jones,PG,30,CLE,60,0,1173,137,355,89,231,48,124,30,44,9,57,66,94,16,2,36,53,393
224,Dwayne Jones,PF,23,CLE,4,0,18,0,1,0,0,0,1,3,6,1,5,6,0,0,0,2,3,3
225,Eddie Jones,SG,35,TOT,64,41,1594,178,422,78,222,100,200,59,75,31,159,190,109,68,10,47,124,493
226,Fred Jones,SG,27,TOT,63,12,1319,139,361,39,128,100,233,95,114,23,92,115,108,48,16,67,121,412
227,James Jones,SF,26,PHO,76,7,1376,162,440,90,238,72,202,71,81,33,143,176,45,28,42,28,115,485
228,Jumaine Jones,SF,27,PHO,18,0,138,14,51,10,32,4,19,2,2,6,17,23,1,5,1,7,19,40
229,Solomon Jones,PF,22,ATL,58,8,666,65,128,0,1,65,127,59,75,49,87,136,11,11,42,25,124,189
230,Chris Kaman,C,24,LAC,75,66,2176,294,652,0,1,294,651,166,224,160,428,588,79,41,116,147,251,754
231,Jason Kapono,SF,25,MIA,67,35,1767,278,563,108,210,170,353,66,74,26,154,180,81,38,2,70,135,730
232,Viktor Khryapa,PF,24,CHI,33,0,231,27,70,0,6,27,64,19,26,20,37,57,21,10,1,16,53,73
233,Jason Kidd*,PG,33,NJN,80,80,2933,369,908,124,361,245,547,179,230,135,520,655,736,127,23,213,146,1041
234,Tarence Kinsey,SG,22,MEM,48,12,967,139,304,13,46,126,258,78,98,29,68,97,41,53,1,46,57,369
235,Andrei Kirilenko,SF,25,UTA,70,70,2049,197,418,16,75,181,343,174,239,88,241,329,202,74,144,135,172,584
236,Linas Kleiza,PF,22,DEN,79,14,1488,200,474,83,221,117,253,115,135,77,189,266,45,28,14,79,200,598
237,Brevin Knight,PG,31,CHA,45,25,1273,152,363,1,18,151,345,103,128,14,101,115,296,67,3,95,113,408
238,Yaroslav Korolev,SF,19,LAC,10,0,41,4,16,1,5,3,11,3,6,1,2,3,4,3,0,1,0,12
239,Kyle Korver,SF,25,PHI,74,1,2288,372,845,132,307,240,538,191,209,30,229,259,105,57,20,117,188,1067
240,Nenad Krstić,C,23,NJN,26,26,848,170,323,0,1,170,322,86,121,51,125,176,46,10,24,52,88,426
241,Raef LaFrentz,PF,30,POR,27,9,352,39,102,2,23,37,79,20,26,25,45,70,8,7,11,13,57,100
242,James Lang,C,23,WAS,11,0,55,4,9,0,0,4,9,3,5,5,6,11,2,0,3,2,14,11
243,David Lee,PF,23,NYK,58,12,1731,240,400,0,0,240,400,141,173,196,406,602,104,48,23,92,155,621
244,Rashard Lewis,SF,27,SEA,60,60,2348,463,1005,151,387,312,618,265,315,91,305,396,145,68,39,118,143,1342
245,Randy Livingston,PG,31,SEA,4,0,26,0,3,0,0,0,3,0,0,1,0,1,4,0,0,1,2,0
246,Shaun Livingston,PG,21,LAC,54,31,1611,208,449,5,16,203,433,82,116,56,128,184,274,59,29,108,135,503
247,Kyle Lowry,PG,20,MEM,10,0,175,14,38,3,8,11,30,25,28,12,19,31,32,14,1,12,20,56
248,John Lucas III,PG,24,HOU,47,0,383,62,156,15,59,47,97,15,19,9,27,36,33,17,0,15,38,154
249,Tyronn Lue,PG,29,ATL,56,17,1488,218,524,56,161,162,363,144,163,19,85,104,201,24,0,85,101,636
250,Mark Madsen,C,31,MIN,56,0,473,23,43,0,0,23,43,15,29,35,52,87,10,10,10,21,100,61
251,Corey Maggette,SF,27,LAC,75,31,2291,367,808,13,65,354,743,519,633,90,352,442,208,65,14,201,244,1266
252,Jamaal Magloire,C,28,POR,81,23,1703,199,395,0,0,199,395,131,242,151,341,492,30,21,66,129,226,529
253,Renaldo Major,PF,24,GSW,1,0,27,2,10,0,0,2,10,1,2,0,2,2,0,2,0,1,4,5
254,Stephon Marbury,PG,29,NYK,74,74,2748,395,952,123,345,272,607,297,386,36,177,213,403,71,10,179,185,1210
255,Shawn Marion,SF,28,PHO,80,80,3010,561,1071,80,252,481,819,201,248,172,613,785,134,156,122,114,216,1403
256,Damir Markota,PF,21,MIL,30,0,170,19,52,6,16,13,36,7,11,11,20,31,6,3,1,15,22,51
257,Sean Marks,PF,31,PHO,3,0,17,2,6,0,1,2,5,2,2,0,3,3,0,0,1,0,4,6
258,Donyell Marshall,PF,33,CLE,81,0,1360,209,493,95,271,114,222,53,80,86,237,323,46,39,43,67,130,566
259,Rawle Marshall,SG,24,IND,40,2,361,32,89,4,18,28,71,31,45,8,21,29,13,12,5,19,22,99
260,Darrick Martin,PG,35,TOR,31,0,220,33,94,13,37,20,57,15,21,2,10,12,43,3,0,12,22,94
261,Kenyon Martin,PF,29,DEN,2,2,63,8,16,0,1,8,15,3,12,6,14,20,1,0,0,5,10,19
262,Kevin Martin,SG,23,SAC,80,80,2818,505,1067,127,333,378,734,481,570,69,273,342,173,98,11,135,181,1618
263,Desmond Mason,SF,29,NOK,75,75,2575,407,900,0,0,407,900,214,323,124,221,345,115,52,22,192,174,1028
264,Roger Mason,SG,26,WAS,62,0,492,59,179,33,102,26,77,14,16,7,38,45,35,13,6,19,66,165
265,Jason Maxiell,C,23,DET,67,8,943,131,262,0,0,131,262,72,137,88,98,186,14,30,60,53,110,334
266,Sean May,PF,22,CHA,35,8,838,164,328,2,3,162,325,86,112,73,160,233,66,19,24,56,100,416
267,Rashad McCants,SG,22,MIN,37,0,554,62,177,20,75,42,102,40,58,14,33,47,38,26,7,40,71,184
268,Chris McCray,SG,22,MIL,5,0,12,0,3,0,0,0,3,0,0,0,0,0,0,0,0,2,1,0
269,Antonio McDyess,PF,32,DET,82,3,1729,284,540,0,0,284,540,96,139,165,331,496,72,61,65,75,240,664
270,Ivan McFarlin,PF,24,PHI,11,0,41,5,13,0,1,5,12,5,7,7,4,11,1,0,0,1,8,15
271,Tracy McGrady*,SG,27,HOU,71,71,2539,638,1480,126,381,512,1099,345,488,56,322,378,458,92,36,213,136,1747
272,Jeff McInnis,PG,32,CHA,38,3,702,71,181,1,8,70,173,22,32,14,48,62,124,14,0,42,72,165
273,Aaron McKie,SF,34,LAL,10,0,131,11,17,0,0,11,17,0,0,1,17,18,13,4,0,8,14,22
274,Keith McLeod,PG,27,TOT,48,9,718,73,188,16,45,57,143,69,78,4,39,43,90,24,5,46,51,231
275,Stanislav Medvedenko,C,27,ATL,14,0,81,12,29,1,2,11,27,17,20,4,10,14,2,0,2,5,16,42
276,Pops Mensah-Bonsu,PF,23,DAL,12,0,71,11,17,0,0,11,17,7,18,9,12,21,0,1,0,9,8,29
277,C.J. Miles,SG,19,UTA,37,13,373,40,116,7,32,33,84,14,23,11,24,35,25,11,4,28,60,101
278,Darko Miličić,PF,21,ORL,80,16,1913,249,548,0,1,249,547,141,230,145,292,437,90,44,140,124,219,639
279,Andre Miller,PG,30,TOT,80,79,2966,424,909,5,35,419,874,222,283,97,255,352,625,110,10,222,184,1075
280,Brad Miller,C,30,SAC,63,56,1783,224,494,5,33,219,461,115,149,79,322,401,224,38,39,108,155,568
281,Mike Miller,SG,26,MEM,70,69,2740,465,1010,202,498,263,512,161,203,52,326,378,298,54,18,179,138,1293
282,Paul Millsap,PF,21,UTA,82,1,1472,209,398,1,3,208,395,140,208,183,240,423,62,67,74,94,236,559
283,Yao Ming*,C,26,HOU,48,48,1624,423,819,0,2,423,817,356,413,101,351,452,94,17,94,167,159,1202
284,Cuttino Mobley,SG,31,LAC,78,73,2841,388,882,101,246,287,636,200,239,52,215,267,198,92,24,145,186,1077
285,Nazr Mohammed,C,29,DET,51,33,773,118,222,0,0,118,222,50,82,89,140,229,9,27,40,43,133,286
286,Mikki Moore,C,31,NJN,79,55,2082,308,506,0,1,308,505,160,235,145,258,403,74,46,60,113,261,776
287,Randolph Morris,C,21,NYK,5,0,44,1,6,0,0,1,6,2,6,1,8,9,1,2,1,2,4,4
288,Adam Morrison,PF,22,CHA,78,23,2326,355,944,87,258,268,686,120,169,54,176,230,163,28,6,130,179,917
289,Alonzo Mourning*,C,36,MIA,77,43,1572,238,425,0,0,238,425,185,308,126,224,350,18,13,178,129,219,661
290,Troy Murphy,PF,26,TOT,68,48,1852,266,581,58,147,208,434,108,145,100,314,414,126,46,42,78,196,698
291,Ronald Murray,SG,27,DET,69,18,1477,177,438,24,83,153,355,87,120,26,87,113,187,49,13,90,96,465
292,Dikembe Mutombo*,C,40,HOU,75,33,1289,85,153,0,0,85,153,60,87,164,324,488,13,22,76,38,156,230
293,Boštjan Nachbar,SF,26,NJN,76,1,1532,226,495,112,265,114,230,132,164,27,226,253,61,30,26,69,183,696
294,Eduardo Nájera,PF,30,DEN,75,36,1658,204,354,1,12,203,342,88,123,131,179,310,64,73,26,56,207,497
295,Steve Nash*,PG,32,PHO,76,76,2682,517,971,156,343,361,628,222,247,30,239,269,884,57,6,287,117,1412
296,Jameer Nelson,PG,24,ORL,77,77,2331,376,875,65,194,311,681,183,221,50,186,236,330,73,5,184,225,1000
297,Rasho Nesterović,C,30,TOR,80,73,1676,230,421,0,1,230,420,34,50,115,245,360,74,37,84,56,193,494
298,Ira Newble,SF,32,CLE,15,1,129,16,37,8,15,8,22,6,10,13,17,30,2,6,0,3,17,46
299,Andrés Nocioni,PF,27,CHI,53,31,1406,273,584,80,209,193,375,123,145,42,259,301,57,27,24,104,164,749
300,David Noel,PF,22,MIL,68,0,792,65,177,17,53,48,124,37,43,42,81,123,65,25,9,40,77,184
301,Steve Novak,SF,23,HOU,35,1,191,18,50,13,39,5,11,2,2,4,22,26,6,5,0,4,21,51
302,Dirk Nowitzki,PF,28,DAL,78,78,2820,673,1341,72,173,601,1168,498,551,122,571,693,263,52,62,167,171,1916
303,Patrick O'Bryant,C,20,GSW,16,0,119,10,32,0,0,10,32,11,17,7,14,21,9,6,8,8,26,31
304,Jermaine O'Neal,C,28,IND,69,69,2459,498,1141,0,7,498,1134,343,447,153,508,661,167,50,182,203,232,1339
305,Shaquille O'Neal*,C,34,MIA,40,39,1135,283,479,0,0,283,479,124,294,97,200,297,79,8,55,95,139,690
306,Fabricio Oberto,PF,31,SAS,79,33,1365,158,281,0,0,158,281,33,51,131,237,368,68,25,24,69,213,349
307,Lamar Odom,PF,27,LAL,56,56,2202,319,681,54,182,265,499,198,283,102,445,547,270,53,32,163,182,890
308,Emeka Okafor,C,24,CHA,67,65,2329,394,740,0,0,394,740,175,295,258,499,757,80,57,172,111,210,963
309,Mehmet Okur,C,27,UTA,80,80,2664,490,1061,129,336,361,725,296,387,160,419,579,156,36,38,125,257,1405
310,Kevin Ollie,PG,34,PHI,53,23,919,81,187,0,2,81,185,37,45,8,66,74,130,21,1,47,76,199
311,Michael Olowokandi,C,31,BOS,24,0,234,19,46,0,0,19,46,2,3,14,34,48,5,8,13,17,48,40
312,Bo Outlaw,PF,35,ORL,41,0,460,34,51,0,0,34,51,13,22,47,59,106,16,17,6,21,57,81
313,Travis Outlaw,PF,22,POR,67,1,1532,246,567,10,37,236,530,143,181,65,152,217,52,61,74,66,150,645
314,Zaza Pachulia,C,22,ATL,72,47,2026,291,614,0,1,291,613,293,373,199,301,500,106,77,36,162,267,875
315,Scott Padgett,PF,30,TOT,31,0,231,16,56,8,33,8,23,6,13,16,38,54,8,5,3,9,35,46
316,Jannero Pargo,PG,27,NOK,82,7,1710,283,692,81,209,202,483,104,122,20,160,180,203,53,4,122,121,751
317,Anthony Parker,SG,31,TOR,73,73,2437,328,687,115,261,213,426,132,158,60,223,283,153,73,11,71,135,903
318,Smush Parker,PG,25,LAL,82,80,2457,342,785,110,301,232,484,113,175,45,161,206,228,119,10,153,211,907
319,Tony Parker,PG,24,SAS,77,77,2499,570,1096,15,38,555,1058,274,350,34,216,250,420,82,6,191,137,1429
320,Ruben Patterson,SF,31,MIL,81,53,2508,475,867,3,19,472,848,241,376,190,250,440,232,110,25,199,232,1194
321,Chris Paul,PG,21,NOK,64,64,2353,381,871,50,143,331,728,292,357,54,226,280,569,118,3,161,154,1104
322,Sasha Pavlović,SG,23,CLE,67,28,1534,222,490,60,148,162,342,100,126,23,135,158,105,55,17,102,145,604
323,Gary Payton*,PG,38,MIA,68,28,1503,144,366,32,123,112,243,38,57,18,114,132,201,43,3,66,117,358
324,Kendrick Perkins,C,22,BOS,72,53,1576,132,269,0,3,132,266,60,100,113,259,372,94,23,96,113,214,324
325,Morris Peterson,SF,29,TOR,71,12,1515,222,517,106,295,116,222,84,123,32,205,237,47,45,12,53,126,634
326,Johan Petro,C,21,SEA,81,13,1510,226,438,0,0,226,438,50,77,92,243,335,45,39,47,82,237,502
327,Eric Piatkowski,SG,36,PHO,11,0,73,9,25,7,18,2,7,2,2,2,7,9,4,0,1,5,6,27
328,Paul Pierce,SG,29,BOS,47,46,1740,373,850,107,275,266,575,320,402,39,238,277,194,48,13,152,122,1173
329,Mickaël Piétrus,SF,24,GSW,72,38,1937,286,586,93,240,193,346,136,210,81,246,327,62,48,55,105,220,801
330,Kevinn Pinkney,PF,23,BOS,6,0,100,12,27,1,2,11,25,6,9,7,8,15,5,3,3,4,12,31
331,Scot Pollard,C,31,CLE,24,0,109,11,26,0,0,11,26,2,4,15,16,31,3,4,1,4,27,24
332,James Posey,SF,30,MIA,71,19,1919,186,432,97,259,89,173,81,98,66,291,357,94,71,23,55,193,550
333,Vitaly Potapenko,C,31,SAC,3,0,13,0,4,0,0,0,4,0,0,0,2,2,0,0,0,2,3,0
334,Leon Powe,C,23,BOS,63,2,720,79,177,0,2,79,175,106,144,97,118,215,10,14,22,47,104,264
335,Josh Powell,PF,24,TOT,37,0,353,43,93,0,0,43,93,30,42,24,64,88,21,5,12,29,61,116
336,Roger Powell,SF,24,UTA,3,0,13,0,3,0,1,0,2,2,2,3,0,3,0,0,0,3,2,2
337,Ronnie Price,PG,23,SAC,58,1,563,67,172,21,65,46,107,37,55,15,56,71,48,28,4,33,64,192
338,Tayshaun Prince,SF,26,DET,82,82,3001,459,997,81,210,378,787,172,224,144,285,429,227,51,55,98,116,1171
339,Joel Przybilla,C,27,POR,43,43,701,37,78,0,0,37,78,10,27,59,109,168,12,10,67,40,124,84
340,Chris Quinn,PG,23,MIA,42,1,408,48,131,20,57,28,74,25,37,6,24,30,65,15,0,21,32,141
341,Vladimir Radmanović,PF,26,LAL,55,15,986,134,316,40,118,94,198,53,73,53,127,180,66,25,18,69,125,361
342,Shavlik Randolph,PF,23,PHI,13,6,179,23,48,0,0,23,48,12,22,19,35,54,4,7,10,9,23,58
343,Zach Randolph,PF,25,POR,68,67,2425,600,1286,14,48,586,1238,394,481,199,489,688,147,53,15,215,184,1608
344,Theo Ratliff,C,33,BOS,2,2,44,1,3,0,0,1,3,3,4,2,5,7,0,1,3,1,6,5
345,Allan Ray,SG,22,BOS,47,5,710,100,259,48,116,52,143,42,55,18,51,69,43,20,3,42,85,290
346,Michael Redd,SF,27,MIL,53,53,2036,477,1025,117,306,360,719,345,416,42,154,196,124,63,9,122,78,1416
347,J.J. Redick,PG,22,ORL,42,0,622,80,195,38,98,42,97,54,60,10,42,52,36,12,0,21,52,252
348,Justin Reed,PF,25,MIN,41,3,318,40,107,0,0,40,107,26,30,15,31,46,17,5,3,22,44,106
349,Jared Reiner,C,24,MIL,27,2,244,15,43,0,0,15,43,3,10,21,50,71,13,5,6,14,45,33
350,Jason Richardson,SG,26,GSW,51,49,1675,306,734,110,301,196,433,92,140,71,188,259,172,54,32,82,129,814
352,Quentin Richardson,SF,26,NYK,49,47,1621,228,545,97,258,131,287,83,120,65,287,352,108,36,7,70,133,636
353,Luke Ridnour,PG,25,SEA,71,58,2091,301,695,49,139,252,556,128,159,28,136,164,368,83,19,156,181,779
354,Anthony Roberson,PG,23,GSW,20,1,227,44,104,21,55,23,49,2,3,2,19,21,10,12,0,13,27,111
355,Lawrence Roberts,PF,24,MEM,54,18,969,94,208,0,2,94,206,95,131,101,160,261,30,36,13,36,133,283
357,Clifford Robinson,C,40,NJN,50,1,955,81,218,25,66,56,152,16,36,31,91,122,51,12,23,30,98,203
358,Nate Robinson,PG,22,NYK,64,5,1356,227,523,83,213,144,310,108,139,55,97,152,90,50,6,72,160,645
359,Sergio Rodríguez,PG,20,POR,67,1,862,101,239,24,85,77,154,21,26,20,71,91,218,35,2,77,72,247
360,Rajon Rondo,PG,20,BOS,78,25,1831,188,450,6,29,182,421,119,184,74,218,292,297,128,8,137,181,501
361,Jalen Rose,SF,34,PHO,29,0,246,38,86,21,47,17,39,11,12,3,20,23,16,5,2,9,22,108
362,Malik Rose,PF,32,NYK,65,2,810,74,186,2,8,72,178,42,52,47,128,175,65,26,9,65,120,192
363,Quinton Ross,SG,25,LAC,81,43,1700,177,379,2,10,175,369,68,87,60,130,190,86,70,32,33,179,424
364,Brandon Roy,SG,22,POR,57,55,2015,349,765,55,146,294,619,202,241,58,192,250,230,67,10,116,139,955
365,Michael Ruffin,PF,30,WAS,30,0,271,5,18,0,0,5,18,7,19,35,27,62,6,6,8,12,43,17
366,John Salmons,SG,27,SAC,79,19,2135,236,517,40,112,196,405,159,204,47,217,264,254,73,27,119,177,671
367,Jamal Sampson,C,23,DEN,22,3,125,9,14,0,1,9,13,6,14,15,33,48,5,2,7,10,17,24
368,Brian Scalabrine,PF,28,BOS,54,17,1027,77,191,44,110,33,81,18,23,24,81,105,59,23,18,44,130,216
369,Luke Schenscher,C,24,POR,11,0,118,7,23,0,0,7,23,5,7,10,15,25,1,2,4,4,25,19
370,Thabo Sefolosha,SG,22,CHI,71,4,868,109,256,15,42,94,214,23,45,35,118,153,60,33,11,60,100,256
371,Mouhamed Sene,C,20,SEA,28,3,169,18,49,0,0,18,49,17,29,16,29,45,0,3,12,11,33,53
372,Wayne Simien,PF,23,MIA,8,0,93,9,23,0,0,9,23,5,7,5,6,11,4,2,0,3,13,23
373,Cedric Simmons,PF,21,NOK,43,4,534,55,132,0,0,55,132,16,33,44,63,107,12,8,23,22,75,126
374,James Singleton,PF,25,LAC,53,0,376,30,82,3,14,27,68,22,29,36,70,106,17,15,17,17,45,85
375,Brian Skinner,PF,30,MIL,67,44,1523,124,253,0,0,124,253,46,79,106,279,385,58,18,64,75,195,294
376,Uroš Slokar,C,23,TOR,20,0,72,14,26,1,2,13,24,9,13,7,7,14,1,1,2,9,11,38
377,Craig Smith,PF,23,MIN,82,5,1537,246,463,0,6,246,457,116,186,149,267,416,49,51,18,74,223,608
378,J.R. Smith,SG,21,DEN,63,24,1471,284,644,149,382,135,262,102,126,30,113,143,91,49,9,85,147,819
379,Joe Smith,PF,31,TOT,65,11,1503,214,477,0,5,214,472,125,148,120,280,400,49,37,27,76,148,553
380,Josh Smith,SF,21,ATL,72,72,2647,436,993,38,152,398,841,268,387,165,456,621,236,101,207,227,241,1178
381,Steven Smith,PF,23,PHI,8,0,28,2,8,0,0,2,8,1,2,1,5,6,0,1,0,2,4,5
382,Eric Snow,PG,33,CLE,82,45,1929,135,324,0,4,135,320,72,113,35,153,188,330,55,16,111,185,342
383,Kirk Snyder,SF,23,HOU,39,1,563,66,146,11,44,55,102,49,75,17,66,83,39,11,12,26,51,192
384,Darius Songaila,PF,28,WAS,37,1,700,118,225,0,2,118,223,46,54,44,90,134,38,17,10,43,105,282
385,Pape Sow,C,25,TOR,7,0,34,3,9,0,0,3,9,4,6,6,5,11,2,1,1,1,2,10
386,Vassilis Spanoulis,SG,24,HOU,31,0,272,23,72,5,29,18,43,34,42,5,17,22,28,7,1,29,33,85
387,Jerry Stackhouse,SF,32,DAL,67,8,1615,280,654,62,162,218,492,182,215,39,106,145,187,51,10,117,78,804
388,DeShawn Stevenson,SG,25,WAS,82,82,2419,347,753,74,183,273,570,152,216,55,161,216,218,65,19,119,155,920
389,Peja Stojaković,SF,29,NOK,13,13,425,83,196,34,84,49,112,31,38,11,43,54,11,8,4,19,29,231
390,Damon Stoudamire,PG,33,MEM,62,51,1501,171,437,59,175,112,262,66,83,31,108,139,299,47,2,101,95,467
391,Salim Stoudamire,SG,24,ATL,61,0,1034,177,425,56,155,121,270,61,68,6,68,74,61,21,2,55,88,471
392,Amar'e Stoudemire,C,24,PHO,82,78,2689,607,1055,0,3,607,1052,457,585,222,564,786,84,78,110,232,295,1671
393,Mike Sweetney,C,24,CHI,48,0,385,58,134,0,0,58,134,37,66,45,75,120,28,9,11,42,79,153
394,Stromile Swift,C,27,MEM,54,18,1029,161,346,0,5,161,341,97,134,85,165,250,17,30,62,69,146,419
395,Wally Szczerbiak,SF,29,BOS,32,19,900,161,388,44,106,117,282,113,126,16,82,98,55,18,3,54,65,479
396,Donell Taylor,SG,24,WAS,47,1,369,56,140,3,17,53,123,11,21,14,39,53,45,17,3,25,34,126
397,Maurice Taylor,PF,30,SAC,12,2,103,8,28,0,0,8,28,8,13,10,18,28,5,4,1,6,16,24
398,Sebastian Telfair,PG,21,BOS,78,30,1578,176,474,37,128,139,346,90,110,17,91,108,218,43,11,98,166,479
399,Jason Terry,SG,29,DAL,81,80,2846,514,1063,162,370,352,693,160,199,41,190,231,422,81,17,152,170,1350
400,Etan Thomas,C,28,WAS,65,32,1246,159,277,0,0,159,277,77,138,136,241,377,29,22,89,71,162,395
401,Kenny Thomas,PF,29,SAC,62,53,1412,146,303,0,1,146,302,39,76,134,243,377,76,43,16,90,141,331
402,Kurt Thomas,C,34,PHO,67,13,1208,126,259,0,1,126,258,56,71,86,293,379,24,24,29,35,156,308
403,Tim Thomas,PF,29,LAC,76,24,2054,299,723,136,356,163,367,102,144,63,315,378,171,55,28,106,228,836
404,Tyrus Thomas,PF,20,CHI,72,4,966,134,282,0,2,134,280,106,175,89,180,269,40,46,76,94,162,374
405,Dijon Thompson,SF,23,ATL,6,0,50,6,15,0,2,6,13,5,6,3,5,8,2,0,0,1,2,17
406,Jamaal Tinsley,PG,28,IND,72,72,2243,346,889,61,193,285,696,172,239,60,180,240,494,117,25,200,190,925
407,Jake Tsakalidis,C,27,TOT,36,7,390,29,72,0,0,29,72,26,39,42,62,104,5,8,12,24,51,84
408,P.J. Tucker,SF,21,TOR,17,0,83,11,22,0,0,11,22,8,14,11,12,23,3,2,0,6,12,30
409,Ronny Turiaf,C,24,LAL,72,1,1087,147,268,0,1,147,267,89,134,88,171,259,63,17,78,52,202,383
410,Hedo Türkoğlu,SF,27,ORL,73,73,2268,345,823,109,281,236,542,171,219,57,236,293,233,70,16,143,221,970
411,Ime Udoka,SF,29,POR,75,75,2144,237,514,89,219,148,295,66,89,95,184,279,112,71,17,73,207,629
412,Beno Udrih,PG,24,SAS,73,1,948,127,344,33,115,94,229,53,60,11,71,82,122,27,1,56,70,340
413,Anderson Varejão,C,24,CLE,81,6,1932,191,401,0,9,191,392,165,268,191,354,545,75,76,52,67,269,547
414,Jacque Vaughn,PG,31,SAS,64,4,760,71,167,1,2,70,165,49,65,8,60,68,131,24,2,40,74,192
415,Charlie Villanueva,PF,22,MIL,39,17,984,180,383,29,86,151,297,73,89,62,166,228,36,24,12,54,108,462
416,Marcus Vinicius,SF,22,NOK,13,0,103,7,15,3,7,4,8,5,7,2,9,11,5,2,1,6,10,22
417,Jake Voskuhl,C,29,CHA,73,9,1043,121,255,0,0,121,255,77,113,84,172,256,44,30,24,56,199,319
418,Sasha Vujačić,SG,22,LAL,73,4,935,105,268,60,161,45,107,43,49,28,79,107,64,41,1,30,103,313
419,Dwyane Wade,SG,25,MIA,51,50,1931,472,962,21,79,451,883,432,535,51,188,239,384,107,62,216,117,1397
420,Von Wafer,SF,21,LAC,1,0,1,0,1,0,1,0,0,0,0,0,0,0,0,0,0,0,0,0
421,Dajuan Wagner,SG,23,GSW,1,0,7,1,1,1,1,0,0,1,2,0,0,0,1,0,0,1,1,4
422,Antoine Walker,PF,30,MIA,78,15,1818,265,668,84,305,181,363,46,105,92,247,339,130,48,17,141,173,660
423,Ben Wallace,C,32,CHI,77,77,2697,192,424,1,5,191,419,109,267,303,518,821,186,111,156,101,153,494
424,Gerald Wallace,SF,24,CHA,72,71,2640,478,952,39,120,439,832,309,447,142,376,518,185,144,69,160,209,1304
425,Rasheed Wallace,C,32,DET,75,72,2419,357,843,104,296,253,547,108,137,90,453,543,127,75,118,94,225,926
426,Luke Walton,SF,26,LAL,60,60,1982,264,557,48,124,216,433,108,145,87,215,302,257,60,21,118,117,684
427,Hakim Warrick,PF,24,MEM,82,43,2152,373,712,0,8,373,704,299,388,130,290,420,75,43,30,161,232,1045
428,Earl Watson,PG,27,SEA,77,25,2152,263,687,92,280,171,407,108,147,34,151,185,437,99,23,167,152,726
429,Chris Webber,PF,33,TOT,61,60,1821,289,639,4,11,285,628,102,160,124,313,437,188,60,41,107,143,684
430,Martell Webster,SF,20,POR,82,27,1759,195,492,91,250,104,242,93,132,43,197,240,52,35,19,76,126,574
431,Bonzi Wells,SF,30,HOU,28,1,590,85,207,1,7,84,200,46,82,26,94,120,31,24,13,57,62,217
432,David Wesley,SG,36,CLE,35,5,352,22,75,9,38,13,37,20,28,3,32,35,37,12,4,17,32,73
433,David West,PF,26,NOK,52,52,1900,377,792,8,25,369,767,187,227,126,298,424,114,42,38,98,143,949
434,Delonte West,SG,23,BOS,69,47,2219,306,717,65,178,241,539,168,197,32,176,208,304,74,34,140,152,845
435,James White,SG,24,SAS,6,2,137,18,41,2,7,16,34,12,15,3,17,20,5,3,1,5,7,50
436,Chris Wilcox,PF,24,SEA,82,81,2586,433,819,0,6,433,813,240,351,178,451,629,82,70,38,127,248,1106
437,Damien Wilkins,SF,27,SEA,82,31,2037,262,602,50,122,212,480,150,170,87,142,229,156,92,16,116,157,724
438,Mike Wilks,PG,27,SEA,47,4,534,66,141,5,15,61,126,33,42,15,39,54,79,15,4,31,53,170
439,Aaron Williams,PF,35,LAC,38,7,374,29,53,0,1,29,52,18,22,27,58,85,7,7,14,18,56,76
440,Alvin Williams,PG,32,LAC,2,0,10,0,2,0,1,0,1,2,4,1,0,1,3,2,0,3,0,2
441,Deron Williams,PG,22,UTA,80,80,2950,494,1083,82,255,412,828,227,296,41,226,267,745,78,13,246,254,1297
442,Eric Williams,SF,34,TOT,21,0,121,19,47,8,19,11,28,8,14,3,14,17,7,3,0,7,12,54
443,Jason Williams,PG,31,MIA,61,55,1865,235,569,100,295,135,274,94,103,18,123,141,322,58,1,100,68,664
444,Justin Williams,C,22,SAC,26,1,333,54,88,0,1,54,87,23,63,51,64,115,2,5,16,15,51,131
445,Lou Williams,PG,20,PHI,61,0,688,93,211,12,37,81,174,64,92,17,53,70,110,22,1,46,42,262
446,Marcus Williams,PG,21,NJN,79,2,1315,208,526,46,163,162,363,72,85,29,134,163,260,29,2,142,96,534
447,Marvin Williams,PF,20,ATL,64,63,2179,306,706,11,45,295,661,216,265,84,253,337,121,52,30,127,191,839
448,Mo Williams,PG,24,MIL,68,68,2472,468,1049,79,228,389,821,159,186,54,275,329,416,85,6,203,201,1174
449,Shammond Williams,PG,31,LAL,30,0,345,35,86,20,50,15,36,4,6,11,29,40,31,12,0,13,20,94
450,Shawne Williams,SG,20,IND,46,3,556,75,160,19,52,56,108,11,20,33,50,83,22,6,8,24,69,180
451,Shelden Williams,PF,23,ATL,81,31,1514,166,365,2,4,164,361,110,144,131,304,435,44,52,39,96,199,444
452,Corliss Williamson,PF,33,SAC,68,1,1337,236,463,0,2,236,461,148,207,63,158,221,39,29,15,97,183,620
453,Kevin Willis,PF,44,DAL,5,0,43,5,13,0,0,5,13,2,2,2,6,8,1,2,1,2,11,12
454,Metta World Peace,SF,27,SAC,70,65,2641,458,1040,93,260,365,780,307,415,102,352,454,235,149,43,146,205,1316
455,Antoine Wright,SG,22,NJN,63,23,1137,110,251,19,59,91,192,44,73,38,137,175,55,30,10,43,120,283
456,Bracey Wright,SG,22,MIN,19,0,190,24,60,6,20,18,40,13,18,7,14,21,15,9,1,6,6,67
457,Dorell Wright,SF,21,MIA,66,19,1292,162,364,5,34,157,330,64,86,40,232,272,95,41,46,65,112,393
458,Lorenzen Wright,C,31,ATL,67,31,1035,82,183,0,0,82,183,9,32,85,131,216,40,28,28,39,204,173
