Rk,Player,Pos,Age,Tm,G,GS,MP,FG,FGA,3P,3PA,2P,2PA,FT,FTA,ORB,DRB,TRB,AST,STL,BLK,TOV,PF,PTS
1,Shareef Abdur-Rahim,PF,31,SAC,6,0,51,3,14,0,0,3,14,4,4,6,4,10,4,1,0,1,9,10
2,Arron Afflalo,SG,22,DET,75,9,970,99,241,10,48,89,193,68,87,36,101,137,52,31,8,34,83,276
3,Maurice Ager,SG,23,TOT,26,3,165,21,65,3,19,18,46,6,12,4,9,13,8,0,1,6,17,51
4,Blake Ahearn,PG,23,MIA,12,0,177,15,57,10,34,5,23,30,31,1,18,19,19,6,0,16,20,70
5,LaMarcus Aldridge,PF,22,POR,76,76,2649,561,1160,1,7,560,1153,227,298,220,358,578,122,55,94,126,240,1350
6,Malik Allen,PF,29,TOT,73,16,1096,157,327,1,2,156,325,23,25,66,130,196,44,19,31,45,149,338
7,Ray Allen*,SG,32,BOS,73,73,2624,439,986,180,452,259,534,215,237,75,193,268,225,65,16,127,147,1273
8,Tony Allen,SG,26,BOS,75,11,1373,169,389,18,57,151,332,138,181,34,134,168,114,62,21,109,168,494
9,Lance Allred,C,26,CLE,3,0,10,1,4,0,0,1,4,1,2,0,1,1,0,0,0,0,1,3
10,Morris Almond,SG,22,UTA,9,0,39,4,15,1,4,3,11,4,6,0,2,2,3,1,0,2,5,13
11,Rafer Alston,PG,31,HOU,74,74,2526,364,924,143,407,221,517,98,137,28,232,260,392,98,18,160,139,969
12,Lou Amundson,PF,25,PHI,16,0,64,8,16,0,0,8,16,2,7,7,5,12,0,1,1,2,13,18
13,Chris Andersen,C,29,NOH,5,0,34,2,7,0,0,2,7,2,4,2,7,9,0,0,4,1,6,6
14,Derek Anderson,SG,33,CHA,28,0,396,47,125,19,52,28,73,28,38,9,43,52,44,12,1,25,49,141
15,Carmelo Anthony,SF,23,DEN,77,77,2806,728,1481,58,164,670,1317,464,590,178,393,571,259,98,39,253,253,1978
16,Joel Anthony,PF,25,MIA,24,1,498,28,60,0,0,28,60,29,49,38,55,93,3,9,31,17,55,85
17,Gilbert Arenas,PG,26,WAS,13,8,425,78,196,22,78,56,118,74,96,6,45,51,66,23,1,49,30,252
18,Trevor Ariza,SF,22,TOT,35,3,546,69,136,5,18,64,118,49,75,30,78,108,44,31,11,23,45,192
19,Darrell Armstrong,PG,39,NJN,50,2,549,40,110,23,69,17,41,20,30,17,50,67,73,28,2,41,53,123
20,Hilton Armstrong,C,23,NOH,65,3,732,67,148,0,0,67,148,44,70,65,98,163,23,15,34,59,130,178
21,Carlos Arroyo,PG,28,ORL,62,20,1269,157,348,29,84,128,264,87,102,10,103,113,219,26,2,77,85,430
22,Chucky Atkins,SG,33,DEN,24,0,352,42,122,25,79,17,43,4,9,3,28,31,47,9,1,10,27,113
23,James Augustine,PF,23,ORL,25,0,149,18,34,0,0,18,34,4,8,16,14,30,2,5,2,6,18,40
24,Kelenna Azubuike,SG,24,GSW,81,17,1732,261,587,71,195,190,392,99,138,107,217,324,75,45,34,58,159,692
25,Renaldo Balkman,SF,23,NYK,65,0,952,91,186,1,12,90,174,41,95,83,133,216,40,44,30,37,132,224
26,Marcus Banks,PG,26,TOT,36,3,569,86,191,40,102,46,89,27,35,4,41,45,61,14,13,37,65,239
27,Leandro Barbosa,SG,25,PHO,82,12,2421,472,1021,164,422,308,599,175,213,40,191,231,216,75,18,117,195,1283
28,J.J. Barea,PG,23,DAL,44,9,460,71,170,21,54,50,116,28,35,4,43,47,58,14,1,35,48,191
29,Andrea Bargnani,PF,22,TOR,78,53,1861,280,725,90,261,190,464,142,169,50,238,288,89,23,37,88,211,792
30,Matt Barnes,PF,27,GSW,73,18,1414,187,442,53,181,134,261,59,79,94,230,324,139,48,36,85,159,486
31,Andre Barrett,PG,25,LAC,4,0,25,2,5,1,3,1,2,1,2,0,1,1,7,0,0,1,1,6
32,Earl Barron,C,26,MIA,46,15,889,132,327,1,13,131,314,61,87,67,131,198,29,19,8,48,114,326
33,Brent Barry,SF,36,SAS,31,1,554,77,160,48,112,29,48,19,20,12,43,55,54,17,3,18,43,221
34,Brandon Bass,C,22,DAL,79,1,1557,246,493,0,4,246,489,162,197,120,227,347,58,22,48,82,150,654
35,Maceo Baston,PF,32,TOR,15,2,103,17,25,0,0,17,25,7,10,9,17,26,3,2,4,4,20,41
36,Shane Battier,SF,29,HOU,80,78,2907,265,619,139,369,126,250,75,101,131,276,407,155,77,90,78,196,744
37,Marco Belinelli,SG,21,GSW,33,0,241,36,93,16,41,20,52,7,9,3,11,14,15,5,0,12,15,95
38,Charlie Bell,SG,28,MIL,68,5,1628,185,486,74,217,111,269,70,87,31,136,167,210,52,2,76,121,514
39,Raja Bell,SG,31,PHO,75,75,2646,317,753,176,439,141,314,79,91,47,227,274,168,54,27,65,220,889
40,Mike Bibby,PG,29,TOT,48,44,1573,248,603,93,248,155,355,78,100,16,144,160,290,54,4,119,97,667
41,Andris Biedriņš,C,21,GSW,76,59,2078,340,543,0,0,340,543,116,187,256,488,744,75,56,94,85,262,796
42,Chauncey Billups,PG,31,DET,78,78,2522,393,877,137,342,256,535,401,437,42,170,212,529,101,17,160,130,1324
43,Steve Blake,PG,27,POR,81,78,2424,261,640,121,298,140,342,49,64,31,164,195,413,55,4,113,133,692
44,Andray Blatche,PF,21,WAS,82,15,1675,254,536,3,13,251,523,107,154,164,261,425,92,53,114,112,258,618
45,Mark Blount,C,32,MIA,69,46,1542,238,515,17,44,221,471,88,138,69,194,263,41,33,34,70,133,581
46,Keith Bogans,SG,27,ORL,82,35,2198,241,588,148,409,93,179,81,110,42,224,266,104,59,10,53,164,711
47,Andrew Bogut,C,23,MIL,78,78,2720,465,910,0,7,465,903,189,322,245,518,763,199,64,135,172,254,1119
48,Matt Bonner,PF,27,SAS,68,3,853,121,291,46,137,75,154,38,44,53,139,192,32,14,17,39,111,326
49,Josh Boone,PF,23,NJN,70,53,1773,238,434,0,0,238,434,99,217,192,317,509,55,36,61,68,155,575
50,Calvin Booth,C,31,PHI,31,0,204,9,27,0,0,9,27,6,10,6,32,38,8,6,18,4,35,24
51,Carlos Boozer,PF,26,UTA,81,81,2827,709,1297,0,1,709,1296,290,393,197,647,844,233,100,41,210,293,1708
52,Chris Bosh,C,23,TOR,67,67,2425,507,1027,10,25,497,1002,472,559,174,409,583,171,63,67,153,157,1496
53,Bruce Bowen,SF,36,SAS,81,81,2448,174,428,90,215,84,213,45,69,33,201,234,91,54,22,46,177,483
54,Ryan Bowen,SF,32,NOH,53,4,660,49,100,0,1,49,99,16,29,55,45,100,25,32,11,15,77,114
55,Earl Boykins,PG,31,CHA,36,0,577,61,172,14,44,47,128,49,59,9,25,34,96,13,0,41,21,185
56,Elton Brand,PF,28,LAC,8,6,274,52,114,0,0,52,114,37,47,21,43,64,16,3,15,17,21,141
57,Corey Brewer,SF,21,MIN,79,35,1803,182,486,7,36,175,450,88,110,82,210,292,111,76,25,89,188,459
58,Ronnie Brewer,SG,22,UTA,76,76,2088,354,634,11,50,343,584,195,257,97,121,218,134,129,19,69,110,914
59,Primož Brezec,C,28,TOT,50,18,475,44,94,0,0,44,94,24,40,30,51,81,11,3,7,24,83,112
60,Aaron Brooks,PG,23,HOU,51,0,608,93,225,36,109,57,116,42,49,13,43,56,87,13,5,44,69,264
61,Andre Brown,PF,26,MEM,33,1,286,39,78,0,0,39,78,22,49,37,55,92,8,7,4,14,38,100
62,Devin Brown,SG,29,CLE,78,20,1762,217,531,45,146,172,385,107,142,65,198,263,175,52,7,99,144,586
63,Kwame Brown,C,25,TOT,38,15,713,72,142,0,0,72,142,40,98,51,137,188,45,22,23,51,82,184
64,P.J. Brown,PF,38,BOS,18,0,209,14,41,0,1,14,40,11,16,29,39,68,10,5,8,10,29,39
65,Shannon Brown,SG,22,TOT,21,4,240,44,126,9,30,35,96,17,29,6,14,20,17,11,3,24,29,114
66,Kobe Bryant,SG,29,LAL,82,82,3192,775,1690,150,415,625,1275,623,742,94,423,517,441,151,40,257,227,2323
67,Greg Buckner,SG,31,MIN,31,4,520,45,117,15,50,30,67,19,22,10,55,65,39,21,2,29,63,124
68,Caron Butler,SF,27,WAS,58,58,2314,439,943,66,185,373,758,236,262,93,295,388,284,128,20,150,160,1180
69,Rasual Butler,SF,28,NOH,51,8,875,91,260,44,133,47,127,26,31,16,84,100,36,15,21,10,66,252
70,Andrew Bynum,C,20,LAL,35,25,1008,189,297,0,0,189,297,82,118,105,251,356,61,12,72,52,98,460
71,José Calderón,PG,26,TOR,82,56,2484,367,707,79,184,288,523,109,120,34,202,236,678,87,6,126,134,922
72,Marcus Camby,C,33,DEN,79,79,2758,286,635,6,20,280,615,143,202,230,807,1037,259,85,285,118,216,721
73,Brian Cardinal,PF,30,MEM,37,1,440,43,126,25,81,18,45,13,19,26,70,96,22,10,2,23,62,124
74,Rodney Carney,SF,23,PHI,70,6,1039,158,392,38,120,120,272,55,81,50,99,149,32,39,23,34,96,409
75,Matt Carroll,SG,27,CHA,80,18,2016,252,589,105,241,147,348,111,138,33,193,226,73,46,19,58,187,720
76,Anthony Carter,PG,32,DEN,70,67,1960,218,476,45,129,173,347,64,85,27,173,200,388,107,28,124,172,545
77,Vince Carter,SG,31,NJN,76,72,2959,587,1287,98,273,489,1014,350,429,112,341,453,389,93,33,181,241,1622
78,Sam Cassell,PG,38,TOT,55,34,1274,233,532,23,76,210,456,127,144,17,119,136,214,37,6,97,98,616
79,Tyson Chandler,C,25,NOH,79,79,2783,377,605,0,1,377,604,175,295,322,606,928,81,45,84,136,243,929
80,Wilson Chandler,SF,20,NYK,35,16,685,106,242,9,30,97,212,34,54,38,89,127,33,15,16,27,83,255
81,Josh Childress,SF,24,ATL,76,0,2274,327,573,22,60,305,513,222,275,174,199,373,117,71,43,98,129,898
82,Jarron Collins,C,29,UTA,70,9,702,36,82,0,1,36,81,46,74,40,76,116,37,10,6,22,106,118
83,Jason Collins,C,29,TOT,74,26,1172,53,113,0,1,53,112,34,74,64,114,178,25,23,25,48,194,140
84,Mardy Collins,SG,23,NYK,46,8,634,57,175,8,32,49,143,23,38,19,56,75,89,24,8,56,56,145
85,Nick Collison,PF,27,SEA,78,35,2223,322,641,0,2,322,639,123,167,254,476,730,113,47,60,118,250,767
86,Mike Conley,PG,20,MEM,53,46,1381,189,442,30,91,159,351,90,123,21,118,139,222,44,2,89,85,498
87,Brian Cook,PF,27,TOT,51,2,629,88,234,43,115,45,119,19,21,28,81,109,27,13,12,39,93,238
88,Daequan Cook,SG,20,MIA,59,19,1441,196,514,79,238,117,276,47,57,20,157,177,75,23,9,63,157,518
89,Jamal Crawford,SG,27,NYK,80,80,3190,570,1391,176,494,394,897,329,381,37,170,207,398,81,17,192,144,1645
90,Javaris Crittenton,SG,20,TOT,50,0,679,98,233,10,37,88,196,72,104,27,83,110,51,19,2,55,47,278
91,Austin Croshere,PF,32,GSW,44,0,457,61,137,22,61,39,76,29,32,33,71,104,30,8,6,22,60,173
92,Eddy Curry,C,25,NYK,59,58,1530,297,544,0,0,297,544,187,300,111,164,275,32,14,29,126,157,781
93,Samuel Dalembert,C,26,PHI,82,82,2724,339,661,0,1,339,660,186,263,304,545,849,45,40,192,155,269,864
94,Erick Dampier,C,32,DAL,72,64,1755,178,277,0,0,178,277,84,146,207,332,539,63,24,106,80,226,440
95,Antonio Daniels,PG,32,WAS,71,63,2161,205,447,17,74,188,373,170,219,23,180,203,340,69,2,91,78,597
96,Marquis Daniels,SG,27,IND,74,1,1546,241,561,27,102,214,459,97,139,66,146,212,137,79,18,112,121,606
97,Jermareo Davidson,SF,23,CHA,38,2,322,51,125,0,0,51,125,18,28,21,41,62,13,7,15,17,46,120
98,Baron Davis,PG,28,GSW,82,82,3196,650,1526,173,525,477,1001,318,424,96,289,385,623,191,43,232,247,1791
99,Glen Davis,C,22,BOS,69,1,940,107,221,0,0,107,221,99,150,95,113,208,28,31,20,65,160,313
100,Paul Davis,PF,23,LAC,22,1,194,24,65,0,0,24,65,6,10,25,22,47,10,6,6,9,33,54
101,Ricky Davis,SF,28,MIA,82,47,2963,420,971,135,333,285,638,155,197,55,298,353,276,87,14,191,187,1130
102,Carlos Delfino,SG,25,TOR,82,0,1928,251,632,120,314,131,318,116,156,66,293,359,145,69,11,75,177,738
103,Luol Deng,SF,22,CHI,63,59,2128,429,896,8,22,421,874,204,265,136,258,394,155,57,29,120,117,1070
104,Boris Diaw,PF,25,PHO,82,19,2308,308,646,13,41,295,605,96,129,97,281,378,317,61,39,155,166,725
105,Yakhouba Diawara,SG,25,DEN,54,14,542,55,134,21,66,34,68,22,31,23,39,62,37,8,3,16,61,153
106,Guillermo Díaz,SG,22,LAC,6,0,18,1,4,0,1,1,3,3,5,2,0,2,1,0,0,0,0,5
107,Dan Dickau,PG,29,LAC,67,8,1040,124,296,36,108,88,188,68,82,13,84,97,172,32,3,55,108,352
108,Kaniel Dickens,PF,29,CLE,5,0,12,1,3,0,0,1,3,0,0,0,1,1,1,0,1,0,1,2
109,Travis Diener,PG,25,IND,66,21,1356,159,430,74,233,85,197,64,71,26,89,115,251,35,4,55,107,456
110,Ike Diogu,PF,24,IND,30,1,305,64,134,0,0,64,134,40,47,38,47,85,10,7,3,20,43,168
111,DeSagana Diop,C,26,TOT,79,23,1295,94,180,0,0,94,180,38,70,160,232,392,40,26,88,58,146,226
112,Juan Dixon,PG,29,TOT,53,0,668,106,258,30,72,76,186,21,26,15,60,75,97,21,2,54,62,263
113,Michael Doleac,C,30,MIN,24,8,257,28,63,0,0,28,63,1,2,16,33,49,7,10,10,12,44,57
114,Keyon Dooling,PG,27,ORL,72,1,1334,198,423,22,65,176,358,163,193,7,94,101,133,36,5,61,131,581
115,Quincy Douby,PG,23,SAC,74,0,876,132,335,42,122,90,213,48,52,17,66,83,53,30,12,59,80,354
116,Jared Dudley,PF,22,CHA,73,14,1384,163,348,9,41,154,307,87,118,121,165,286,81,55,10,50,128,422
117,Chris Duhon,PG,25,CHI,66,18,1490,133,344,54,155,79,189,65,80,19,97,116,263,48,2,71,92,385
118,Tim Duncan,C,31,SAS,78,78,2651,585,1178,0,4,585,1174,338,463,237,644,881,218,56,152,178,185,1508
119,Mike Dunleavy,SG,27,IND,82,82,2953,532,1117,165,389,367,728,336,403,59,365,424,288,86,31,190,208,1565
120,Ronald Dupree,SF,27,TOT,5,0,21,1,3,0,0,1,3,2,2,1,7,8,1,1,0,0,0,4
121,Kevin Durant,SG,19,SEA,80,80,2768,587,1366,59,205,528,1161,391,448,70,278,348,192,78,75,232,122,1624
122,Monta Ellis,SG,22,GSW,81,72,3071,652,1227,12,52,640,1175,320,417,133,271,404,315,124,27,173,195,1636
123,Francisco Elson,C,31,TOT,63,5,813,92,236,0,1,92,235,26,37,50,150,200,24,15,20,47,96,210
124,Melvin Ely,C,29,NOH,52,1,621,85,180,0,0,85,180,32,58,28,117,145,22,7,18,42,79,202
125,Maurice Evans,SG,29,TOT,75,47,1720,262,545,81,209,181,336,59,83,92,126,218,81,46,10,40,142,664
126,Reggie Evans,PF,27,PHI,81,61,1879,152,346,1,1,151,345,120,257,224,387,611,65,86,8,108,213,425
127,Jordan Farmar,PG,21,LAL,82,0,1690,291,631,114,307,177,324,53,78,39,144,183,225,77,5,108,105,749
128,Nick Fazekas,PF,22,TOT,26,0,269,46,82,0,2,46,80,15,22,34,55,89,11,8,11,13,25,107
129,Raymond Felton,PG,23,CHA,79,79,2972,412,997,56,200,356,797,260,325,37,199,236,583,96,12,213,184,1140
130,Kyrylo Fesenko,C,21,UTA,9,0,70,6,16,0,0,6,16,2,4,14,11,25,2,0,3,8,19,14
131,Michael Finley,SG,34,SAS,82,61,2204,315,761,132,357,183,404,64,80,27,227,254,114,29,10,56,93,826
132,Derek Fisher,PG,33,LAL,82,82,2249,339,777,112,276,227,501,166,188,24,146,170,239,86,3,90,188,956
133,T.J. Ford,PG,24,TOR,51,26,1199,246,524,15,51,231,473,110,125,23,77,100,313,54,0,102,93,617
134,Jeff Foster,C,31,IND,77,52,1884,205,373,0,3,205,370,86,145,264,404,668,129,56,32,62,221,496
135,Randy Foye,PG,24,MIN,39,31,1259,198,462,61,148,137,314,53,65,13,115,128,164,36,3,79,102,510
136,Adonal Foyle,C,32,ORL,82,0,774,70,153,0,0,70,153,16,34,71,137,208,18,16,45,32,94,156
137,Richie Frahm,SG,30,LAC,10,2,163,20,54,7,25,13,29,0,2,4,10,14,8,2,0,6,7,47
138,Steve Francis,PG,30,HOU,10,3,199,19,57,4,17,15,40,13,23,8,15,23,30,9,5,14,25,55
139,Channing Frye,C,24,POR,78,20,1342,221,453,3,10,218,443,85,109,107,247,354,57,29,27,55,208,530
140,Dan Gadzuric,C,29,MIL,51,4,534,64,154,0,1,64,153,33,63,67,77,144,11,20,24,34,83,161
141,Jorge Garbajosa,PF,30,TOR,7,0,74,8,25,6,16,2,9,0,0,2,13,15,3,3,0,1,2,22
142,Francisco García,SF,26,SAC,79,20,2096,348,752,113,289,235,463,162,208,52,212,264,128,96,50,128,232,971
143,Thomas Gardner,SG,22,CHI,4,0,45,9,23,3,12,6,11,0,2,3,1,4,1,0,0,4,4,21
144,Kevin Garnett,PF,31,BOS,71,71,2328,534,990,0,11,534,979,269,336,135,520,655,244,100,89,138,163,1337
145,Pat Garrity,PF,31,ORL,31,0,284,27,80,8,37,19,43,4,5,9,35,44,13,6,1,17,35,66
146,Pau Gasol,C,27,TOT,66,66,2351,475,890,4,16,471,874,292,362,155,398,553,211,30,98,124,139,1246
147,Rudy Gay,SF,21,MEM,81,81,3000,625,1355,134,387,491,968,248,316,140,359,499,158,111,79,190,230,1632
148,Mickaël Gelabale,SG,24,SEA,39,0,465,69,157,16,37,53,120,14,18,16,42,58,33,10,9,27,31,168
149,Devean George,SF,30,DAL,53,4,821,74,207,22,68,52,139,24,34,28,109,137,35,19,13,24,90,194
150,Daniel Gibson,PG,21,CLE,58,26,1765,201,465,118,268,83,197,85,105,30,104,134,145,47,14,76,163,605
151,Eddie Gill,PG,29,TOT,14,1,154,12,31,5,15,7,16,9,9,1,21,22,22,7,2,9,18,38
152,Manu Ginóbili,SG,30,SAS,74,23,2299,453,984,156,389,297,595,380,442,63,291,354,332,109,33,200,173,1442
153,Gordan Giriček,SG,30,TOT,56,0,831,133,302,36,99,97,203,23,26,16,80,96,62,24,4,52,82,325
154,Ryan Gomes,PF,25,MIN,82,74,2434,392,857,59,179,333,678,190,229,133,342,475,145,65,10,96,154,1033
155,Drew Gooden,PF,26,TOT,69,65,2122,332,740,0,6,332,734,162,215,175,415,590,81,48,53,122,203,826
156,Ben Gordon,SG,24,CHI,72,27,2291,464,1069,142,346,322,723,266,293,40,181,221,213,55,8,150,171,1336
157,Marcin Gortat,C,23,ORL,6,0,41,8,17,0,0,8,17,2,3,8,8,16,2,1,1,2,4,18
158,Joey Graham,SF,25,TOR,38,3,331,49,113,2,3,47,110,38,45,18,49,67,15,3,0,23,47,138
159,Stephen Graham,SF,25,IND,22,0,128,34,58,7,14,27,44,12,16,4,18,22,9,4,1,10,14,87
160,Danny Granger,SF,24,IND,80,80,2876,537,1205,171,423,366,782,322,378,93,393,486,166,95,84,171,290,1567
161,Aaron Gray,C,23,CHI,61,1,613,103,204,0,1,103,203,56,99,70,98,168,41,21,16,57,117,262
162,Gerald Green,SF,22,TOT,30,0,362,52,151,15,39,37,112,34,41,13,51,64,29,8,4,32,45,153
163,Jeff Green,SF,21,SEA,80,52,2253,320,749,21,76,299,673,177,238,101,278,379,119,46,49,158,198,838
165,Willie Green,SG,26,PHI,74,74,1970,379,870,51,179,328,691,112,148,32,150,182,151,54,22,109,119,921
166,Orien Greene,SG,25,SAC,7,2,61,3,11,0,1,3,10,0,0,0,6,6,3,3,1,7,9,6
168,Richard Hamilton,SG,29,DET,72,72,2424,499,1030,62,141,437,889,184,221,75,160,235,299,73,10,132,171,1244
169,Anfernee Hardaway,SF,36,MIA,16,8,325,22,60,8,19,14,41,8,9,3,32,35,35,19,1,13,24,60
170,Matt Harpring,SF,31,UTA,76,0,1374,237,474,2,10,235,464,146,205,96,144,240,82,45,14,95,162,622
171,Al Harrington,C,27,GSW,81,59,2190,401,923,153,408,248,515,147,190,107,332,439,132,74,16,90,266,1102
172,Othella Harrington,C,34,CHA,22,0,166,18,42,0,0,18,42,10,16,11,31,42,4,1,4,11,34,46
173,Devin Harris,PG,24,TOT,64,61,2022,321,693,56,167,265,526,248,301,28,145,173,369,90,10,161,190,946
174,Mike Harris,PF,24,HOU,17,0,159,27,54,0,2,27,52,8,13,24,30,54,3,6,3,9,16,62
175,David Harrison,C,25,IND,55,0,702,90,170,0,0,90,170,49,96,43,75,118,14,20,59,58,164,229
176,Jason Hart,PG,29,UTA,57,0,606,58,180,11,31,47,149,38,45,5,50,55,86,30,3,28,75,165
177,Udonis Haslem,PF,27,MIA,49,48,1805,237,507,0,0,237,507,115,142,107,336,443,68,39,18,67,145,589
178,Trenton Hassell,SG,28,TOT,63,6,773,57,135,2,9,55,126,7,10,20,63,83,41,13,3,22,90,123
179,Spencer Hawes,C,19,SAC,71,8,931,146,318,4,21,142,297,38,58,68,162,230,44,14,40,56,128,334
180,Chuck Hayes,PF,24,HOU,79,44,1575,113,221,0,3,113,218,11,24,132,295,427,91,85,43,62,212,237
181,Jarvis Hayes,SF,26,DET,82,1,1287,217,504,73,194,144,310,45,60,35,143,178,62,47,6,47,137,552
182,Brendan Haywood,C,28,WAS,80,80,2228,316,599,0,0,316,599,216,294,273,303,576,71,31,133,108,216,848
183,Luther Head,SG,25,HOU,73,17,1379,206,477,79,225,127,252,66,81,18,117,135,138,44,9,70,75,557
184,Walter Herrmann,PF,28,TOT,45,0,373,56,144,20,64,36,80,21,25,22,51,73,18,7,1,12,24,153
185,Nenê Hilário,PF,25,DEN,16,1,266,29,71,0,1,29,70,27,49,30,57,87,15,9,14,21,46,85
186,Grant Hill*,SF,35,PHO,70,68,2222,358,712,33,104,325,608,170,196,74,279,353,203,65,56,96,153,919
187,Kirk Hinrich,PG,27,CHI,75,72,2380,330,797,84,240,246,557,118,142,28,216,244,452,87,19,157,224,862
188,Ryan Hollins,PF,23,CHA,60,1,532,46,94,0,0,46,94,55,82,53,54,107,14,10,30,25,96,147
189,Al Horford,C,21,ATL,81,77,2540,333,668,0,5,333,663,155,212,248,537,785,124,60,76,137,267,821
190,Robert Horry,PF,37,SAS,45,5,583,38,119,18,70,20,49,18,28,35,74,109,47,21,19,22,55,112
191,Eddie House,PG,29,BOS,78,2,1480,217,531,117,298,100,233,33,36,19,148,167,152,59,10,76,114,584
192,Dwight Howard,C,22,ORL,82,82,3088,583,974,0,4,583,970,529,897,279,882,1161,110,74,176,263,274,1695
193,Josh Howard,SF,27,DAL,76,76,2757,567,1247,67,210,500,1037,312,384,120,412,532,164,59,32,114,202,1513
194,Juwan Howard,PF,34,DAL,50,0,353,23,64,0,0,23,64,11,14,21,60,81,17,5,2,17,62,57
195,Troy Hudson,PG,31,GSW,9,0,93,9,31,4,12,5,19,6,6,0,7,7,9,3,0,7,4,28
197,Kris Humphries,PF,22,TOR,70,0,925,161,333,0,2,161,331,75,124,90,169,259,28,25,28,47,107,397
198,Lindsey Hunter,PG,37,DET,24,0,215,22,64,7,26,15,38,7,9,4,9,13,33,13,2,13,30,58
199,Steven Hunter,C,26,DEN,19,2,120,15,28,0,0,15,28,9,20,10,19,29,0,0,6,7,20,39
200,Andre Iguodala,SF,24,PHI,82,82,3242,582,1277,101,307,481,970,365,506,85,361,446,391,171,49,214,187,1630
201,Zydrunas Ilgauskas,C,32,CLE,73,73,2222,417,879,0,1,417,878,195,243,263,419,682,104,34,120,135,247,1029
202,Didier Ilunga-Mbenga,C,27,TOT,42,0,326,39,84,0,0,39,84,5,12,28,44,72,10,7,26,12,70,83
203,Allen Iverson*,SG,32,DEN,82,82,3424,712,1556,95,275,617,1281,645,797,47,196,243,586,160,12,245,109,2164
204,Royal Ivey,PG,26,MIL,75,20,1437,149,378,35,107,114,271,85,117,38,80,118,160,45,7,75,166,418
205,Jarrett Jack,SG,24,POR,82,16,2229,267,620,65,190,202,430,215,248,31,203,234,313,61,1,178,129,814
207,Luke Jackson,SF,26,MIA,14,1,228,26,80,11,30,15,50,16,23,7,26,33,17,8,0,9,22,79
208,Stephen Jackson,SF,29,GSW,73,73,2855,488,1204,182,501,306,703,308,370,67,251,318,300,92,29,197,171,1466
209,Casey Jacobsen,SG,26,MEM,53,0,547,39,115,16,72,23,43,13,17,12,53,65,20,5,1,16,34,107
210,Jerome James,C,32,NYK,2,0,5,1,1,0,0,1,1,2,2,0,3,3,0,0,0,0,0,4
211,LeBron James,SF,23,CLE,75,74,3027,794,1642,113,359,681,1283,549,771,133,459,592,539,138,81,255,165,2250
212,Mike James,PG,32,TOT,54,1,720,101,290,31,97,70,193,39,48,14,55,69,60,21,2,36,56,272
213,Antawn Jamison,PF,31,WAS,79,79,3061,618,1417,120,354,498,1063,333,438,215,591,806,120,106,34,113,195,1689
214,Marko Jarić,SG,29,MIN,75,56,2189,227,528,46,127,181,401,121,163,38,184,222,311,97,32,128,180,621
215,Al Jefferson,C,23,MIN,82,82,2919,721,1441,0,5,721,1436,284,394,308,603,911,117,74,119,167,222,1726
216,Richard Jefferson,SF,27,NJN,82,82,3200,619,1328,77,213,542,1115,542,679,93,249,342,252,76,21,199,225,1857
217,Jared Jeffries,SF,26,NYK,73,19,1325,108,270,4,25,104,245,49,93,118,125,243,66,36,23,64,132,269
218,Yi Jianlian,PF,20,MIL,66,49,1647,219,520,6,21,213,499,122,145,106,238,344,55,36,56,90,153,566
219,Alexander Johnson,PF,24,MIA,43,6,549,61,125,0,0,61,125,57,83,32,62,94,13,13,10,42,80,179
220,Amir Johnson,PF,20,DET,62,0,764,92,165,0,0,92,165,37,55,87,148,235,29,24,82,39,141,221
221,Anthony Johnson,PG,33,TOT,69,52,1531,155,355,42,93,113,262,35,43,22,115,137,262,52,9,84,115,387
222,DerMarr Johnson,SF,27,SAS,5,0,28,7,14,3,9,4,5,0,2,0,1,1,1,1,0,0,4,17
223,Joe Johnson,SG,26,ATL,82,82,3343,647,1497,169,444,478,1053,316,379,83,284,367,474,84,18,223,168,1779
224,Linton Johnson,PF,27,TOT,8,0,63,9,19,1,3,8,16,2,2,5,9,14,4,0,1,5,11,21
225,Bobby Jones,SF,24,TOT,47,2,531,60,140,18,53,42,87,40,51,29,63,92,28,15,3,28,85,178
226,Dahntay Jones,SG,27,SAC,25,0,206,23,53,1,6,22,47,34,51,7,28,35,12,8,6,10,28,81
227,Damon Jones,SG,31,CLE,67,3,1336,151,363,115,276,36,87,20,28,5,67,72,126,19,1,36,66,437
228,Dwayne Jones,PF,24,CLE,56,0,472,25,47,0,1,25,46,28,58,69,71,140,10,10,25,17,88,78
229,Eddie Jones,SG,36,DAL,47,33,922,66,180,34,116,32,64,10,14,18,114,132,69,26,8,29,72,176
230,Fred Jones,SG,28,NYK,70,26,1757,182,432,74,192,108,240,94,126,30,140,170,166,48,18,78,140,532
231,James Jones,SF,27,POR,58,3,1276,143,327,91,205,52,122,86,98,43,118,161,34,24,15,28,96,463
232,Solomon Jones,PF,23,ATL,35,0,145,12,30,0,2,12,28,11,20,19,23,42,0,3,5,11,28,35
233,Chris Kaman,C,25,LAC,56,55,2083,338,700,0,4,338,696,202,265,173,538,711,107,33,155,164,179,878
234,Jason Kapono,SF,26,TOR,81,7,1530,243,498,57,118,186,380,37,43,31,89,120,65,34,2,58,131,580
235,Coby Karl,SG,24,LAL,17,0,71,9,26,4,13,5,13,8,10,3,11,14,9,4,2,5,4,30
236,Viktor Khryapa,PF,25,CHI,9,0,105,12,31,0,1,12,30,8,14,6,14,20,8,6,0,6,11,32
237,Jason Kidd*,PG,34,TOT,80,80,2906,305,793,119,312,186,481,135,165,94,506,600,806,136,26,266,165,864
238,Tarence Kinsey,SG,23,MEM,11,0,96,16,38,3,7,13,31,5,6,3,9,12,2,3,0,3,11,40
239,Andrei Kirilenko,SF,26,UTA,72,72,2217,275,544,44,116,231,428,198,257,121,218,339,285,86,109,140,165,792
240,Linas Kleiza,SF,23,DEN,79,13,1889,311,659,94,277,217,382,164,213,92,241,333,95,44,19,89,181,880
241,Brevin Knight,PG,32,LAC,74,39,1674,138,342,0,6,138,336,62,71,15,127,142,328,100,11,71,160,338
243,Nenad Krstić,C,24,NJN,45,38,812,123,300,0,2,123,298,52,69,35,165,200,27,9,17,41,111,298
244,Raef LaFrentz,C,31,POR,39,0,291,27,61,0,4,27,57,11,19,28,39,67,6,12,17,10,59,65
245,Carl Landry,PF,24,HOU,42,0,711,135,219,0,1,135,218,72,109,96,111,207,21,17,7,26,98,342
246,Keith Langford,SG,24,SAS,2,0,10,1,4,0,0,1,4,0,0,0,2,2,0,0,0,0,1,2
248,Acie Law,PG,23,ATL,56,6,865,95,237,7,34,88,203,38,48,12,45,57,113,29,0,56,73,235
249,David Lee,PF,24,NYK,81,29,2356,341,618,0,2,341,616,194,237,242,482,724,95,55,29,97,210,876
250,Rashard Lewis,PF,28,ORL,81,81,3076,516,1135,226,553,290,582,218,260,97,340,437,196,99,38,140,214,1476
251,Kyle Lowry,PG,21,MEM,82,9,2089,256,592,36,140,220,452,243,348,41,209,250,296,92,22,127,185,791
252,Tyronn Lue,PG,30,TOT,50,3,736,113,253,39,86,74,167,25,32,9,45,54,74,11,1,27,66,290
253,Mark Madsen,PF,32,MIN,20,6,151,3,19,0,0,3,19,3,12,18,20,38,4,3,2,9,25,9
254,Corey Maggette,SF,28,LAC,70,65,2502,458,1000,78,203,380,797,553,681,78,316,394,189,71,7,195,210,1547
255,Jamaal Magloire,C,29,TOT,31,2,286,18,55,0,0,18,55,20,44,19,70,89,7,1,10,30,50,56
256,Ian Mahinmi,C,21,SAS,6,0,23,6,12,0,0,6,12,9,9,0,5,5,1,0,4,2,4,21
257,Stephon Marbury,PG,30,NYK,24,19,805,111,265,28,74,83,191,83,116,17,42,59,113,21,2,48,57,333
258,Shawn Marion,PF,29,TOT,63,62,2315,400,787,66,198,334,589,106,150,136,507,643,138,125,85,86,150,972
259,Sean Marks,C,32,PHO,19,0,130,23,43,1,4,22,39,12,19,9,27,36,4,3,10,8,23,59
260,Donyell Marshall,PF,34,TOT,26,1,340,32,98,15,53,17,45,19,22,24,52,76,10,6,16,15,31,98
261,Darrick Martin,PG,36,TOR,17,0,141,10,43,2,16,8,27,5,6,3,4,7,21,6,0,1,12,27
262,Kenyon Martin,PF,30,DEN,71,71,2159,376,699,2,11,374,688,123,212,105,356,461,90,88,85,91,235,877
263,Kevin Martin,SG,24,SAC,61,57,2216,417,914,107,266,310,648,502,578,48,225,273,129,62,5,131,150,1443
264,Desmond Mason,SF,30,MIL,59,56,1702,230,477,0,0,230,477,114,173,75,181,256,121,40,30,83,106,574
265,Roger Mason,PG,27,WAS,80,9,1708,266,600,130,327,136,273,62,71,17,113,130,134,40,18,69,140,724
266,Jason Maxiell,C,24,DET,82,7,1768,240,446,0,1,240,445,171,270,177,256,433,46,21,94,71,183,651
267,Rashad McCants,SG,23,MIN,75,24,2020,428,944,142,349,286,595,116,155,50,156,206,162,66,18,172,234,1114
268,Jelani McCoy,C,30,DEN,6,1,33,1,1,0,0,1,1,1,2,1,6,7,0,0,5,4,7,3
269,Antonio McDyess,PF,33,DET,78,78,2285,293,600,0,2,293,598,97,156,204,462,666,89,61,53,75,246,683
270,Tracy McGrady*,SG,28,HOU,66,62,2440,548,1307,86,295,462,1012,245,358,42,297,339,387,68,30,160,91,1427
271,Dominic McGuire,SG,22,WAS,70,1,695,39,103,1,6,38,97,14,32,53,86,139,40,20,26,40,76,93
272,Jeff McInnis,PG,33,CHA,54,26,1410,108,249,3,19,105,230,23,30,16,80,96,220,23,3,76,120,242
273,Josh McRoberts,PF,20,POR,8,0,28,6,10,0,1,6,9,0,0,2,8,10,2,1,0,2,1,12
274,Chris Mihm,C,28,LAL,23,5,278,32,95,0,0,32,95,18,27,28,49,77,13,4,14,17,42,82
275,C.J. Miles,SG,20,UTA,60,13,689,113,236,30,77,83,159,41,52,16,62,78,53,32,8,27,98,297
276,Darko Miličić,C,22,MEM,70,64,1663,219,500,0,1,219,499,67,121,127,297,424,58,32,114,101,185,505
277,Andre Miller,PG,31,PHI,82,82,3016,569,1156,3,34,566,1122,257,333,95,229,324,565,105,6,206,181,1398
278,Brad Miller,C,31,SAC,72,72,2513,337,728,28,90,309,638,262,309,167,514,681,264,69,74,164,247,964
279,Mike Miller,SG,27,MEM,70,70,2474,414,824,155,359,259,465,164,212,51,416,467,240,35,16,182,145,1147
280,Paul Millsap,PF,22,UTA,82,2,1702,253,502,0,4,253,498,155,229,167,293,460,81,72,73,87,269,661
281,Yao Ming*,C,27,HOU,55,55,2044,432,852,0,2,432,850,345,406,172,422,594,129,25,111,183,171,1209
282,Cuttino Mobley,SG,32,LAC,77,38,2702,377,870,67,192,310,678,163,199,50,225,275,202,78,34,123,152,984
283,Nazr Mohammed,C,30,TOT,82,29,1650,272,528,0,1,272,527,95,163,194,300,494,72,45,60,101,230,639
284,Jamario Moon,SF,27,TOR,78,75,2166,279,575,40,122,239,453,63,85,92,392,484,90,80,108,51,152,661
285,Mikki Moore,PF,32,SAC,82,79,2385,282,489,0,2,282,487,134,182,160,334,494,84,35,46,110,310,698
286,Randolph Morris,C,22,NYK,18,2,181,21,58,0,0,21,58,14,29,12,25,37,2,4,2,9,37,56
287,Alonzo Mourning*,C,37,MIA,25,0,389,52,95,0,0,52,95,45,76,34,59,93,7,4,42,25,56,149
288,Troy Murphy,PF,27,IND,75,61,2106,315,693,94,236,221,457,192,241,108,435,543,165,49,32,96,217,916
289,Ronald Murray,PG,28,TOT,42,19,874,154,367,20,63,134,304,68,98,23,60,83,144,38,4,84,50,396
290,Dikembe Mutombo*,C,41,HOU,39,25,619,43,80,0,0,43,80,32,45,68,131,199,5,11,48,17,55,118
291,Boštjan Nachbar,PF,27,NJN,75,1,1660,245,609,94,262,151,347,154,196,56,204,260,88,44,21,85,182,738
292,Eduardo Nájera,PF,31,DEN,78,3,1664,174,368,53,147,121,221,63,89,113,224,337,95,69,40,59,199,464
293,Steve Nash*,PG,33,PHO,81,81,2780,485,962,179,381,306,581,222,245,28,254,282,898,53,5,295,113,1371
294,Juan Carlos Navarro,SG,27,MEM,82,30,2117,308,766,156,432,152,334,124,146,34,176,210,177,48,1,134,94,896
295,Jameer Nelson,PG,25,ORL,69,62,1961,283,603,64,154,219,449,125,151,28,215,243,383,63,4,141,167,755
296,Rasho Nesterović,C,31,TOR,71,39,1486,257,467,1,3,256,464,37,49,130,212,342,82,20,52,60,132,552
298,Demetris Nichols,SF,23,TOT,14,0,44,6,23,3,13,3,10,0,0,0,5,5,1,0,3,4,4,15
299,Joakim Noah,C,22,CHI,74,31,1534,177,367,0,1,177,366,134,194,174,242,416,84,68,64,89,173,488
300,Andrés Nocioni,SF,28,CHI,82,27,2021,379,877,126,346,253,531,196,243,48,294,342,95,25,43,133,245,1080
301,Steve Novak,SF,24,HOU,35,0,264,49,102,34,71,15,31,3,4,4,31,35,6,2,3,4,17,135
302,Dirk Nowitzki,PF,29,DAL,77,77,2769,630,1314,79,220,551,1094,478,544,95,564,659,266,51,71,160,198,1817
303,Patrick O'Bryant,C,21,GSW,24,0,99,16,29,0,0,16,29,3,5,10,19,29,4,4,9,7,27,35
304,Jermaine O'Neal,C,29,IND,42,34,1206,225,512,0,5,225,507,121,163,82,201,283,93,20,87,106,129,571
305,Shaquille O'Neal*,C,35,TOT,61,61,1748,331,558,0,0,331,558,170,338,166,388,554,93,32,88,181,228,832
306,Fabricio Oberto,PF,32,SAS,82,64,1644,180,296,0,1,180,295,37,61,153,277,430,95,37,20,51,203,397
307,Lamar Odom,PF,28,LAL,77,77,2921,417,795,31,113,386,682,229,328,197,622,819,273,75,72,156,222,1094
308,Emeka Okafor,C,25,CHA,82,82,2718,460,860,0,0,460,860,213,374,255,621,876,70,62,138,164,241,1133
309,Mehmet Okur,C,28,UTA,72,72,2390,374,841,114,294,260,547,185,230,132,424,556,145,55,29,104,236,1047
310,Kevin Ollie,SG,35,PHI,40,0,300,29,69,0,1,29,68,12,15,4,15,19,38,10,0,5,28,70
311,Bo Outlaw,PF,36,ORL,2,0,7,2,3,0,0,2,3,0,0,0,0,0,0,0,0,1,1,4
312,Travis Outlaw,PF,23,POR,82,6,2186,417,964,40,101,377,863,218,294,96,280,376,106,59,63,107,173,1092
313,Andre Owens,PG,27,IND,31,7,392,40,107,18,40,22,67,25,34,13,34,47,47,13,3,24,37,123
314,Zaza Pachulia,C,23,ATL,62,5,944,107,245,0,3,107,242,108,153,89,159,248,36,24,13,69,140,322
315,Jannero Pargo,SG,28,NOH,80,5,1497,254,652,65,186,189,466,71,81,26,104,130,192,50,5,93,123,644
316,Anthony Parker,SG,32,TOR,82,82,2634,395,829,133,304,262,525,102,125,50,284,334,183,79,17,87,157,1025
317,Smush Parker,PG,26,TOT,28,2,592,64,184,18,78,46,106,19,28,4,47,51,84,24,6,44,60,165
318,Tony Parker,PG,25,SAS,69,68,2312,515,1043,17,66,498,977,248,347,30,191,221,411,55,8,164,93,1295
319,Ruben Patterson,SF,32,LAC,20,5,327,39,86,0,2,39,84,24,43,24,40,64,17,21,7,27,37,102
320,Chris Paul,PG,22,NOH,80,80,3006,630,1291,92,249,538,1042,332,390,62,259,321,925,217,4,201,185,1684
321,Sasha Pavlović,SG,24,CLE,51,45,1188,146,403,34,114,112,289,53,77,35,93,128,82,29,6,55,117,379
322,Oleksiy Pecherov,C,22,WAS,35,0,320,44,125,17,60,27,65,20,31,21,45,66,7,6,5,17,30,125
323,Kendrick Perkins,C,23,BOS,78,78,1912,214,348,0,1,214,347,114,183,145,329,474,84,31,114,125,242,542
324,Kosta Perović,C,22,GSW,7,0,38,3,10,0,0,3,10,4,6,6,7,13,1,0,2,1,6,10
325,Morris Peterson,SG,30,NOH,76,76,1796,215,516,113,287,102,229,65,85,36,170,206,67,47,7,41,125,608
326,Johan Petro,C,22,SEA,72,28,1310,184,439,0,1,184,438,64,87,98,272,370,32,35,42,73,173,432
327,Eric Piatkowski,SF,37,PHO,16,0,113,12,33,11,26,1,7,4,4,1,11,12,10,0,1,6,11,39
328,Paul Pierce,SF,30,BOS,80,80,2874,509,1098,143,365,366,733,409,485,53,358,411,363,101,36,221,200,1570
329,Mickaël Piétrus,SF,25,GSW,66,16,1316,170,387,66,183,104,204,66,98,67,175,242,49,66,43,48,200,472
330,Scot Pollard,C,32,BOS,22,0,173,12,23,0,0,12,23,15,22,14,23,37,3,3,6,5,43,39
331,James Posey,PF,31,BOS,74,2,1821,173,414,106,279,67,135,93,115,30,292,322,114,72,19,65,182,545
332,Leon Powe,C,24,BOS,56,5,809,154,269,0,1,154,268,137,193,95,132,227,15,15,16,43,127,445
333,Josh Powell,C,25,LAC,64,25,1228,145,315,0,3,145,312,63,87,115,216,331,47,14,23,65,130,353
334,Kasib Powell,SF,26,MIA,11,4,304,35,95,8,33,27,62,6,9,8,36,44,18,9,2,5,18,84
335,Ronnie Price,PG,24,UTA,61,3,588,88,204,26,75,62,129,26,38,8,38,46,78,32,3,30,83,228
336,Tayshaun Prince,SF,27,DET,82,82,2694,421,940,53,146,368,794,185,241,109,289,398,268,42,33,91,90,1080
337,Gabe Pruitt,PG,21,BOS,15,0,95,14,39,3,12,11,27,1,2,1,7,8,13,5,0,5,10,32
338,Joel Przybilla,C,28,POR,77,67,1819,144,250,0,1,144,249,83,122,195,454,649,27,13,93,95,234,371
339,Chris Quinn,PG,24,MIA,60,25,1340,158,373,64,159,94,214,85,98,11,107,118,178,46,4,55,90,465
340,Vladimir Radmanović,SF,27,LAL,65,41,1483,198,437,95,234,103,203,52,65,56,159,215,123,46,12,73,147,543
341,Shavlik Randolph,PF,24,PHI,9,0,27,4,14,0,0,4,14,0,0,9,2,11,3,1,3,2,5,8
342,Zach Randolph,C,26,NYK,69,68,2244,486,1058,22,80,464,978,223,289,184,526,710,140,59,16,186,194,1217
344,Michael Redd,SG,28,MIL,72,71,2702,550,1243,130,359,420,884,402,490,85,224,309,247,65,13,181,120,1632
345,J.J. Redick,SG,23,ORL,34,0,276,48,108,17,43,31,65,27,34,1,22,23,16,4,0,15,29,140
346,Chris Richard,C,23,MIN,52,3,556,41,87,0,0,41,87,16,27,52,83,135,18,10,12,24,83,98
347,Jason Richardson,SF,27,CHA,82,82,3149,648,1468,243,599,405,869,249,331,80,361,441,258,116,57,166,241,1788
349,Quentin Richardson,SF,27,NYK,65,65,1841,199,555,69,214,130,341,60,88,56,259,315,116,44,15,69,153,527
350,Luke Ridnour,PG,26,SEA,61,5,1223,147,368,21,71,126,297,78,91,13,81,94,241,37,14,80,120,393
351,Nate Robinson,PG,23,NYK,72,17,1883,331,782,97,292,234,490,154,196,51,171,222,212,60,1,103,186,913
352,Sergio Rodríguez,PG,21,POR,72,0,628,69,196,17,58,52,138,25,38,13,45,58,123,24,0,53,57,180
353,Rajon Rondo,PG,21,BOS,77,77,2306,351,713,5,19,346,694,107,175,78,244,322,393,129,13,147,187,814
354,Malik Rose,PF,33,NYK,49,3,494,66,180,2,7,64,173,37,51,31,72,103,28,16,7,40,80,171
355,Quinton Ross,SG,26,LAC,76,44,1505,131,335,9,21,122,314,40,60,54,118,172,88,43,33,29,132,311
356,Brandon Roy,SG,23,POR,74,74,2792,531,1170,73,215,458,955,281,373,81,267,348,430,79,16,136,147,1416
357,Michael Ruffin,C,31,MIL,46,2,632,33,62,0,0,33,62,25,63,90,96,186,24,31,19,19,93,91
358,Kareem Rush,SG,27,IND,71,15,1504,228,569,102,262,126,307,30,42,19,149,168,89,42,19,62,108,588
359,John Salmons,SG,28,SAC,81,41,2517,381,799,39,120,342,679,214,260,76,273,349,208,93,31,170,171,1015
360,Cheikh Samb,C,23,DET,4,0,31,3,4,0,0,3,4,1,2,3,4,7,0,1,2,1,8,7
361,Brian Scalabrine,PF,29,BOS,48,9,512,29,94,15,46,14,48,15,20,22,57,79,40,9,8,26,63,88
362,Luis Scola,PF,27,HOU,82,39,2024,345,670,0,3,345,667,157,235,174,351,525,106,60,19,105,235,847
363,Thabo Sefolosha,SG,23,CHI,69,22,1436,180,421,29,88,151,333,75,104,50,205,255,129,61,30,93,128,464
364,Mouhamed Sene,C,21,SEA,13,0,62,11,24,0,0,11,24,8,17,7,9,16,1,0,7,0,9,30
365,Ramon Sessions,PG,21,MIL,17,7,450,51,117,3,7,48,110,32,41,8,50,58,127,17,3,36,26,137
366,Bobby Simmons,SF,27,MIL,70,21,1521,209,496,60,171,149,325,53,70,67,159,226,80,50,5,78,140,531
367,Cedric Simmons,PF,22,TOT,14,0,87,4,14,0,0,4,14,0,10,6,12,18,0,2,5,6,8,8
368,Courtney Sims,C,24,IND,3,0,11,0,1,0,0,0,1,0,0,1,1,2,1,0,0,0,2,0
369,Brian Skinner,C,31,PHO,66,0,844,92,198,2,3,90,195,33,63,63,175,238,15,21,77,39,112,219
370,Craig Smith,PF,24,MIN,77,11,1547,297,528,0,9,297,519,133,200,123,230,353,60,36,17,89,217,727
371,J.R. Smith,SG,22,DEN,74,0,1421,311,674,157,390,154,284,128,178,43,109,152,128,62,12,112,144,907
372,Jason Smith,PF,21,PHI,76,1,1107,141,310,4,14,137,296,54,82,77,153,230,20,22,50,48,142,340
373,Joe Smith,PF,32,TOT,77,36,1726,312,653,0,3,312,650,154,204,163,238,401,66,34,47,71,186,778
374,Josh Smith,PF,22,ATL,81,81,2873,518,1133,25,99,493,1034,333,469,161,506,667,272,123,227,245,269,1394
375,Eric Snow,PG,34,CLE,22,5,305,6,38,0,2,6,36,10,22,4,16,20,42,10,4,10,30,22
377,Darius Songaila,C,29,WAS,80,13,1554,214,467,0,2,214,465,67,73,81,190,271,135,53,16,86,181,495
378,Jerry Stackhouse,SG,33,DAL,58,13,1412,213,526,60,184,153,342,132,148,33,100,133,145,28,10,86,82,618
379,DeShawn Stevenson,SG,26,WAS,82,82,2564,301,780,158,413,143,367,157,197,37,198,235,252,65,15,102,110,917
380,Peja Stojaković,SF,30,NOH,77,77,2711,451,1026,231,524,220,502,130,140,64,267,331,96,57,10,61,127,1263
381,Awvee Storey,SG,30,MIL,26,0,259,39,89,0,7,39,82,14,29,31,23,54,16,7,1,10,41,92
382,Damon Stoudamire,PG,34,TOT,60,33,1037,120,337,50,149,70,188,27,34,20,98,118,165,30,2,80,76,317
383,Salim Stoudamire,PG,25,ATL,35,0,402,65,180,29,85,36,95,41,50,4,20,24,28,7,5,21,34,200
384,Amar'e Stoudemire,C,25,PHO,79,79,2677,714,1211,5,31,709,1180,556,691,178,541,719,118,64,163,174,294,1989
385,D.J. Strawberry,SG,22,PHO,33,0,270,29,92,6,25,23,67,9,19,9,19,28,30,12,6,11,36,73
386,Rodney Stuckey,PG,21,DET,57,2,1081,153,382,3,16,150,366,127,156,32,97,129,160,49,6,78,113,436
387,Robert Swift,C,22,SEA,8,4,98,6,17,0,0,6,17,2,2,6,12,18,1,5,6,10,16,14
388,Stromile Swift,PF,28,TOT,56,4,844,135,265,0,2,135,263,73,109,64,135,199,26,15,54,51,113,343
389,Wally Szczerbiak,SF,30,TOT,75,2,1736,311,722,90,218,221,504,149,175,34,183,217,104,23,12,76,103,861
390,Sebastian Telfair,PG,22,MIN,60,51,1933,223,556,32,114,191,442,78,105,16,119,135,355,59,11,111,171,556
391,Jason Terry,SG,30,DAL,82,34,2579,471,1008,136,363,335,645,191,223,30,178,208,264,88,18,92,170,1269
392,Billy Thomas,SF,32,TOT,11,0,42,4,17,4,16,0,1,2,2,0,2,2,0,1,0,4,4,14
393,Kenny Thomas,PF,30,SAC,23,3,281,16,38,0,0,16,38,0,5,18,43,61,13,6,1,21,38,32
395,Tim Thomas,PF,30,LAC,63,51,1940,291,705,83,271,208,434,115,153,62,261,323,171,40,29,98,192,780
396,Tyrus Thomas,PF,21,CHI,74,27,1330,186,440,1,6,185,434,129,174,102,240,342,90,48,72,77,170,502
397,Al Thornton,PF,24,LAC,79,31,2158,374,871,43,130,331,741,214,288,98,260,358,98,46,43,128,195,1005
398,Jamaal Tinsley,PG,29,IND,39,36,1293,176,463,40,141,136,322,72,100,24,117,141,326,66,10,130,97,464
399,Alando Tucker,SF,23,PHO,6,0,48,8,22,1,4,7,18,5,6,4,4,8,0,0,1,0,2,22
400,Ronny Turiaf,C,25,LAL,78,21,1458,188,397,0,1,188,396,140,186,95,211,306,128,28,108,72,199,516
401,Hedo Türkoğlu,SF,28,ORL,82,82,3026,556,1219,166,415,390,804,324,391,83,388,471,409,74,25,246,244,1602
402,Ime Udoka,PF,30,SAS,73,0,1316,159,375,61,165,98,210,44,58,36,192,228,63,56,17,58,127,423
403,Beno Udrih,PG,25,SAC,65,51,2080,328,708,53,137,275,571,125,147,34,183,217,282,56,10,148,138,834
404,Anderson Varejão,C,25,CLE,48,13,1320,136,295,0,2,136,293,49,82,134,265,399,53,37,26,59,134,321
405,Jacque Vaughn,PG,32,SAS,74,9,1139,121,283,3,10,118,273,61,80,13,61,74,159,23,1,54,97,306
406,Charlie Villanueva,PF,23,MIL,76,31,1829,354,814,55,185,299,629,123,157,145,321,466,78,30,35,107,174,886
407,Marcus Vinicius,SF,23,NOH,13,0,69,9,20,5,12,4,8,5,11,1,7,8,2,1,1,3,4,28
408,Jake Voskuhl,C,30,MIL,44,0,386,37,80,0,0,37,80,24,29,30,67,97,13,9,21,29,83,98
409,Sasha Vujačić,SG,23,LAL,72,0,1279,219,482,118,270,101,212,76,91,19,135,154,72,36,5,52,107,632
410,Dwyane Wade,SG,26,MIA,51,49,1954,439,937,22,77,417,860,354,467,45,169,214,354,87,37,224,137,1254
411,Von Wafer,SG,22,TOT,29,0,154,17,61,4,26,13,35,8,12,1,18,19,7,2,3,13,7,46
412,Antoine Walker,PF,31,MIN,46,1,892,136,375,61,188,75,187,35,66,56,112,168,45,33,8,46,80,368
414,Gerald Wallace,PF,25,CHA,62,59,2376,408,908,71,221,337,687,313,428,58,315,373,216,131,58,180,189,1200
415,Rasheed Wallace,C,33,DET,77,76,2346,376,870,112,315,264,555,115,150,84,427,511,137,91,129,86,213,979
416,Luke Walton,SF,27,LAL,74,31,1729,215,478,28,84,187,394,77,109,85,206,291,218,60,18,100,133,535
417,Hakim Warrick,PF,25,MEM,75,30,1754,328,653,13,48,315,605,183,260,123,233,356,53,36,28,85,156,852
418,Darius Washington,SG,22,SAS,18,0,146,21,48,4,12,17,36,7,13,4,16,20,15,5,0,14,16,53
419,Darryl Watkins,C,23,SAC,9,0,71,5,15,0,0,5,15,2,5,5,7,12,0,2,2,7,8,12
420,C.J. Watson,PG,23,GSW,32,0,368,43,101,9,26,34,75,23,29,13,19,32,35,15,0,18,19,118
421,Earl Watson,PG,28,SEA,78,73,2269,339,747,49,132,290,615,111,145,43,182,225,531,69,11,175,158,838
422,Chris Webber,PF,34,GSW,9,8,126,15,31,0,0,15,31,5,12,2,30,32,18,4,6,11,17,35
423,Martell Webster,SF,21,POR,75,70,2132,277,656,123,317,154,339,122,166,54,242,296,90,42,28,83,159,799
424,Bonzi Wells,SG,31,TOT,73,7,1562,252,569,12,50,240,519,146,227,84,247,331,97,75,32,103,157,662
425,David West,PF,27,NOH,76,76,2870,629,1305,6,25,623,1280,300,353,180,495,675,177,62,99,165,208,1564
426,Delonte West,PG,24,TOT,61,31,1533,196,475,48,135,148,340,67,91,31,162,193,229,59,29,117,103,507
427,Mario West,SG,23,ATL,64,2,269,21,49,0,4,21,45,17,26,26,22,48,13,12,4,9,61,59
428,Chris Wilcox,PF,25,SEA,62,55,1739,334,638,0,3,334,635,160,248,126,307,433,74,46,36,103,174,828
429,Damien Wilkins,SF,28,SEA,76,31,1843,271,673,50,155,221,518,106,144,72,173,245,150,62,19,89,128,698
430,Mike Wilks,PG,28,TOT,15,0,188,17,36,3,8,14,28,4,4,5,14,19,14,9,0,9,13,41
431,Aaron Williams,C,36,LAC,30,5,297,27,55,0,0,27,55,14,18,15,46,61,9,12,15,13,44,68
432,Deron Williams,PG,23,UTA,82,82,3059,566,1117,83,210,483,907,330,411,34,209,243,862,90,23,279,200,1545
433,Jason Williams,PG,32,MIA,67,53,1886,211,550,97,275,114,275,69,80,12,118,130,307,83,5,91,93,588
434,Justin Williams,C,23,TOT,23,0,123,13,29,0,0,13,29,8,26,20,29,49,0,5,5,4,17,34
435,Lou Williams,PG,21,PHI,80,0,1862,319,752,55,153,264,599,227,290,41,126,167,253,81,13,125,130,920
436,Marcus Williams,PG,22,NJN,53,7,854,111,293,54,142,57,151,37,47,14,87,101,140,25,3,75,52,313
438,Marvin Williams,SF,21,ATL,80,80,2765,424,918,1,10,423,908,336,409,119,338,457,137,81,33,127,225,1185
439,Mo Williams,PG,25,MIL,66,66,2410,441,919,89,231,352,688,166,194,37,193,230,419,78,10,182,188,1137
440,Sean Williams,C,21,NJN,73,29,1278,164,305,0,0,164,305,81,133,115,207,322,28,28,106,70,193,409
441,Shawne Williams,SF,21,IND,65,3,967,159,372,43,137,116,235,76,106,54,122,176,59,26,26,58,132,437
442,Shelden Williams,PF,24,TOT,64,0,776,92,212,0,2,92,210,71,105,68,137,205,19,22,21,35,110,255
443,Loren Woods,C,29,HOU,7,0,17,3,5,0,0,3,5,0,0,0,1,1,2,0,0,0,2,6
444,Metta World Peace,SF,28,SAC,57,54,2172,436,962,84,221,352,741,212,295,101,227,328,199,133,38,148,159,1168
445,Antoine Wright,SG,23,TOT,56,10,1232,136,329,32,110,104,219,46,67,40,107,147,80,28,21,50,127,350
446,Brandan Wright,PF,20,GSW,38,6,376,62,112,0,0,62,112,27,40,38,61,99,9,6,22,13,36,151
447,Dorell Wright,SF,22,MIA,44,34,1104,143,293,4,11,139,282,57,69,48,172,220,60,29,41,29,79,347
448,Julian Wright,SF,20,NOH,57,1,640,90,169,10,24,80,145,33,52,33,84,117,40,29,12,34,43,223
449,Lorenzen Wright,C,32,TOT,18,1,161,6,21,0,0,6,21,3,6,8,30,38,4,3,3,4,31,15
450,Nick Young,SG,22,WAS,75,2,1158,210,478,40,100,170,378,101,124,23,92,115,63,35,7,94,130,561
451,Thaddeus Young,PF,19,PHI,74,22,1554,264,490,6,19,258,471,76,103,120,192,312,58,73,8,64,126,610
