Rk,Player,Pos,Age,Tm,G,GS,MP,FG,FGA,3P,3PA,2P,2PA,FT,FTA,ORB,DRB,TRB,AST,STL,BLK,TOV,PF,PTS
1,Alex Acker,SG,26,TOT,25,0,199,30,76,7,20,23,56,5,10,8,16,24,12,5,4,7,9,72
2,Hassan Adams,SG,24,TOR,12,0,52,4,13,0,0,4,13,3,6,1,6,7,1,1,1,4,4,11
3,Arron Afflalo,SG,23,DET,74,8,1234,131,300,43,107,88,193,58,71,30,104,134,44,28,13,43,144,363
4,Maurice Ager,SG,24,NJN,20,0,97,15,43,0,6,15,37,4,8,3,7,10,3,1,2,4,17,34
5,Blake Ahearn,PG,24,SAS,3,0,19,2,6,2,4,0,2,2,2,0,1,1,2,1,0,1,3,8
6,Alexis Ajinça,PF,20,CHA,31,4,182,25,69,0,2,25,67,20,28,9,21,30,3,7,6,12,34,70
7,LaMarcus Aldridge,PF,23,POR,81,81,3004,601,1243,7,28,594,1215,261,334,234,371,605,157,77,77,121,207,1470
8,Joe Alexander,SF,22,MIL,59,0,716,102,245,16,46,86,199,58,83,44,71,115,42,15,29,52,107,278
9,Malik Allen,PF,30,MIL,49,3,579,73,170,0,1,73,169,10,21,35,68,103,35,7,12,20,89,156
10,Ray Allen*,SG,33,BOS,79,79,2876,499,1040,199,486,300,554,237,249,66,212,278,218,69,13,134,157,1434
11,Tony Allen,SG,27,BOS,46,2,887,137,284,6,27,131,257,79,109,22,82,104,66,54,23,77,98,359
12,Morris Almond,SG,23,UTA,25,1,255,33,81,5,17,28,64,21,26,9,27,36,7,4,4,16,31,92
13,Rafer Alston,PG,32,TOT,77,76,2447,316,820,112,331,204,489,156,208,33,194,227,406,108,10,140,135,900
14,Lou Amundson,PF,26,PHO,76,0,1044,134,250,0,1,134,249,53,120,128,142,270,28,32,65,56,154,321
15,Chris Andersen,C,30,DEN,71,1,1460,160,292,2,10,158,282,130,181,163,279,442,31,41,175,69,174,452
16,Ryan Anderson,PF,20,NJN,66,30,1312,160,407,69,189,91,218,98,116,104,207,311,52,44,20,63,157,487
17,Carmelo Anthony,SF,24,DEN,66,66,2277,535,1207,63,170,472,1037,371,468,106,344,450,222,75,24,199,195,1504
18,Joel Anthony,C,26,MIA,65,28,1048,57,118,0,0,57,118,30,46,89,108,197,27,20,93,41,139,144
19,Gilbert Arenas,PG,27,WAS,2,2,63,6,23,2,7,4,16,12,16,1,8,9,20,0,1,1,4,26
20,Trevor Ariza,SF,23,LAL,82,20,1999,274,596,61,191,213,405,120,169,111,241,352,145,137,24,87,166,729
21,Hilton Armstrong,C,24,NOH,70,29,1092,138,246,0,2,138,244,62,98,81,114,195,29,26,45,80,181,338
22,Darrell Arthur,PF,20,MEM,76,64,1464,191,436,0,2,191,434,40,60,108,238,346,43,52,52,47,206,422
23,Chucky Atkins,PG,34,TOT,33,0,412,34,113,15,57,19,56,15,16,5,19,24,59,10,2,23,27,98
24,D.J. Augustin,PG,21,CHA,72,12,1908,267,621,108,246,159,375,208,233,17,116,133,250,42,2,119,140,850
25,Kelenna Azubuike,SF,25,GSW,74,51,2375,392,845,94,210,298,635,185,229,112,258,370,117,57,50,95,183,1063
26,Renaldo Balkman,PF,24,DEN,53,10,780,110,197,2,7,108,190,42,65,86,117,203,34,47,23,35,98,264
27,Marcus Banks,PG,27,TOT,22,0,206,21,57,3,19,18,38,11,18,1,17,18,28,11,2,14,26,56
28,Leandro Barbosa,SG,26,PHO,70,11,1705,366,759,90,240,276,519,171,194,34,147,181,162,82,7,93,115,993
29,J.J. Barea,SG,24,DAL,79,15,1600,246,557,55,154,191,403,70,93,36,141,177,269,37,5,105,121,617
30,Andrea Bargnani,PF,23,TOR,78,59,2453,431,958,119,291,312,667,221,266,70,346,416,94,34,97,135,242,1202
31,Matt Barnes,PF,28,PHO,77,40,2082,285,674,117,341,168,333,101,136,79,342,421,212,52,26,130,209,788
32,Brent Barry,SG,37,HOU,56,1,857,70,172,49,131,21,41,19,20,17,77,94,78,24,3,48,45,208
33,Brandon Bass,C,23,DAL,81,0,1574,252,508,0,6,252,502,182,210,129,238,367,43,27,55,86,140,686
34,Maceo Baston,PF,33,IND,27,0,217,25,46,0,1,25,45,17,27,22,30,52,7,6,10,12,39,67
35,Tony Battie,PF,32,ORL,77,3,1202,158,323,2,9,156,314,54,82,92,186,278,31,26,25,46,112,372
36,Shane Battier,SG,30,HOU,60,59,2031,145,354,91,237,54,117,55,67,52,233,285,137,48,54,49,114,436
37,Nicolas Batum,SF,20,POR,79,76,1454,161,361,62,168,99,193,42,52,84,136,220,74,50,40,50,139,426
38,Jerryd Bayless,PG,20,POR,53,0,655,69,189,7,27,62,162,83,103,8,49,57,78,16,2,56,81,228
39,Michael Beasley,PF,20,MIA,81,19,2009,452,957,33,81,419,876,186,241,110,329,439,83,41,37,121,184,1123
40,Marco Belinelli,SG,22,GSW,42,23,882,140,317,52,131,88,186,40,52,10,61,71,88,36,1,59,73,372
41,Charlie Bell,SG,29,MIL,70,23,1783,217,524,87,240,130,284,66,80,32,102,134,151,50,7,76,138,587
42,Raja Bell,SG,32,TOT,67,66,2315,299,684,114,271,185,413,87,102,41,202,243,142,50,8,86,166,799
43,Mike Bibby,PG,30,ATL,79,79,2740,437,1005,167,428,270,577,135,171,38,240,278,392,98,11,128,145,1176
44,Andris Biedriņš,C,22,GSW,62,58,1863,308,533,0,1,308,532,119,216,223,470,693,121,63,96,110,236,735
45,Chauncey Billups,PG,32,TOT,79,79,2789,410,980,162,397,248,583,418,458,32,207,239,506,93,18,177,161,1400
46,Steve Blake,PG,28,POR,69,69,2188,277,647,140,328,137,319,63,75,28,145,173,348,69,4,108,126,757
47,Andray Blatche,C,22,WAS,71,36,1703,297,630,5,21,292,609,114,162,126,252,378,118,53,74,117,211,713
48,Mark Blount,C,33,MIA,20,0,207,30,78,11,27,19,51,8,13,10,31,41,4,1,7,14,17,79
49,Keith Bogans,SG,28,TOT,65,15,1272,119,324,74,218,45,106,52,57,31,171,202,64,43,4,41,105,364
50,Andrew Bogut,C,24,MIL,36,33,1124,183,317,0,0,183,317,56,98,117,252,369,72,23,37,86,130,422
51,Matt Bonner,PF,28,SAS,81,67,1928,266,536,118,268,148,268,17,23,97,289,386,82,47,26,37,190,667
52,Josh Boone,C,24,NJN,62,7,995,113,214,0,0,113,214,32,85,104,154,258,31,22,48,31,106,258
53,Calvin Booth,C,32,TOT,8,0,56,5,10,0,0,5,10,6,8,5,6,11,0,1,2,1,10,16
54,Carlos Boozer,PF,27,UTA,37,37,1197,251,512,0,0,251,512,97,139,111,274,385,79,39,7,79,132,599
55,Chris Bosh,C,24,TOR,77,77,2928,615,1263,12,49,603,1214,504,617,215,556,771,191,67,77,174,189,1746
56,Bruce Bowen,SF,37,SAS,80,10,1506,79,187,42,98,37,89,14,26,16,129,145,40,36,13,25,123,214
57,Ryan Bowen,SF,33,NOH,21,3,219,22,38,0,0,22,38,3,5,10,14,24,9,14,5,5,37,47
58,Elton Brand,PF,29,PHI,29,23,920,163,365,0,0,163,365,73,108,77,177,254,37,17,45,68,78,399
59,Corey Brewer,SF,22,MIN,15,8,307,37,90,5,12,32,78,14,19,18,31,49,25,15,3,13,37,93
60,Ronnie Brewer,SF,23,UTA,81,80,2605,421,828,22,85,399,743,247,352,101,199,300,179,138,30,110,128,1111
61,Aaron Brooks,PG,24,HOU,80,35,1998,316,783,113,309,203,474,149,172,33,124,157,238,46,8,125,152,894
62,Andre Brown,PF,27,CHA,4,0,41,1,7,0,0,1,7,2,2,7,5,12,1,1,0,5,9,4
64,Dee Brown,PG,24,TOT,19,11,261,18,49,7,24,11,25,3,5,7,22,29,36,10,0,17,28,46
65,Devin Brown,SG,30,NOH,63,5,869,111,313,28,97,83,216,78,100,31,88,119,54,32,5,54,81,328
66,Kwame Brown,C,26,DET,58,30,999,90,169,0,0,90,169,63,122,91,199,290,32,24,24,50,138,243
67,Shannon Brown,SG,23,TOT,48,0,477,78,165,14,37,64,128,32,39,11,33,44,38,22,7,38,42,202
68,Kobe Bryant,SG,30,LAL,82,82,2960,800,1712,118,336,682,1376,483,564,90,339,429,399,120,37,210,189,2201
69,Greg Buckner,SF,32,MEM,63,0,878,61,159,13,51,48,108,20,25,32,98,130,57,29,8,38,108,155
70,Caron Butler,SG,28,WAS,67,67,2585,491,1085,65,210,426,875,345,402,118,296,414,290,106,20,210,165,1392
71,Rasual Butler,SF,29,NOH,82,74,2614,348,803,140,359,208,444,86,110,49,222,271,75,51,61,59,159,922
72,Andrew Bynum,C,21,LAL,50,50,1446,281,502,0,0,281,502,152,215,137,261,398,71,18,90,85,157,714
73,Will Bynum,PG,26,DET,57,1,803,156,342,3,19,153,323,95,119,19,56,75,157,34,2,76,85,410
74,José Calderón,PG,27,TOR,68,68,2333,320,644,82,202,238,442,151,154,16,178,194,607,74,7,143,114,873
75,Marcus Camby,C,34,LAC,62,55,1925,254,496,1,4,253,492,132,182,161,529,690,127,51,132,93,129,641
76,Brian Cardinal,PF,31,MIN,64,4,909,65,169,30,92,35,77,30,35,39,103,142,76,37,13,48,135,190
77,Rodney Carney,SG,24,MIN,67,6,1199,176,423,79,226,97,197,50,66,36,90,126,26,45,29,43,94,481
78,Matt Carroll,SG,28,TOT,55,10,616,65,171,13,53,52,118,21,25,7,62,69,27,21,6,33,67,164
79,Anthony Carter,PG,33,DEN,78,5,1787,167,386,21,88,146,298,57,78,40,165,205,364,96,13,155,142,412
80,Vince Carter,SG,32,NJN,80,80,2946,588,1345,151,392,437,953,335,410,74,336,410,376,82,38,166,234,1662
81,Mario Chalmers,PG,22,MIA,82,82,2626,278,662,114,311,164,351,148,193,37,191,228,403,160,8,165,240,818
82,Tyson Chandler,C,26,NOH,45,45,1445,160,283,0,0,160,283,77,133,163,230,393,22,15,56,70,144,397
83,Wilson Chandler,SF,21,NYK,82,70,2735,455,1054,103,314,352,740,171,215,91,354,445,170,71,75,139,250,1184
84,Speedy Claxton,PG,30,ATL,2,0,15,2,7,0,0,2,7,1,2,0,0,0,3,0,0,0,1,5
85,Jarron Collins,C,30,UTA,26,3,201,16,35,0,0,16,35,8,11,20,17,37,7,2,1,9,35,40
86,Jason Collins,C,30,MIN,31,22,422,22,70,0,0,22,70,13,28,28,42,70,11,9,13,12,73,57
88,Nick Collison,C,28,OKC,71,40,1831,243,428,0,2,243,426,98,136,181,308,489,66,51,50,73,239,584
89,Mike Conley,PG,21,MEM,82,61,2508,323,730,88,217,235,513,161,197,25,251,276,354,90,8,143,146,895
90,Brian Cook,PF,28,TOT,30,0,171,28,76,13,30,15,46,5,6,7,25,32,5,3,3,13,26,74
91,Daequan Cook,SF,21,MIA,75,4,1833,242,645,153,395,89,250,49,56,19,170,189,71,39,10,42,125,686
93,Joe Crawford,SF,22,NYK,2,0,23,3,10,1,4,2,6,2,2,1,3,4,1,1,0,0,2,9
95,Austin Croshere,PF,33,TOT,14,0,100,14,39,5,15,9,24,7,12,11,23,34,9,1,1,6,5,40
96,Eddy Curry,C,26,NYK,3,0,12,2,2,0,0,2,2,1,3,0,4,4,0,0,0,2,5,5
97,Samuel Dalembert,C,27,PHI,82,82,2036,216,434,0,2,216,432,91,124,214,487,701,18,33,146,117,248,523
98,Erick Dampier,C,33,DAL,80,80,1836,182,280,0,0,182,280,90,141,216,349,565,77,24,95,74,191,454
99,Antonio Daniels,PG,33,TOT,74,9,1021,99,236,22,60,77,176,80,100,5,72,77,177,26,1,62,55,300
100,Marquis Daniels,SF,28,IND,54,43,1700,311,689,18,90,293,599,93,129,80,168,248,114,62,26,94,120,733
101,Jermareo Davidson,SF,24,GSW,14,0,111,17,35,0,0,17,35,8,17,10,24,34,1,2,3,5,12,42
102,Baron Davis,PG,29,LAC,65,60,2248,355,959,99,328,256,631,159,210,46,192,238,501,108,35,193,193,968
103,Glen Davis,C,23,BOS,76,16,1637,199,450,2,5,197,445,130,178,121,180,301,69,53,19,71,230,530
104,Paul Davis,PF,24,LAC,27,1,320,40,98,0,1,40,97,27,34,28,39,67,12,10,3,13,44,107
105,Ricky Davis,SG,29,LAC,36,9,785,83,245,35,111,48,134,31,36,9,51,60,82,19,5,39,63,232
106,Luol Deng,SF,23,CHI,49,46,1665,265,591,8,20,257,571,152,191,80,215,295,94,60,25,72,85,690
107,Boris Diaw,PF,26,TOT,81,59,2754,448,884,75,181,373,703,101,147,118,314,432,333,61,53,215,202,1072
108,Yakhouba Diawara,SF,26,MIA,63,21,851,76,217,51,163,25,54,10,19,26,56,82,27,13,6,16,75,213
109,Travis Diener,PG,26,IND,55,0,719,74,179,46,118,28,61,12,15,6,80,86,122,26,5,21,42,206
110,Ike Diogu,PF,25,TOT,29,1,215,39,74,1,2,38,72,40,53,26,30,56,3,3,3,12,23,119
111,DeSagana Diop,C,27,TOT,75,1,1036,74,171,0,0,74,171,22,66,114,159,273,32,29,56,39,128,170
112,Juan Dixon,PG,30,WAS,50,6,816,101,256,25,75,76,181,34,39,8,59,67,118,35,6,70,74,261
113,Keyon Dooling,PG,28,NJN,77,18,2074,261,598,99,235,162,363,127,154,24,131,155,270,71,8,105,135,748
114,Joey Dorsey,PF,25,HOU,3,0,6,1,2,0,0,1,2,0,0,0,1,1,1,0,0,0,0,2
115,Quincy Douby,PG,24,TOT,27,0,300,42,110,14,46,28,64,17,19,6,26,32,25,5,5,13,27,115
116,Chris Douglas-Roberts,SG,22,NJN,44,3,585,81,176,3,12,78,164,51,62,14,36,50,52,12,7,31,34,216
117,Goran Dragić,PG,22,PHO,55,1,728,88,224,20,54,68,170,50,65,33,70,103,111,29,3,73,87,246
118,Jared Dudley,SF,23,TOT,68,7,1155,136,285,29,74,107,211,71,105,82,123,205,56,57,8,43,105,372
119,Chris Duhon,PG,26,NYK,79,78,2906,287,681,127,325,160,356,179,209,45,201,246,566,72,7,221,126,880
120,Tim Duncan,C,32,SAS,75,75,2524,558,1107,0,2,558,1105,334,483,201,599,800,264,38,126,165,173,1450
121,Mike Dunleavy,SG,28,IND,18,14,495,93,232,32,90,61,142,53,65,14,54,68,44,12,9,38,36,271
122,Kevin Durant,SF,20,OKC,74,74,2885,661,1390,97,230,564,1160,452,524,77,405,482,205,96,53,225,134,1871
123,Monta Ellis,SG,23,GSW,25,25,892,194,430,8,26,186,404,78,94,14,94,108,93,39,8,67,67,474
124,Francisco Elson,C,32,MIL,59,23,977,83,169,1,4,82,165,33,39,100,129,229,32,36,36,48,144,200
125,Melvin Ely,C,30,NOH,31,4,373,37,95,0,0,37,95,23,36,30,34,64,18,2,9,23,58,97
126,Maurice Evans,SF,30,ATL,80,25,1840,208,482,98,248,110,234,60,73,88,155,243,54,50,10,43,163,574
127,Reggie Evans,PF,28,PHI,79,7,1137,79,178,0,1,79,177,104,175,135,226,361,26,41,8,69,161,262
128,Jordan Farmar,PG,22,LAL,65,0,1192,161,412,49,146,112,266,45,77,22,95,117,155,57,10,87,105,416
129,Desmon Farmer,SG,27,SAS,3,0,54,4,14,3,12,1,2,2,2,0,6,6,2,0,0,4,6,13
130,Raymond Felton,PG,24,CHA,82,81,3086,442,1083,59,207,383,876,219,272,54,256,310,553,126,30,228,191,1162
131,Rudy Fernández,SG,23,POR,78,4,1993,268,630,159,398,109,232,120,143,47,160,207,159,69,12,86,111,815
132,Kyrylo Fesenko,C,22,UTA,21,1,156,21,36,0,0,21,36,7,21,14,23,37,4,7,15,9,35,49
133,Michael Finley,SF,35,SAS,81,77,2336,301,689,131,319,170,370,51,62,26,244,270,114,37,17,61,82,784
134,Derek Fisher,PG,34,LAL,82,82,2441,292,688,120,302,172,386,110,130,25,163,188,261,95,6,72,187,814
135,T.J. Ford,PG,25,IND,74,49,2258,413,913,35,104,378,809,245,281,59,200,259,392,89,16,180,180,1106
136,Jeff Foster,C,32,IND,74,26,1828,177,353,2,7,175,346,96,146,215,293,508,130,53,49,88,229,452
137,Randy Foye,SG,25,MIN,70,61,2494,399,981,111,308,288,673,230,272,34,180,214,303,72,26,150,201,1139
138,Adonal Foyle,C,33,TOT,10,0,62,7,11,0,0,7,11,3,6,9,17,26,1,0,8,3,5,17
139,Channing Frye,PF,25,POR,63,1,746,113,267,11,33,102,234,26,36,41,99,140,24,17,16,29,106,263
140,Dan Gadzuric,C,30,MIL,67,26,941,117,244,0,2,117,242,37,68,95,160,255,39,32,43,41,162,271
141,Danilo Gallinari,SG,20,NYK,28,2,412,56,125,32,72,24,53,26,27,13,42,55,15,14,4,15,48,170
142,Francisco García,SF,27,SAC,65,36,1975,295,665,88,221,207,444,146,178,56,162,218,150,80,67,112,196,824
143,Thomas Gardner,SG,23,ATL,16,0,98,9,36,4,23,5,13,2,4,0,7,7,2,4,1,3,4,24
144,Kevin Garnett,PF,32,BOS,57,57,1772,393,740,2,8,391,732,111,132,78,407,485,144,63,68,90,128,899
145,Marc Gasol,C,24,MEM,82,75,2521,350,661,0,1,350,660,275,375,201,404,605,143,63,90,164,265,975
146,Pau Gasol,C,28,LAL,81,81,2999,592,1045,1,2,591,1043,343,439,262,518,780,284,52,81,157,172,1528
147,Rudy Gay,SF,22,MEM,79,78,2945,572,1262,85,242,487,1020,264,344,109,328,437,135,98,59,203,221,1493
148,Devean George,SF,31,DAL,43,17,708,54,142,22,76,32,66,17,22,25,53,78,15,23,11,17,57,147
149,Daniel Gibson,PG,22,CLE,75,0,1795,206,527,108,283,98,244,66,86,31,124,155,132,44,16,61,163,586
150,J.R. Giddens,SF,23,BOS,6,0,8,2,3,0,0,2,3,0,0,2,1,3,0,1,0,1,1,4
151,Eddie Gill,PG,30,MIL,6,0,43,6,9,2,3,4,6,0,0,0,4,4,11,3,1,5,10,14
152,Manu Ginóbili,SG,31,SAS,44,7,1181,223,491,69,209,154,282,168,190,24,174,198,157,64,16,88,90,683
153,Ryan Gomes,SF,26,MIN,82,76,2614,420,974,106,285,314,689,146,181,106,286,392,135,63,22,128,183,1092
154,Drew Gooden,PF,27,TOT,51,28,1264,237,506,0,4,237,502,131,156,113,249,362,48,30,18,76,144,605
155,Ben Gordon,SG,25,CHI,82,76,2999,598,1315,173,422,425,893,330,382,52,231,283,279,71,22,200,184,1699
156,Eric Gordon,SG,20,LAC,78,65,2677,411,901,131,337,280,564,299,350,45,156,201,215,78,35,164,172,1252
157,Marcin Gortat,PF,24,ORL,63,3,794,106,187,1,1,105,186,26,45,96,190,286,14,18,53,25,111,239
158,Joey Graham,SF,26,TOR,78,10,1541,231,480,3,16,228,464,132,160,95,197,292,48,35,12,74,191,597
159,Stephen Graham,SG,26,IND,52,6,684,106,256,20,66,86,190,50,62,21,75,96,33,10,4,45,82,282
160,Danny Granger,SF,25,IND,67,66,2424,571,1277,182,450,389,827,404,460,49,292,341,183,69,97,165,207,1728
161,Aaron Gray,C,24,CHI,56,18,715,81,167,0,1,81,166,34,59,84,136,220,46,14,18,40,135,196
162,Gerald Green,SG,23,DAL,38,12,376,79,180,14,46,65,134,27,32,14,40,54,15,10,5,33,51,199
163,Jeff Green,PF,22,OKC,78,78,2873,476,1068,96,247,380,821,242,307,120,399,519,155,81,33,173,202,1290
164,Willie Green,SG,27,PHI,81,60,1828,286,658,51,161,235,497,62,85,29,97,126,158,53,13,64,154,685
165,Donté Greene,SF,20,SAC,55,4,725,77,236,26,100,51,136,29,34,19,67,86,30,16,14,37,68,209
166,Hamed Haddadi,C,23,MEM,19,0,120,15,31,0,0,15,31,18,30,16,31,47,8,1,12,9,20,48
167,Malik Hairston,SG,21,SAS,15,0,155,24,49,0,1,24,48,2,7,11,17,28,13,6,7,12,19,50
168,Richard Hamilton,SG,30,DET,67,51,2279,466,1043,70,190,396,853,223,263,44,163,207,297,40,4,133,176,1225
169,Matt Harpring,SG,32,UTA,63,2,693,111,241,0,2,111,239,55,72,47,76,123,28,29,9,29,102,277
170,Al Harrington,PF,28,TOT,73,56,2546,532,1212,171,470,361,742,234,295,99,356,455,102,88,22,161,227,1469
171,Devin Harris,PG,25,NJN,69,69,2494,455,1039,64,220,391,819,496,605,30,201,231,476,114,13,212,164,1470
172,Jason Hart,PG,30,TOT,39,2,348,30,94,0,6,30,88,18,23,13,33,46,48,12,4,22,39,78
173,Udonis Haslem,PF,28,MIA,75,75,2560,333,643,0,0,333,643,128,170,169,449,618,85,43,25,82,204,794
174,Trenton Hassell,SF,29,NJN,53,31,1094,86,191,2,8,84,183,20,25,50,96,146,51,21,16,30,92,194
175,Spencer Hawes,C,20,SAC,77,51,2259,373,800,40,115,333,685,90,136,148,401,549,149,44,93,160,249,876
176,Chuck Hayes,C,25,HOU,71,1,858,42,113,0,4,42,109,7,19,74,176,250,42,34,19,25,134,91
177,Jarvis Hayes,SF,27,NJN,74,1,1832,257,577,94,244,163,333,36,52,27,240,267,54,52,7,49,162,644
178,Brendan Haywood,C,29,WAS,6,5,175,24,50,0,0,24,50,10,21,13,31,44,8,4,15,9,14,58
180,Walter Herrmann,SF,29,DET,59,0,630,82,207,41,120,41,87,19,25,28,79,107,22,7,4,17,43,224
181,Roy Hibbert,C,22,IND,70,42,1009,198,420,0,0,198,420,98,147,115,128,243,49,20,76,55,215,494
182,J.J. Hickson,C,20,CLE,62,0,705,100,194,0,0,100,194,45,67,52,113,165,9,14,30,45,81,245
183,Nenê Hilário,C,26,DEN,77,76,2510,428,709,1,5,427,704,266,368,183,415,598,108,95,101,147,278,1123
184,George Hill,PG,22,SAS,77,7,1270,150,372,24,73,126,299,114,146,30,128,158,136,45,21,74,150,438
185,Grant Hill*,SF,36,PHO,82,68,2445,390,745,24,76,366,669,181,224,64,341,405,186,90,54,126,182,985
186,Steven Hill,PF,23,OKC,1,0,2,1,1,0,0,1,1,0,0,2,1,3,0,0,0,0,0,2
187,Kirk Hinrich,SG,28,CHI,51,4,1339,183,419,69,169,114,250,68,86,16,107,123,197,66,19,87,126,503
188,Ryan Hollins,C,24,TOT,45,3,444,50,94,0,0,50,94,43,72,46,51,97,7,7,32,24,78,143
189,Al Horford,C,22,ATL,67,67,2242,312,594,0,1,312,593,149,205,145,479,624,163,53,95,103,190,773
190,Eddie House,PG,30,BOS,81,0,1479,249,560,151,340,98,220,42,53,11,146,157,92,61,7,55,113,691
191,Dwight Howard,C,23,ORL,79,79,2821,560,979,0,2,560,977,504,849,336,757,1093,112,77,231,240,270,1624
192,Josh Howard,SF,28,DAL,52,51,1663,353,783,58,168,295,615,172,220,59,204,263,83,55,30,89,135,936
195,Kris Humphries,SF,23,TOR,29,0,265,38,90,0,0,38,90,38,48,24,46,70,10,8,6,8,31,114
196,Lindsey Hunter,PG,38,CHI,28,0,266,27,82,16,48,11,34,3,5,2,10,12,37,20,1,19,28,73
197,Othello Hunter,PF,22,ATL,16,0,92,11,20,0,0,11,20,0,5,9,15,24,1,2,5,2,11,22
198,Andre Iguodala,SF,25,PHI,82,82,3269,542,1147,80,261,462,886,377,521,92,379,471,434,131,36,222,152,1541
199,Zydrunas Ilgauskas,C,33,CLE,65,65,1765,342,724,15,39,327,685,139,174,157,333,490,64,28,84,90,183,838
200,Didier Ilunga-Mbenga,C,28,LAL,23,0,181,27,57,0,1,27,56,7,8,9,22,31,9,10,24,13,33,61
202,Royal Ivey,SG,27,PHI,71,0,861,69,208,39,114,30,94,34,43,19,57,76,43,36,7,23,76,211
203,Jarrett Jack,SG,25,IND,82,53,2716,386,853,78,221,308,632,224,263,44,232,276,338,88,17,184,179,1074
204,Bobby Jackson,PG,35,SAC,71,10,1484,193,485,60,197,133,288,86,101,42,158,200,143,62,4,66,100,532
205,Darnell Jackson,PF,23,CLE,51,2,430,37,86,0,2,37,84,24,35,32,55,87,8,10,4,14,77,98
206,Stephen Jackson,SF,30,GSW,59,59,2339,413,997,103,305,310,692,294,356,70,233,303,381,88,31,229,153,1223
207,Jerome James,C,33,NYK,2,0,10,3,8,0,0,3,8,0,0,1,2,3,0,1,1,1,2,6
208,LeBron James,SF,24,CLE,81,81,3054,789,1613,132,384,657,1229,594,762,106,507,613,587,137,93,241,139,2304
209,Mike James,PG,33,TOT,61,50,1649,197,514,69,184,128,330,68,82,25,108,133,201,44,6,94,108,531
210,Antawn Jamison,PF,32,WAS,81,81,3096,674,1441,112,319,562,1122,341,452,196,525,721,153,95,25,125,218,1801
211,Marko Jarić,SG,30,MEM,53,0,605,48,145,11,28,37,117,29,41,23,42,65,74,29,11,49,62,136
212,Nathan Jawai,PF,22,TOR,6,0,19,1,4,0,0,1,4,0,0,1,1,2,0,0,0,2,3,2
213,Al Jefferson,C,24,MIN,50,50,1836,485,975,0,4,485,971,186,252,172,376,548,79,39,83,92,141,1156
214,Dontell Jefferson,SG,25,CHA,6,0,84,11,22,1,2,10,20,6,9,1,11,12,9,4,1,6,9,29
215,Richard Jefferson,SF,28,MIL,82,82,2939,537,1222,116,292,421,930,417,518,57,317,374,199,66,14,165,252,1607
216,Jared Jeffries,SF,27,NYK,56,36,1310,120,273,1,12,119,261,55,90,128,103,231,80,47,33,65,153,296
217,Yi Jianlian,PF,21,NJN,61,52,1421,191,500,48,140,143,360,95,123,67,259,326,60,29,36,70,157,525
218,Amir Johnson,PF,21,DET,62,24,911,97,163,0,0,97,163,23,35,102,130,232,20,20,60,33,171,217
219,Anthony Johnson,PG,34,ORL,80,12,1481,154,381,52,133,102,248,61,81,29,118,147,200,46,5,82,111,421
220,Joe Johnson,SG,27,ATL,79,79,3124,620,1420,149,414,471,1006,299,362,65,281,346,455,84,19,195,176,1688
221,Linton Johnson,PF,28,TOT,10,0,55,4,11,1,2,3,9,0,0,3,5,8,2,1,0,2,7,9
222,Trey Johnson,SG,24,CLE,4,0,14,0,5,0,0,0,5,4,4,0,1,1,0,0,0,1,4,4
223,Dahntay Jones,SG,28,DEN,79,71,1426,154,336,11,17,143,319,110,151,58,110,168,78,49,19,68,199,429
224,Damon Jones,PG,32,MIL,18,0,108,11,34,11,28,0,6,0,0,0,6,6,7,3,0,6,4,33
225,Dwayne Jones,PF,25,CHA,6,0,52,4,7,0,0,4,7,4,6,6,6,12,0,0,1,4,6,12
226,Fred Jones,SF,29,LAC,52,21,1495,129,317,54,147,75,170,66,81,23,103,126,188,53,11,66,112,378
227,James Jones,SF,28,MIA,40,1,630,55,149,33,96,22,53,26,31,12,50,62,20,12,14,12,58,169
228,Solomon Jones,C,24,ATL,63,0,675,67,111,1,2,66,109,53,74,52,90,142,15,7,34,27,125,188
229,DeAndre Jordan,C,20,LAC,53,13,771,93,147,0,0,93,147,42,109,72,165,237,11,11,59,41,96,228
230,Chris Kaman,C,26,LAC,31,24,921,161,305,0,0,161,305,51,75,75,172,247,46,17,45,84,93,373
231,Jason Kapono,SG,27,TOR,80,12,1831,261,604,98,229,163,375,34,42,26,137,163,105,22,3,70,144,654
232,Jason Kidd*,PG,35,DAL,81,81,2886,257,618,131,323,126,295,86,105,85,415,500,702,160,39,185,168,731
233,Tarence Kinsey,SG,24,CLE,50,3,277,31,69,7,18,24,51,33,38,10,28,38,10,12,0,22,34,102
234,Andrei Kirilenko,PF,27,UTA,67,10,1831,256,570,20,73,236,497,244,311,84,235,319,175,83,77,121,127,776
235,Linas Kleiza,SF,24,DEN,82,7,1824,289,646,87,267,202,379,148,204,92,235,327,64,31,14,82,155,813
236,Brevin Knight,PG,33,UTA,74,0,938,66,189,0,6,66,183,48,64,13,75,88,190,68,4,66,98,180
237,Kyle Korver,SF,27,UTA,78,2,1874,245,560,103,267,142,293,112,127,35,223,258,137,47,30,90,170,705
238,Kosta Koufos,C,19,UTA,48,7,565,94,185,0,0,94,185,36,51,50,88,138,20,12,31,26,70,224
239,Nenad Krstić,C,25,OKC,46,29,1141,191,407,0,0,191,407,63,79,85,168,253,29,21,49,45,114,445
240,Rob Kurz,SF,23,GSW,40,5,442,51,131,15,38,36,93,40,50,33,48,81,20,14,19,16,78,157
241,Carl Landry,PF,25,HOU,69,0,1467,240,418,1,3,239,415,157,193,124,219,343,39,26,31,68,166,638
242,Acie Law,PG,24,ATL,55,1,560,52,139,9,29,43,110,49,60,6,52,58,86,11,3,29,43,162
243,Courtney Lee,SG,23,ORL,77,42,1939,243,540,82,203,161,337,78,94,18,160,178,91,76,14,69,157,646
244,David Lee,C,25,NYK,81,74,2824,522,951,0,3,522,948,249,330,256,695,951,174,80,22,150,260,1293
245,Rashard Lewis,PF,29,ORL,79,79,2859,478,1089,220,554,258,535,225,269,92,361,453,205,81,51,158,194,1401
246,Shaun Livingston,PG,23,TOT,12,1,231,31,60,0,0,31,60,9,10,3,25,28,20,7,2,9,12,71
247,Brook Lopez,C,20,NJN,82,75,2501,448,844,0,2,448,842,172,217,225,440,665,86,44,151,147,257,1068
248,Robin Lopez,C,20,PHO,60,7,614,71,137,0,1,71,136,47,68,52,66,118,8,11,41,28,97,189
249,Kevin Love,C,20,MIN,81,37,2048,316,688,2,19,314,669,265,336,274,460,734,84,35,50,118,205,899
250,Kyle Lowry,PG,22,TOT,77,21,1679,189,434,25,98,164,336,181,226,26,163,189,275,69,17,117,146,584
251,Tyronn Lue,PG,31,TOT,44,0,521,71,162,27,62,44,100,14,19,6,40,46,60,8,0,23,54,183
252,Mark Madsen,C,33,MIN,19,1,116,3,14,0,0,3,14,0,4,10,8,18,4,1,1,3,18,6
253,Corey Maggette,PF,29,GSW,51,19,1588,292,634,24,95,268,539,342,415,49,233,282,92,44,8,120,192,950
254,Jamaal Magloire,C,30,MIA,55,12,709,65,131,0,0,65,131,29,60,82,140,222,22,11,25,32,121,159
255,Stephon Marbury,PG,31,BOS,23,4,414,38,111,6,25,32,86,6,13,2,26,28,75,10,3,37,34,88
256,Shawn Marion,SF,30,TOT,69,68,2470,382,788,10,53,372,735,117,147,180,409,589,139,88,66,105,132,891
257,Sean Marks,C,33,NOH,60,5,838,80,165,2,10,78,155,30,44,62,125,187,14,7,33,35,121,192
258,Donyell Marshall,PF,35,PHI,25,0,189,33,73,25,55,8,18,3,6,6,34,40,15,4,5,6,24,94
259,Cartier Martin,SF,24,CHA,33,1,266,28,77,10,33,18,44,20,25,7,26,33,13,8,4,9,33,86
260,Kenyon Martin,PF,31,DEN,66,66,2111,318,648,14,38,304,610,119,197,81,314,395,132,96,74,104,201,769
261,Kevin Martin,SG,25,SAC,51,46,1947,341,811,115,277,226,534,457,527,29,154,183,138,61,8,146,116,1254
262,Desmond Mason,SG,31,OKC,39,19,1064,124,285,0,3,124,282,46,85,41,116,157,46,15,30,56,96,294
263,Roger Mason,SG,28,SAS,82,71,2496,349,822,166,394,183,428,105,118,16,235,251,173,40,12,100,160,969
264,Jason Maxiell,C,25,DET,78,4,1408,184,320,0,1,184,319,84,158,169,155,324,24,25,63,45,157,452
265,Sean May,PF,24,CHA,24,12,301,39,98,1,1,38,97,14,20,20,49,69,10,5,4,26,32,93
266,O.J. Mayo,SG,21,MEM,82,82,3120,562,1283,145,378,417,905,247,281,56,252,308,262,91,13,226,204,1516
267,Luc Mbah a Moute,PF,22,MIL,82,52,2114,227,491,0,4,227,487,140,192,189,298,487,87,87,45,100,204,594
268,Rashad McCants,SG,24,TOT,58,3,1101,192,488,63,189,129,299,107,141,21,89,110,68,47,14,64,103,554
269,Antonio McDyess,PF,34,DET,62,30,1866,268,525,0,0,268,525,60,86,185,422,607,83,41,50,51,191,596
270,JaVale McGee,C,21,WAS,75,14,1143,191,387,0,0,191,387,107,162,120,174,294,23,33,75,61,155,489
271,Tracy McGrady*,SG,29,HOU,35,35,1181,188,485,44,117,144,368,125,156,20,134,154,175,42,15,69,38,545
272,Dominic McGuire,SF,23,WAS,79,57,2072,140,324,2,4,138,320,74,102,113,315,428,198,62,74,92,153,356
273,Josh McRoberts,PF,21,IND,33,0,279,35,83,0,10,35,73,10,13,26,48,74,16,12,16,12,41,80
274,Pops Mensah-Bonsu,PF,25,TOT,22,0,283,39,103,0,2,39,101,33,48,55,58,113,6,9,5,19,43,111
275,Chris Mihm,C,29,LAL,18,0,105,15,40,0,0,15,40,6,7,15,19,34,10,1,6,10,23,36
276,C.J. Miles,SG,21,UTA,72,72,1623,258,562,63,179,195,383,78,89,45,122,167,107,46,15,64,187,657
277,Darius Miles,SF,27,MEM,34,0,298,48,99,1,6,47,93,23,31,19,38,57,17,11,20,21,32,120
278,Darko Miličić,C,23,MEM,61,15,1034,137,266,0,0,137,266,59,105,83,181,264,34,22,51,48,134,333
279,Andre Miller,PG,32,PHI,82,82,2976,492,1041,15,53,477,988,338,409,123,245,368,534,109,14,199,196,1337
280,Brad Miller,C,32,TOT,70,43,2100,292,614,23,56,269,558,224,272,150,395,545,234,52,36,130,223,831
281,Mike Miller,SF,28,MIN,73,47,2356,264,548,85,225,179,323,109,149,73,410,483,326,30,31,145,139,722
282,Paul Millsap,PF,23,UTA,76,38,2290,400,749,0,4,400,745,228,326,251,403,654,138,78,73,129,288,1028
283,Yao Ming*,C,28,HOU,77,77,2589,566,1032,1,1,565,1031,381,440,204,557,761,137,30,150,234,257,1514
284,Cuttino Mobley,SG,33,LAC,11,11,365,63,146,12,35,51,111,13,18,9,20,29,12,15,2,18,21,151
285,Nazr Mohammed,C,31,CHA,39,1,341,41,101,0,0,41,101,22,40,35,44,79,8,5,16,23,63,104
286,Jamario Moon,SF,28,TOT,80,60,2068,222,474,65,183,157,291,68,80,58,307,365,95,86,60,43,133,577
288,Randolph Morris,C,23,ATL,23,0,89,7,17,0,0,7,17,4,4,4,16,20,2,2,1,7,25,18
289,Adam Morrison,SF,24,TOT,52,5,711,80,223,32,96,48,127,17,23,18,62,80,41,9,4,32,77,209
290,Anthony Morrow,SG,23,GSW,67,17,1515,255,534,86,184,169,350,80,92,78,121,199,80,36,12,52,130,676
291,Troy Murphy,PF,28,IND,73,73,2482,364,767,161,358,203,409,152,184,146,715,861,172,58,34,114,226,1041
292,Ronald Murray,SG,29,ATL,80,2,1975,355,795,87,242,268,553,177,233,22,146,168,158,88,17,128,173,974
293,Dikembe Mutombo*,C,42,HOU,9,2,96,5,13,0,0,5,13,6,9,12,21,33,0,0,11,6,11,16
294,Eduardo Nájera,PF,32,NJN,27,0,319,33,74,5,25,28,49,8,22,17,50,67,19,10,4,18,50,79
295,Steve Nash*,PG,34,PHO,74,74,2484,428,851,108,246,320,605,196,210,19,204,223,717,55,10,248,108,1160
296,DeMarcus Nelson,PG,23,GSW,13,5,171,24,54,0,3,24,51,5,14,6,18,24,13,9,2,15,24,53
297,Jameer Nelson,PG,26,ORL,42,42,1309,267,531,82,181,185,350,86,97,20,125,145,226,51,3,83,123,702
298,Rasho Nesterović,C,32,IND,70,19,1214,224,437,0,1,224,436,25,32,93,147,240,109,30,38,63,171,473
299,Demetris Nichols,SF,24,TOT,4,0,14,3,9,0,2,3,7,1,2,0,2,2,1,0,1,0,1,7
300,Joakim Noah,C,23,CHI,80,55,1938,207,372,0,1,207,371,123,182,244,362,606,106,49,110,82,238,537
302,Steve Novak,PF,25,LAC,71,3,1161,176,396,119,286,57,110,21,23,19,106,125,40,20,5,23,71,492
303,Dirk Nowitzki,PF,30,DAL,81,81,3050,774,1616,61,170,713,1446,485,545,88,593,681,197,61,63,157,176,2094
304,Patrick O'Bryant,C,22,TOT,39,3,255,45,84,0,2,45,82,11,20,13,53,66,11,6,19,22,61,101
305,Jermaine O'Neal,C,30,TOT,68,61,2027,365,770,0,1,365,769,175,222,126,307,433,122,29,136,144,211,905
306,Shaquille O'Neal*,C,36,PHO,75,75,2252,512,841,0,1,512,840,309,519,187,446,633,126,49,108,168,253,1333
307,Fabricio Oberto,C,33,SAS,54,11,677,61,104,0,1,61,103,20,35,65,77,142,59,7,11,38,95,142
308,Greg Oden,C,21,POR,61,39,1314,198,351,0,0,198,351,144,226,169,255,424,31,25,69,87,238,540
309,Lamar Odom,PF,29,LAL,78,32,2316,346,703,33,103,313,600,160,257,176,461,637,204,77,98,138,235,885
310,Emeka Okafor,C,26,CHA,82,81,2691,433,772,0,0,433,772,219,369,275,552,827,53,48,136,144,247,1085
311,Mehmet Okur,C,29,UTA,72,72,2409,431,888,90,202,341,686,273,334,124,433,557,120,54,53,132,219,1225
312,Kevin Ollie,PG,36,MIN,50,21,850,61,150,0,1,61,149,80,96,13,62,75,117,19,4,34,79,202
313,Travis Outlaw,SF,24,POR,81,6,2246,385,850,89,236,296,614,175,242,70,261,331,83,47,57,94,168,1034
314,Zaza Pachulia,C,24,ATL,77,26,1473,159,320,0,3,159,317,163,230,173,263,436,57,35,26,91,208,481
315,Anthony Parker,SG,33,TOR,80,71,2637,321,754,94,241,227,513,121,145,45,272,317,269,100,15,114,145,857
316,Tony Parker,PG,26,SAS,72,71,2456,639,1263,19,65,620,1198,284,363,27,196,223,496,67,4,186,110,1581
317,Chris Paul,PG,23,NOH,78,78,3002,631,1255,64,176,567,1079,455,524,69,363,432,861,216,10,231,212,1781
318,Sasha Pavlović,SF,25,CLE,66,12,1053,116,275,48,117,68,158,25,54,31,96,127,72,22,16,48,122,305
319,Oleksiy Pecherov,C,23,WAS,32,0,277,39,101,14,43,25,58,24,29,35,41,76,2,6,3,10,34,116
320,Kendrick Perkins,C,24,BOS,76,76,2253,276,478,0,2,276,476,96,160,204,415,619,96,22,150,165,253,648
321,Morris Peterson,SG,31,NOH,43,9,515,73,183,33,85,40,98,12,19,13,71,84,16,15,2,15,51,191
322,Johan Petro,C,23,TOT,49,22,559,73,176,0,2,73,174,16,29,42,116,158,16,19,15,28,107,162
323,Paul Pierce,SF,31,BOS,81,81,3035,540,1181,119,304,421,877,459,553,56,401,457,294,80,27,228,215,1658
324,Mickaël Piétrus,SG,26,ORL,54,25,1329,176,426,80,223,96,203,78,110,44,132,176,65,31,24,56,126,510
325,James Posey,SG,32,NOH,75,0,2140,216,524,116,314,100,210,120,146,38,324,362,82,58,21,79,216,668
326,Leon Powe,PF,25,BOS,70,7,1227,177,338,0,0,177,338,184,267,145,200,345,46,24,38,76,192,538
327,Josh Powell,PF,26,LAL,60,1,703,106,239,0,0,106,239,38,50,71,105,176,27,9,17,51,98,250
328,Ronnie Price,PG,25,UTA,52,17,738,77,203,19,61,58,142,34,45,12,57,69,108,39,5,61,74,207
329,Tayshaun Prince,SF,28,DET,82,82,3057,459,1020,56,141,403,879,189,243,128,348,476,253,44,51,101,104,1163
330,Gabe Pruitt,SG,22,BOS,47,0,366,31,101,14,48,17,53,17,21,9,34,43,39,15,3,19,34,93
331,Joel Przybilla,C,29,POR,82,43,1952,168,269,0,1,168,268,112,169,204,513,717,27,34,97,78,215,448
332,Chris Quinn,PG,25,MIA,66,0,962,118,289,56,137,62,152,47,58,8,67,75,132,24,2,33,79,339
333,Vladimir Radmanović,SF,28,TOT,78,31,1445,196,466,105,262,91,204,43,58,45,177,222,81,46,15,98,111,540
334,Anthony Randolph,PF,19,GSW,63,22,1129,199,431,0,4,199,427,101,141,128,235,363,49,42,74,80,141,499
335,Shavlik Randolph,PF,25,POR,10,0,37,8,13,1,1,7,12,1,4,10,8,18,0,0,1,6,4,18
337,Theo Ratliff,C,35,PHI,46,0,579,34,64,0,0,34,64,21,35,46,82,128,9,17,47,14,77,89
338,Michael Redd,SG,29,MIL,33,32,1203,249,547,70,191,179,356,131,161,24,83,107,88,35,2,53,45,699
339,J.J. Redick,SG,24,ORL,64,5,1111,117,299,67,179,50,120,81,93,8,101,109,73,21,1,54,72,382
340,Jason Richardson,SG,28,TOT,72,71,2410,465,974,129,325,336,649,153,199,77,242,319,146,76,28,95,146,1212
341,Jeremy Richardson,SF,24,ORL,12,0,93,14,49,6,17,8,32,3,6,1,13,14,3,0,0,3,6,37
342,Quentin Richardson,SG,28,NYK,72,51,1894,262,667,120,329,142,338,89,117,71,248,319,117,47,7,74,132,733
343,Luke Ridnour,PG,27,MIL,72,50,2033,250,621,55,157,195,464,133,153,33,185,218,365,92,16,128,200,688
344,Anthony Roberson,PG,25,TOT,29,0,276,44,120,26,81,18,39,5,5,6,16,22,20,10,1,8,18,119
345,Nate Robinson,PG,24,NYK,74,11,2209,449,1028,125,385,324,643,249,296,98,192,290,301,95,6,139,206,1272
346,Sergio Rodríguez,PG,22,POR,80,13,1225,129,329,37,114,92,215,61,77,43,87,130,286,54,2,119,133,356
347,Rajon Rondo,PG,22,BOS,80,80,2642,383,759,15,48,368,711,172,268,100,316,416,659,149,11,209,193,953
348,Derrick Rose,PG,20,CHI,81,80,3000,574,1208,16,72,558,1136,197,250,96,221,317,512,66,18,202,125,1361
350,Quinton Ross,SF,27,MEM,68,7,1164,99,259,33,88,66,171,34,42,29,97,126,47,32,14,36,114,265
351,Brandon Roy,SG,24,POR,78,78,2903,633,1318,83,220,550,1098,416,505,104,266,370,400,88,22,152,127,1765
352,Michael Ruffin,PF,32,POR,11,0,35,2,7,0,0,2,7,2,2,6,5,11,0,3,1,2,7,6
353,Brandon Rush,SG,23,IND,75,19,1803,243,575,78,209,165,366,46,66,34,199,233,66,38,37,75,128,610
354,Kareem Rush,SG,28,PHI,25,1,199,20,58,10,33,10,25,4,4,0,15,15,15,5,1,10,10,54
355,John Salmons,SF,29,TOT,79,74,2959,516,1093,126,302,390,791,288,347,59,274,333,249,83,24,165,182,1446
356,Cheikh Samb,C,24,TOT,18,0,83,6,32,0,3,6,29,3,7,10,14,24,1,3,10,3,7,15
357,Brian Scalabrine,C,30,BOS,39,8,504,48,114,24,61,24,53,16,18,7,43,50,18,7,10,12,73,136
358,Luis Scola,PF,28,HOU,82,82,2488,424,799,0,3,424,796,196,258,200,520,720,123,68,11,123,261,1044
360,Mouhamed Sene,C,22,TOT,6,0,29,6,9,0,0,6,9,8,10,5,9,14,0,1,3,4,2,20
361,Ramon Sessions,PG,22,MIL,79,39,2173,345,775,6,34,339,741,281,354,64,205,269,452,83,7,152,158,977
362,Walter Sharpe,PF,22,DET,8,0,20,4,11,0,2,4,9,0,2,0,3,3,0,0,2,0,3,8
363,Bobby Simmons,SF,28,NJN,71,44,1729,198,441,117,262,81,179,43,58,72,205,277,92,50,10,62,186,556
364,Cedric Simmons,PF,23,TOT,18,0,84,11,25,0,0,11,25,7,16,5,11,16,2,1,4,2,8,29
365,Courtney Sims,C,25,TOT,2,0,13,3,6,0,0,3,6,0,0,2,2,4,0,0,0,1,1,6
366,Sean Singletary,PG,23,TOT,37,2,303,31,85,10,25,21,60,18,21,10,25,35,29,11,0,23,45,90
367,James Singleton,PF,27,DAL,62,6,884,117,221,13,40,104,181,67,78,89,161,250,17,26,28,36,110,314
368,Brian Skinner,PF,32,LAC,51,21,843,92,205,0,2,92,203,30,47,72,131,203,27,17,52,43,94,214
369,Craig Smith,PF,25,MIN,74,31,1460,289,514,0,1,289,513,168,248,98,186,284,79,31,19,105,184,746
370,J.R. Smith,SG,23,DEN,81,18,2245,424,950,180,453,244,497,205,272,43,254,297,227,78,14,150,190,1233
371,Joe Smith,C,33,TOT,57,3,1102,156,333,3,7,153,326,59,82,89,174,263,41,17,40,25,122,374
372,Josh Smith,PF,23,ATL,69,69,2421,418,849,26,87,392,762,211,359,134,364,498,169,94,111,161,184,1073
373,Will Solomon,PG,30,TOT,53,9,712,105,245,28,86,77,159,25,34,12,52,64,133,27,4,54,71,263
374,Darius Songaila,C,30,WAS,77,29,1521,243,457,0,1,243,456,80,90,75,152,227,94,64,20,74,200,566
375,Marreese Speights,C,21,PHI,79,2,1263,252,502,2,8,250,494,102,132,123,170,293,30,27,56,46,181,608
376,Jerry Stackhouse,SG,34,DAL,10,1,162,16,60,3,19,13,41,7,7,5,12,17,12,4,1,9,6,42
377,DeShawn Stevenson,SG,27,WAS,32,25,886,72,231,35,129,37,102,32,60,11,65,76,98,21,2,32,43,211
378,Peja Stojaković,SF,31,NOH,61,59,2089,287,719,145,384,142,335,93,104,44,220,264,75,52,3,51,101,812
379,Amar'e Stoudemire,PF,26,PHO,53,53,1948,404,749,3,7,401,742,323,387,116,314,430,104,49,57,150,163,1134
380,Rodney Stuckey,PG,22,DET,79,65,2517,401,913,23,78,378,835,233,290,69,206,275,387,78,11,173,217,1058
381,Robert Swift,C,23,OKC,26,10,343,37,71,0,0,37,71,12,16,21,68,89,9,5,17,8,50,86
382,Stromile Swift,PF,29,TOT,19,0,185,24,56,1,1,23,55,13,26,16,30,46,3,4,8,16,40,62
383,Wally Szczerbiak,SF,31,CLE,74,5,1527,179,398,69,168,110,230,90,106,43,189,232,82,28,10,55,130,517
384,Mike Taylor,PG,23,LAC,51,5,771,110,267,13,40,97,227,56,81,22,65,87,106,36,0,73,84,289
385,Sebastian Telfair,PG,23,MIN,75,43,2095,267,697,73,211,194,486,131,160,32,95,127,343,73,12,146,184,738
386,Jason Terry,SG,31,DAL,74,11,2491,541,1168,167,456,374,712,198,225,39,138,177,251,97,20,119,141,1447
387,Etan Thomas,C,30,WAS,26,7,306,32,66,0,0,32,66,16,23,25,41,66,6,3,18,18,35,80
388,Kenny Thomas,PF,31,SAC,8,0,62,3,8,0,0,3,8,0,0,4,11,15,1,6,1,1,9,6
389,Kurt Thomas,PF,36,SAS,79,10,1404,153,304,0,2,153,302,37,45,134,271,405,66,34,58,42,170,343
390,Tim Thomas,PF,31,TOT,64,6,1247,189,438,78,189,111,249,89,121,42,159,201,68,31,11,70,144,545
391,Tyrus Thomas,PF,22,CHI,79,61,2175,308,683,3,9,305,674,238,304,148,360,508,77,91,151,129,220,857
392,Jason Thompson,PF,22,SAC,82,56,2303,356,717,0,8,356,709,198,286,234,372,606,93,46,59,146,314,910
393,Al Thornton,SF,25,LAC,71,67,2654,469,1051,20,79,449,972,236,313,122,246,368,103,59,62,130,227,1194
394,Anthony Tolliver,PF,23,SAS,19,0,208,19,65,9,41,10,24,5,10,12,29,41,17,5,1,7,16,52
395,Alando Tucker,SG,24,PHO,30,1,282,52,121,8,23,44,98,26,33,19,12,31,12,5,1,14,14,138
396,Ronny Turiaf,C,26,GSW,79,26,1696,186,366,0,3,186,363,98,124,88,272,360,166,34,168,70,243,470
397,Hedo Türkoğlu,SF,29,ORL,77,77,2815,423,1025,134,376,289,649,314,389,45,365,410,375,64,19,204,218,1294
398,Ime Udoka,SF,31,SAS,67,3,1035,110,287,41,125,69,162,28,46,28,159,187,54,36,12,38,86,289
399,Beno Udrih,PG,26,SAC,73,72,2270,321,696,35,113,286,583,123,150,46,174,220,342,81,12,158,192,800
400,Roko Ukić,PG,24,TOR,72,0,890,123,324,11,62,112,262,44,60,27,48,75,153,30,2,60,77,301
401,Anderson Varejão,PF,26,CLE,81,42,2306,270,504,0,2,270,502,154,250,166,415,581,81,75,66,80,239,694
402,Jacque Vaughn,PG,33,SAS,30,0,292,24,75,1,1,23,74,16,18,4,18,22,55,6,0,15,26,65
403,Charlie Villanueva,PF,24,MIL,78,47,2095,487,1089,89,258,398,831,201,240,154,366,520,137,50,56,138,254,1264
404,Jake Voskuhl,C,31,TOR,38,1,240,12,45,0,0,12,45,11,14,21,38,59,8,3,4,17,60,35
405,Sasha Vujačić,SG,24,LAL,80,0,1293,155,401,81,223,74,178,70,76,19,116,135,113,77,7,35,154,461
406,Dwyane Wade,SG,27,MIA,79,79,3048,854,1739,88,278,766,1461,590,771,89,309,398,589,173,106,272,178,2386
407,Von Wafer,SG,23,HOU,63,11,1225,229,512,64,164,165,348,88,117,19,94,113,71,40,8,59,71,610
408,Henry Walker,SF,21,BOS,29,0,216,36,58,0,1,36,57,16,23,8,21,29,13,6,2,18,51,88
409,Ben Wallace,PF,34,CLE,56,53,1314,69,155,0,0,69,155,27,64,136,226,362,44,48,75,34,82,165
410,Gerald Wallace,SF,26,CHA,71,71,2669,389,811,39,131,350,680,365,454,112,441,553,189,121,67,148,210,1182
411,Rasheed Wallace,C,34,DET,66,63,2123,302,720,113,319,189,401,78,101,56,434,490,91,62,86,59,197,795
412,Luke Walton,SF,28,LAL,65,34,1166,134,307,17,57,117,250,41,57,55,125,180,177,32,10,69,105,326
413,Hakim Warrick,PF,26,MEM,82,7,2029,340,693,5,23,335,670,266,374,129,277,406,66,48,39,98,170,951
414,C.J. Watson,PG,24,GSW,77,18,1883,257,562,48,120,209,442,168,193,39,153,192,206,96,4,92,137,730
415,Earl Watson,PG,29,OKC,68,18,1776,174,453,20,85,154,368,80,106,36,147,183,391,50,11,156,137,448
416,Kyle Weaver,SG,22,OKC,56,19,1166,113,246,32,93,81,153,41,58,31,99,130,101,47,25,69,81,299
417,Martell Webster,SF,22,POR,1,0,5,0,1,0,1,0,0,0,0,0,0,0,0,0,0,0,0,0
418,Sonny Weems,SG,22,DEN,12,0,55,8,25,0,3,8,22,3,8,0,4,4,3,1,0,6,8,19
419,David West,PF,28,NOH,76,76,2982,610,1292,6,25,604,1267,367,415,160,486,646,173,49,68,163,207,1593
420,Delonte West,SG,25,CLE,64,64,2152,285,624,91,228,194,396,90,108,31,172,203,226,94,13,92,125,751
421,Mario West,SG,24,ATL,53,3,269,14,34,1,1,13,33,14,30,24,32,56,19,18,4,13,35,43
422,Russell Westbrook,PG,20,OKC,82,65,2668,436,1095,35,129,401,966,349,428,178,221,399,435,110,16,274,191,1256
423,D.J. White,PF,22,OKC,7,0,130,26,50,0,0,26,50,10,13,10,22,32,6,3,5,3,10,62
424,James White,SF,26,HOU,4,0,11,3,5,1,2,2,3,0,0,0,0,0,1,1,1,3,2,7
425,Chris Wilcox,C,26,TOT,62,6,1049,184,370,0,4,184,366,79,140,96,181,277,47,26,16,75,137,447
426,Damien Wilkins,SG,29,OKC,41,14,636,77,213,27,72,50,141,37,46,20,50,70,37,22,7,37,55,218
427,Deron Williams,PG,24,UTA,68,68,2505,463,984,70,226,393,758,326,384,24,171,195,725,73,20,228,134,1322
428,Jawad Williams,SF,25,CLE,10,0,20,5,12,2,6,3,6,0,0,1,1,2,0,1,0,1,2,12
429,Lou Williams,SG,22,PHI,81,0,1919,336,844,63,220,273,624,304,385,36,129,165,242,85,14,151,128,1039
430,Marcus Williams,PG,23,GSW,9,0,54,4,17,2,6,2,11,2,6,0,4,4,13,1,1,4,6,12
432,Marvin Williams,SF,22,ATL,61,59,2093,285,622,55,155,230,467,220,273,110,272,382,81,57,39,70,127,845
433,Mo Williams,PG,26,CLE,81,81,2834,526,1126,183,420,343,706,208,228,47,232,279,329,69,9,179,215,1443
434,Sean Williams,PF,22,NJN,33,0,366,30,72,0,0,30,72,20,32,34,45,79,13,7,29,20,72,80
435,Shawne Williams,SF,22,DAL,15,0,170,16,56,1,17,15,39,9,11,19,27,46,2,2,9,5,19,42
436,Shelden Williams,PF,25,TOT,45,0,512,70,157,0,2,70,155,46,63,49,104,153,12,22,18,34,64,186
437,Metta World Peace,SF,29,HOU,69,55,2452,416,1037,153,383,263,654,196,262,65,294,359,229,105,24,140,155,1181
438,Antoine Wright,SF,24,DAL,65,53,1552,179,431,45,149,134,282,71,95,31,105,136,77,46,27,54,172,474
439,Brandan Wright,PF,21,GSW,39,23,688,130,246,0,4,130,242,63,85,62,95,157,21,22,37,23,74,323
440,Dorell Wright,SF,23,MIA,6,0,73,8,20,0,0,8,20,2,6,2,18,20,2,2,0,6,8,18
441,Julian Wright,SF,21,NOH,54,19,772,109,234,2,21,107,213,17,30,46,106,152,43,35,19,43,49,237
442,Lorenzen Wright,C,33,CLE,17,2,125,10,27,0,0,10,27,3,8,7,18,25,3,4,5,9,17,23
443,Nick Young,SG,23,WAS,82,5,1837,336,756,56,164,280,592,164,193,31,119,150,95,39,20,92,140,892
444,Thaddeus Young,PF,20,PHI,75,71,2580,475,960,56,164,419,796,139,189,139,238,377,86,100,23,118,165,1145
445,Sun Yue,SG,23,LAL,10,0,28,3,11,0,6,3,5,0,0,0,0,0,2,1,1,3,10,6
