Rk,Player,Pos,Age,Tm,G,GS,MP,FG,FGA,3P,3PA,2P,2PA,FT,FTA,ORB,DRB,TRB,AST,STL,BLK,TOV,PF,PTS
1,Jeff Adrien,PF,24,GSW,23,0,196,23,54,0,0,23,54,11,19,23,35,58,10,4,5,9,28,57
2,Arron Afflalo,SG,25,DEN,69,69,2324,312,627,105,248,207,379,138,163,45,206,251,168,34,31,71,153,867
3,Maurice Ager,SG,26,MIN,4,0,29,6,11,3,4,3,7,0,0,0,2,2,1,1,0,4,4,15
4,Alexis Ajinça,C,22,TOT,34,2,340,59,133,12,34,47,99,13,18,17,61,78,10,11,19,18,73,143
5,Solomon Alabi,C,22,TOR,12,0,59,3,15,0,0,3,15,0,2,7,7,14,2,2,2,3,5,6
6,Cole Aldrich,C,22,OKC,18,0,142,8,15,0,0,8,15,2,4,13,22,35,4,5,7,8,30,18
7,LaMarcus Aldridge,PF,25,POR,81,81,3211,707,1415,4,23,703,1392,351,444,278,431,709,170,82,94,153,220,1769
8,Malik Allen,PF,32,ORL,18,0,178,11,31,0,0,11,31,1,2,12,20,32,4,1,4,3,30,23
9,Ray Allen*,SG,35,BOS,80,80,2890,480,978,168,378,312,600,193,219,51,223,274,219,77,16,117,147,1321
10,Tony Allen,SG,29,MEM,72,31,1494,251,492,4,23,247,469,137,182,70,123,193,104,129,44,86,161,643
11,Al-Farouq Aminu,SF,20,LAC,81,14,1452,160,406,45,143,115,263,92,119,75,192,267,60,59,25,103,121,457
12,Lou Amundson,PF,28,GSW,46,7,691,83,183,0,0,83,183,34,87,81,104,185,17,14,33,24,87,200
13,Chris Andersen,C,32,DEN,45,0,732,82,137,0,1,82,136,86,135,75,144,219,20,23,58,25,79,250
14,David Andersen,PF,30,TOT,40,0,373,56,121,8,23,48,98,14,22,20,64,84,13,5,9,22,40,134
15,James Anderson,SF,21,SAS,26,2,286,31,81,18,46,13,35,14,18,2,21,23,18,3,6,13,24,94
16,Ryan Anderson,PF,22,ORL,64,14,1424,226,525,134,341,92,184,95,117,129,226,355,52,30,38,49,137,681
17,Carmelo Anthony,SF,26,TOT,77,77,2751,684,1503,95,251,589,1252,507,605,118,445,563,221,68,46,206,224,1970
18,Joel Anthony,C,28,MIA,75,11,1463,53,99,0,0,53,99,47,73,104,162,266,24,10,93,36,194,153
19,Gilbert Arenas,PG,29,TOT,70,16,1796,269,734,97,327,172,407,120,153,22,167,189,274,74,21,177,188,755
20,Trevor Ariza,SF,25,NOH,75,75,2600,303,762,82,271,221,491,138,197,61,347,408,162,120,31,118,180,826
21,Hilton Armstrong,C,26,TOT,53,2,488,37,76,2,4,35,72,16,33,42,89,131,14,18,21,28,84,92
22,Carlos Arroyo,PG,31,TOT,64,43,1185,120,273,31,69,89,204,39,47,20,83,103,125,21,1,60,71,310
23,Darrell Arthur,PF,22,MEM,80,9,1609,310,624,0,6,310,618,109,134,115,227,342,53,52,63,88,228,729
24,Ömer Aşık,C,24,CHI,82,0,989,78,141,0,0,78,141,73,145,112,194,306,32,20,56,64,153,229
25,D.J. Augustin,PG,23,CHA,82,82,2757,399,958,111,333,288,625,269,297,38,187,225,498,54,3,155,152,1178
26,Luke Babbitt,SF,21,POR,24,0,137,15,55,3,16,12,39,3,9,6,24,30,6,2,2,8,15,36
27,Renaldo Balkman,SF,26,TOT,8,0,62,6,13,1,2,5,11,3,4,2,5,7,2,4,2,1,15,16
28,Marcus Banks,PG,29,TOR,3,0,22,0,2,0,0,0,2,6,8,0,1,1,3,1,0,2,4,6
29,Leandro Barbosa,SG,28,TOR,58,0,1395,294,653,72,213,222,440,109,137,14,85,99,119,50,6,84,112,769
30,J.J. Barea,PG,26,DAL,81,2,1669,285,649,66,189,219,460,133,157,29,130,159,317,30,1,136,136,769
31,Andrea Bargnani,C,25,TOR,66,66,2353,525,1173,77,223,448,950,287,350,74,269,343,119,34,46,152,160,1414
32,Matt Barnes,SF,30,LAL,53,0,1020,131,279,34,107,97,172,60,77,73,155,228,71,39,22,58,127,356
33,Earl Barron,C,29,TOT,21,7,305,32,99,0,0,32,99,15,24,32,44,76,11,8,6,16,46,79
34,Brandon Bass,PF,25,ORL,76,51,1980,332,645,0,2,332,643,190,233,134,290,424,57,27,52,97,159,854
35,Tony Battie,C,34,PHI,38,0,377,45,96,2,3,43,93,8,14,17,82,99,12,5,15,12,59,100
36,Shane Battier,SF,32,TOT,82,59,2375,229,509,102,267,127,242,64,93,90,283,373,185,69,81,79,158,624
37,Nicolas Batum,SF,22,POR,80,67,2522,367,807,118,342,249,465,138,164,109,252,361,123,68,49,83,194,990
38,Jerryd Bayless,PG,22,TOT,71,14,1496,218,517,49,146,169,371,166,206,26,139,165,266,38,5,127,149,651
39,Michael Beasley,SF,22,MIN,73,73,2361,561,1246,60,164,501,1082,219,291,118,291,409,158,54,52,195,222,1401
40,Rodrigue Beaubois,PG,22,DAL,28,26,496,94,223,25,83,69,140,23,30,7,45,52,64,20,8,47,76,236
41,Marco Belinelli,SG,24,NOH,80,69,1957,302,691,134,324,168,367,98,125,17,134,151,92,38,6,77,146,836
42,Charlie Bell,SG,31,GSW,19,0,171,12,43,6,21,6,22,2,4,6,12,18,13,6,1,6,13,32
43,Raja Bell,SG,34,UTA,68,63,2097,191,467,68,193,123,274,91,102,31,145,176,118,56,14,63,169,541
44,Mike Bibby,PG,32,TOT,80,68,2285,248,576,153,348,95,228,39,62,17,178,195,265,50,9,101,175,688
45,Andris Biedriņš,C,24,GSW,59,55,1397,142,266,0,0,142,266,10,31,145,281,426,60,52,52,57,198,294
46,Chauncey Billups,PG,34,TOT,72,72,2310,339,794,146,363,193,431,384,419,25,165,190,387,71,14,177,146,1208
47,DeJuan Blair,PF,21,SAS,81,65,1734,292,583,0,2,292,581,90,137,215,350,565,77,95,42,113,213,674
48,Steve Blake,PG,30,LAL,79,0,1581,110,306,73,193,37,113,26,30,19,137,156,170,40,3,73,99,319
49,Andray Blatche,PF,24,WAS,64,63,2172,426,957,4,18,422,939,220,283,183,343,526,144,98,51,172,182,1076
50,Eric Bledsoe,PG,21,LAC,81,25,1841,206,486,32,116,174,370,99,133,68,155,223,289,92,26,194,130,543
51,Keith Bogans,SG,30,CHI,82,82,1461,124,307,90,237,34,70,21,32,19,129,148,101,38,9,41,113,359
52,Andrew Bogut,C,26,MIL,65,65,2297,367,742,0,4,367,738,96,217,199,521,720,131,47,168,125,217,830
53,Matt Bonner,PF,30,SAS,66,1,1432,172,371,105,230,67,141,32,43,60,179,239,60,26,21,27,110,481
54,Trevor Booker,PF,23,WAS,65,14,1063,139,253,0,1,139,252,68,101,98,153,251,35,29,42,38,115,346
55,Carlos Boozer,C,29,CHI,59,59,1882,431,845,0,0,431,845,171,244,130,435,565,145,45,18,149,186,1033
56,Chris Bosh,PF,26,MIA,77,77,2795,524,1056,6,25,518,1031,384,471,141,500,641,144,59,49,138,172,1438
57,Earl Boykins,PG,34,MIL,57,0,862,156,352,27,71,129,281,69,82,15,40,55,141,38,3,52,43,408
58,Craig Brackins,PF,23,PHI,3,0,33,4,16,0,5,4,11,0,0,2,2,4,1,1,0,0,3,8
59,Avery Bradley,PG,20,BOS,31,0,162,23,67,0,5,23,62,6,12,4,13,17,12,9,0,16,20,52
60,Elton Brand,PF,31,PHI,81,81,2809,502,981,0,1,502,980,213,273,237,439,676,120,92,106,101,244,1217
62,Ronnie Brewer,SG,25,CHI,81,1,1781,205,427,6,27,199,400,87,133,55,207,262,140,106,22,55,82,503
63,Jon Brockman,C,23,MIL,63,6,677,48,94,0,0,48,94,40,59,74,110,184,18,14,3,24,119,136
64,Aaron Brooks,PG,26,TOT,59,12,1284,220,587,70,236,150,351,124,140,20,58,78,233,34,3,99,115,634
65,Derrick Brown,SF,23,TOT,49,1,576,74,131,5,10,69,121,32,60,41,58,99,33,20,10,35,59,185
66,Kwame Brown,C,28,CHA,66,50,1714,194,375,0,0,194,375,136,231,147,303,450,43,26,39,69,174,524
67,Shannon Brown,SG,25,LAL,82,0,1568,273,643,74,212,199,431,92,101,35,122,157,96,67,16,75,124,712
68,Kobe Bryant,SG,32,LAL,82,82,2779,740,1639,115,356,625,1283,483,583,83,336,419,388,99,12,243,172,2078
69,Chase Budinger,SF,22,HOU,78,22,1738,279,656,89,274,190,382,118,138,52,229,281,127,41,18,67,114,765
70,Caron Butler,SF,30,DAL,29,29,867,170,378,28,65,142,313,68,88,22,96,118,46,28,8,49,59,436
71,Rasual Butler,SG,31,TOT,47,2,770,79,237,46,136,33,101,18,27,10,67,77,27,8,15,24,37,222
72,Andrew Bynum,C,23,LAL,54,47,1500,237,413,0,0,237,413,138,209,170,338,508,73,19,106,74,140,612
73,Will Bynum,PG,28,DET,61,5,1125,182,406,16,50,166,356,102,122,15,59,74,195,52,4,83,113,482
74,José Calderón,PG,29,TOR,68,55,2102,262,596,57,156,205,440,88,103,30,172,202,605,81,7,148,143,669
75,Marcus Camby,C,36,POR,59,51,1540,117,294,0,1,117,293,43,70,182,424,606,121,40,92,62,140,277
76,Derrick Caracter,C,22,LAL,41,0,215,32,66,0,0,32,66,17,23,19,24,43,7,4,10,19,47,81
77,Brian Cardinal,SF,33,DAL,56,4,618,43,100,42,87,1,13,17,18,10,49,59,40,24,7,17,82,145
78,Rodney Carney,SF,26,TOT,27,1,336,46,110,17,38,29,72,18,27,13,35,48,11,12,5,16,33,127
79,DeMarre Carroll,PF,24,TOT,12,0,50,4,12,0,0,4,12,2,2,2,6,8,4,1,1,0,5,10
80,Matt Carroll,SG,30,CHA,54,1,582,89,199,17,46,72,153,40,52,12,56,68,23,17,6,23,43,235
81,Anthony Carter,PG,35,TOT,33,0,463,45,106,12,40,33,66,8,8,7,44,51,69,27,6,39,49,110
82,Vince Carter,SG,34,TOT,73,63,2051,389,891,116,321,273,570,128,173,54,221,275,146,67,20,90,193,1022
83,Omri Casspi,SF,22,SAC,71,27,1702,225,546,92,247,133,299,68,101,74,233,307,74,54,13,68,115,610
84,Mario Chalmers,PG,24,MIA,70,28,1579,155,388,83,231,72,157,54,62,12,134,146,177,76,7,91,158,447
85,Tyson Chandler,C,28,DAL,74,74,2059,266,407,0,0,266,407,216,295,206,486,692,32,36,80,88,240,748
86,Wilson Chandler,SF,23,TOT,72,49,2401,429,953,112,320,317,633,130,161,75,333,408,120,48,94,104,199,1100
87,Josh Childress,SG,27,PHO,54,3,894,121,214,1,16,120,198,29,59,69,86,155,42,33,23,44,68,272
88,Earl Clark,SF,23,TOT,42,0,464,68,158,0,5,68,153,27,47,37,64,101,9,8,18,28,45,163
89,Jarron Collins,C,32,TOT,28,0,181,6,21,0,0,6,21,7,10,14,10,24,2,4,1,7,29,19
90,Jason Collins,C,32,ATL,49,28,593,34,71,1,1,33,70,27,41,30,72,102,22,9,9,26,97,96
91,Sherron Collins,PG,23,CHA,20,0,66,7,25,2,10,5,15,1,1,0,5,5,8,2,0,4,2,17
92,Darren Collison,PG,23,IND,79,79,2360,398,870,41,124,357,746,202,232,40,185,225,403,87,14,194,109,1039
93,Nick Collison,C,30,OKC,71,2,1524,137,242,0,0,137,242,55,73,119,197,316,69,42,31,55,210,329
94,Mike Conley,PG,23,MEM,81,81,2872,423,953,80,217,343,736,181,247,32,215,247,528,144,18,176,182,1107
95,Brian Cook,PF,30,LAC,40,0,447,72,170,34,79,38,91,15,24,19,77,96,15,12,11,25,75,193
96,Daequan Cook,SG,23,OKC,43,0,598,79,181,65,154,14,27,16,20,8,64,72,20,14,1,17,51,239
97,Marcus Cousin,C,24,UTA,4,0,18,2,3,0,0,2,3,0,0,0,3,3,0,0,1,1,1,4
98,DeMarcus Cousins,C,20,SAC,81,62,2309,432,1004,3,18,429,986,276,402,217,482,699,204,85,68,268,332,1143
99,Jamal Crawford,SG,30,ATL,76,0,2297,368,874,119,349,249,525,222,260,22,108,130,241,57,14,145,97,1077
100,Jordan Crawford,SG,22,TOT,42,18,1027,192,500,33,128,159,372,73,84,31,74,105,117,39,3,83,63,490
101,Dante Cunningham,PF,23,TOT,78,18,1637,218,472,1,13,217,459,45,62,96,181,277,43,54,43,51,177,482
102,Stephen Curry,PG,22,GSW,74,74,2489,505,1053,151,342,354,711,212,227,52,234,286,432,109,20,226,233,1373
103,Samuel Dalembert,C,29,SAC,80,46,1938,268,567,0,2,268,565,108,148,212,445,657,67,36,116,132,225,644
104,Erick Dampier,C,35,MIA,51,22,815,52,89,0,1,52,88,24,44,53,124,177,22,14,47,32,82,128
105,Antonio Daniels,PG,35,PHI,4,0,35,2,5,0,2,2,3,2,2,0,5,5,2,0,0,1,0,6
106,Marquis Daniels,SF,30,BOS,49,0,938,114,232,4,21,110,211,39,57,24,89,113,64,39,22,38,63,271
107,Baron Davis,PG,31,TOT,58,44,1649,289,693,81,239,208,454,101,131,35,121,156,391,78,28,146,143,760
108,Ed Davis,PF,21,TOR,65,17,1602,215,373,0,0,215,373,71,128,168,294,462,40,39,67,48,183,501
109,Glen Davis,C,25,BOS,78,13,2298,359,801,2,15,357,786,195,265,101,324,425,92,78,30,85,231,915
110,Austin Daye,SF,22,DET,72,16,1446,193,471,69,172,124,299,82,108,64,210,274,78,39,39,59,165,537
111,Carlos Delfino,SF,28,MIL,49,40,1590,200,513,105,284,95,229,60,75,24,176,200,112,76,8,57,72,565
112,Luol Deng,SF,25,CHI,82,82,3208,531,1155,115,333,416,822,253,336,116,360,476,230,78,48,156,162,1430
113,DeMar DeRozan,SG,21,TOR,82,82,2851,539,1154,5,52,534,1102,327,402,75,240,315,148,85,31,144,217,1410
114,Boris Diaw,PF,28,CHA,82,82,2778,381,774,78,226,303,548,84,123,105,309,414,337,74,46,166,190,924
115,Ike Diogu,PF,27,LAC,36,0,470,83,148,0,0,83,148,41,62,41,74,115,2,3,3,22,72,207
116,DeSagana Diop,C,29,CHA,16,0,181,8,24,0,0,8,24,4,11,12,28,40,7,4,15,11,26,20
117,Keyon Dooling,PG,30,MIL,80,22,1757,206,519,81,234,125,285,78,94,12,105,117,243,54,4,91,119,571
118,Joey Dorsey,C,27,TOR,43,9,522,52,99,0,0,52,99,31,65,79,111,190,27,24,17,39,78,135
119,Toney Douglas,SG,24,NYK,81,9,1971,314,755,143,383,171,372,85,107,65,179,244,244,89,4,89,177,856
120,Chris Douglas-Roberts,SF,24,MIL,44,12,884,117,273,15,46,102,227,74,89,7,81,88,50,29,13,35,73,323
121,Zabian Dowdell,PG,26,PHO,24,0,292,51,125,3,10,48,115,16,17,5,15,20,51,20,2,29,30,121
122,Goran Dragić,PG,24,TOT,70,5,1234,192,441,56,155,136,286,83,133,36,106,142,204,50,10,117,125,523
123,Jared Dudley,SF,25,PHO,82,15,2140,300,629,105,253,195,376,162,218,111,207,318,108,87,20,77,139,867
124,Chris Duhon,PG,28,ORL,51,5,774,49,129,13,52,36,77,14,25,9,43,52,118,16,2,61,30,125
125,Tim Duncan,C,34,SAS,76,76,2156,419,838,0,4,419,834,184,257,169,509,678,203,50,146,122,119,1022
126,Mike Dunleavy,SG,30,IND,61,44,1683,240,520,102,254,138,266,100,125,28,248,276,105,40,30,69,107,682
127,Ronald Dupree,SF,30,TOR,3,0,13,1,4,0,1,1,3,0,0,0,3,3,1,0,0,0,2,2
128,Kevin Durant,SF,22,OKC,78,78,3038,711,1538,145,414,566,1124,594,675,57,476,533,214,88,76,218,159,2161
129,Devin Ebanks,SG,21,LAL,20,0,118,21,51,2,5,19,46,18,23,15,12,27,2,4,5,6,7,62
130,Wayne Ellington,SG,23,MIN,62,8,1181,160,397,48,121,112,276,42,53,26,82,108,72,28,3,53,85,410
131,Monta Ellis,SG,25,GSW,80,80,3227,726,1611,137,379,589,1232,340,431,44,237,281,450,168,23,252,203,1929
132,Francisco Elson,C,34,UTA,62,1,610,54,113,0,0,54,113,26,31,35,80,115,33,21,14,32,84,134
133,Melvin Ely,C,32,DEN,30,2,366,28,51,0,0,28,51,13,21,27,47,74,14,4,11,14,50,69
134,Semih Erden,C,24,TOT,41,8,595,62,111,0,0,62,111,39,60,37,81,118,20,15,24,34,104,163
135,Jeremy Evans,SF,23,UTA,49,3,463,76,115,0,1,76,114,26,37,36,61,97,24,17,17,19,50,178
136,Maurice Evans,SF,32,TOT,73,24,1549,177,424,55,167,122,257,52,58,52,104,156,45,34,14,33,129,461
137,Reggie Evans,PF,30,TOR,30,18,798,42,103,0,1,42,102,48,88,119,226,345,38,29,6,39,89,132
138,Tyreke Evans,SG,21,SAC,57,53,2107,382,933,43,148,339,785,205,266,46,229,275,319,85,30,184,143,1012
139,Patrick Ewing,SF,26,NOH,7,0,19,0,5,0,2,0,3,3,4,1,1,2,2,0,1,1,1,3
140,Christian Eyenga,SF,21,CLE,44,18,947,130,306,25,91,105,215,18,28,27,96,123,35,34,28,47,78,303
141,Jordan Farmar,PG,24,NJN,73,18,1796,255,651,109,304,146,347,82,100,24,149,173,368,62,6,139,128,701
142,Derrick Favors,PF,19,TOT,78,27,1535,215,416,0,0,215,416,103,173,171,241,412,39,29,68,77,246,533
144,Rudy Fernández,SG,25,POR,78,3,1821,213,575,116,361,97,214,126,146,37,135,172,193,87,14,88,134,668
145,Kyrylo Fesenko,C,24,UTA,53,1,456,44,100,0,1,44,99,18,46,34,74,108,18,4,16,25,90,106
146,Landry Fields,SG,22,NYK,82,81,2541,299,602,86,219,213,383,113,147,105,416,521,155,80,17,107,114,797
147,Derek Fisher,PG,36,LAL,82,82,2297,206,529,63,159,143,370,83,103,14,138,152,224,99,8,70,192,558
148,Jonny Flynn,PG,21,MIN,53,8,983,108,296,31,100,77,196,32,42,12,65,77,182,34,3,113,58,279
149,Gary Forbes,SF,25,DEN,63,11,791,124,273,19,58,105,215,59,87,28,88,116,49,23,6,46,77,326
150,T.J. Ford,PG,27,IND,41,3,773,91,236,6,32,85,204,35,48,17,64,81,141,35,8,63,69,223
151,Jeff Foster,C,34,IND,56,3,940,80,167,0,3,80,164,27,48,160,190,350,46,24,31,26,127,187
152,Randy Foye,SG,27,LAC,63,24,1551,206,531,71,217,135,314,133,149,13,90,103,170,47,21,95,122,616
153,Channing Frye,PF,27,PHO,77,64,2541,358,829,171,439,187,390,89,107,65,448,513,96,46,79,73,272,976
155,Sundiata Gaines,PG,24,TOT,24,0,301,42,105,9,38,33,67,18,36,13,25,38,42,16,1,27,25,111
157,Francisco García,SF,29,SAC,58,34,1386,207,475,81,224,126,251,65,76,24,109,133,71,51,49,45,126,560
158,Kevin Garnett,PF,34,BOS,71,71,2220,434,822,1,5,433,817,187,217,83,548,631,171,95,57,115,148,1056
159,Marc Gasol,C,26,MEM,81,81,2586,364,691,3,7,361,684,220,294,154,415,569,200,74,136,146,265,951
160,Pau Gasol,C,30,LAL,82,82,3037,593,1120,1,3,592,1117,354,430,268,568,836,273,48,130,142,203,1541
161,Rudy Gay,SF,24,MEM,54,54,2152,409,869,57,144,352,725,194,241,82,254,336,153,91,58,135,131,1069
162,Alonzo Gee,SG,23,TOT,56,34,1118,121,264,17,51,104,213,72,92,62,120,182,38,40,18,55,94,331
163,Paul George,SG,20,IND,61,19,1265,179,395,41,138,138,257,77,101,37,187,224,65,62,26,70,127,476
164,Daniel Gibson,SG,24,CLE,67,15,1865,264,660,118,293,146,367,134,163,24,153,177,201,48,21,80,154,780
165,Taj Gibson,PF,25,CHI,80,19,1742,234,502,1,8,233,494,100,148,162,296,458,58,39,106,71,203,569
166,Manu Ginóbili,SG,33,SAS,80,79,2426,441,1018,154,441,287,577,357,410,42,253,295,393,123,28,174,163,1393
167,Ryan Gomes,SF,28,LAC,76,62,2095,207,505,72,211,135,294,61,85,61,193,254,118,62,12,55,159,547
168,Drew Gooden,PF,29,MIL,35,18,860,156,362,3,20,153,342,81,102,73,165,238,47,21,18,46,98,396
169,Ben Gordon,SG,27,DET,82,27,2131,339,770,107,266,232,504,136,160,41,154,195,171,48,16,141,178,921
170,Eric Gordon,SG,22,LAC,56,56,2112,427,949,106,291,321,658,287,348,45,119,164,244,71,18,151,115,1247
171,Marcin Gortat,C,26,TOT,80,14,2032,338,603,1,4,337,599,140,193,148,483,631,70,36,91,81,188,817
172,Joey Graham,SF,28,CLE,39,8,586,82,179,9,30,73,149,29,36,8,76,84,18,6,7,28,73,202
173,Stephen Graham,SG,28,NJN,59,28,959,81,200,5,21,76,179,31,38,17,106,123,40,14,1,38,106,198
174,Danny Granger,SF,27,IND,79,79,2763,535,1260,157,407,378,853,395,466,87,338,425,203,89,62,206,213,1622
175,Aaron Gray,C,26,NOH,41,6,531,56,99,0,0,56,99,17,34,59,112,171,16,11,12,32,96,129
176,Danny Green,SG,23,SAS,8,0,92,17,35,7,19,10,16,0,0,3,12,15,2,2,1,5,7,41
178,Willie Green,SG,29,NOH,77,13,1674,270,609,54,155,216,454,78,100,22,139,161,74,36,13,67,143,672
179,Donté Greene,SF,22,SAC,69,21,1127,156,386,45,154,111,232,43,65,49,98,147,48,36,20,60,88,400
180,Orien Greene,SG,28,NJN,3,0,5,1,2,0,0,1,2,1,2,0,0,0,1,1,0,0,0,3
181,Blake Griffin,PF,21,LAC,82,82,3112,696,1376,7,24,689,1352,446,695,270,719,989,312,63,45,223,252,1845
182,Hamed Haddadi,C,25,MEM,31,0,168,30,58,0,1,30,57,15,23,24,44,68,5,2,13,11,29,75
183,Richard Hamilton,SG,32,DET,55,39,1498,288,671,55,144,233,527,146,172,24,102,126,171,39,4,88,95,777
184,Tyler Hansbrough,PF,25,IND,70,29,1535,285,613,0,2,285,611,197,253,145,221,366,41,37,15,76,160,767
185,Luke Harangody,PF,23,TOT,49,0,640,79,206,16,66,63,140,19,26,40,103,143,30,15,17,16,80,193
186,James Harden,SG,21,OKC,82,5,2189,298,684,113,324,185,360,289,343,42,213,255,176,92,24,106,207,998
187,Al Harrington,PF,30,DEN,73,3,1665,281,675,117,328,164,347,86,117,76,256,332,101,39,10,106,202,765
188,Devin Harris,PG,27,TOT,71,70,2254,343,813,58,180,285,633,335,402,17,152,169,503,70,7,207,163,1079
189,Manny Harris,SG,21,CLE,54,15,933,108,289,34,92,74,197,71,93,36,104,140,85,31,7,63,65,321
190,Mike Harris,PF,27,HOU,4,0,16,3,6,0,0,3,6,2,4,2,3,5,1,0,1,1,2,8
191,Udonis Haslem,PF,30,MIA,13,0,345,44,86,0,0,44,86,16,20,29,77,106,6,7,3,14,39,104
192,Spencer Hawes,C,22,PHI,81,81,1718,264,568,9,37,255,531,47,88,129,336,465,121,29,71,97,201,584
193,Chuck Hayes,C,27,HOU,74,63,2079,244,463,0,2,244,461,94,142,219,380,599,202,79,49,86,200,582
194,Gordon Hayward,SF,20,UTA,72,17,1218,142,293,35,74,107,219,69,97,41,98,139,81,30,19,70,106,388
195,Lazar Hayward,SF,24,MIN,42,0,419,55,154,17,60,38,94,33,42,23,47,70,28,12,7,19,44,160
196,Brendan Haywood,C,31,DAL,72,8,1331,128,223,0,1,128,222,64,177,129,247,376,19,16,74,51,146,320
197,Luther Head,PG,28,SAC,36,14,586,68,164,25,64,43,100,39,50,16,44,60,70,10,9,32,43,200
198,Gerald Henderson,SG,23,CHA,68,30,1661,259,570,7,36,252,534,128,163,49,158,207,101,50,32,64,118,653
199,Xavier Henry,SG,19,MEM,38,16,527,65,160,2,17,63,143,33,52,9,28,37,18,11,3,13,48,165
200,Roy Hibbert,C,24,IND,81,80,2244,410,890,0,4,410,886,205,275,182,428,610,166,33,142,185,256,1025
201,J.J. Hickson,C,22,CLE,80,66,2256,429,936,0,5,429,931,247,367,217,478,695,91,48,54,173,215,1105
202,Nenê Hilário,C,28,DEN,75,75,2291,402,654,1,5,401,649,286,402,145,426,571,149,84,73,134,238,1091
203,George Hill,PG,24,SAS,76,5,2148,287,633,77,204,210,429,233,270,24,175,199,193,66,21,99,153,884
204,Grant Hill*,SF,38,PHO,80,80,2409,399,825,45,114,354,711,213,257,77,261,338,200,64,35,134,184,1056
205,Jordan Hill,C,23,HOU,72,11,1125,173,352,0,2,173,350,60,85,128,178,306,29,14,52,62,157,406
207,Jrue Holiday,PG,20,PHI,82,82,2901,446,999,81,222,365,777,172,209,68,264,332,531,120,29,218,203,1145
208,Ryan Hollins,C,26,CLE,70,16,1182,131,219,0,0,131,219,111,163,70,116,186,26,22,42,67,199,373
209,Al Horford,C,24,ATL,77,77,2704,513,921,2,4,511,917,150,188,182,536,718,266,59,80,119,193,1178
210,Eddie House,SG,32,MIA,56,1,978,128,321,68,175,60,146,38,40,9,83,92,62,32,3,29,68,362
211,Dwight Howard,C,25,ORL,78,78,2935,619,1044,0,7,619,1037,546,916,309,789,1098,107,107,186,279,258,1784
212,Josh Howard,SF,30,WAS,18,10,409,58,162,7,29,51,133,29,47,18,56,74,24,13,5,20,34,152
213,Juwan Howard,PF,37,MIA,57,0,592,55,125,0,0,55,125,29,35,36,86,122,23,10,4,25,61,139
214,Lester Hudson,PG,26,WAS,11,0,73,6,24,4,15,2,9,2,4,1,4,5,17,4,1,7,10,18
215,Kris Humphries,PF,25,NJN,74,44,2061,307,583,0,1,307,582,127,191,225,546,771,84,33,80,103,168,741
216,Serge Ibaka,PF,21,OKC,82,44,2216,335,617,0,1,335,616,138,184,214,408,622,22,31,198,71,267,808
217,Andre Iguodala,SF,27,PHI,67,67,2469,338,759,61,181,277,578,208,300,61,326,387,422,101,38,138,109,945
218,Zydrunas Ilgauskas,C,35,MIA,72,51,1145,162,319,0,1,162,318,36,46,108,179,287,26,23,58,52,185,360
219,Didier Ilunga-Mbenga,C,30,NOH,41,0,330,23,49,0,0,23,49,13,18,35,51,86,6,6,27,21,52,59
220,Ersan İlyasova,PF,23,MIL,60,34,1505,221,507,36,121,185,386,93,104,105,260,365,56,51,24,63,159,571
221,Royal Ivey,SG,29,OKC,25,0,155,16,38,7,16,9,22,2,2,2,14,16,7,6,1,5,17,41
223,Darnell Jackson,PF,25,SAC,59,2,486,77,158,3,11,74,147,30,49,49,45,94,14,12,3,23,61,187
224,Stephen Jackson,SG,32,CHA,67,67,2405,435,1059,121,359,314,700,249,305,53,251,304,241,80,28,209,161,1240
225,Damion James,SF,23,NJN,25,9,403,46,103,0,3,46,100,18,28,17,68,85,20,16,12,25,36,110
226,LeBron James,SF,26,MIA,79,79,3063,758,1485,92,279,666,1206,503,663,80,510,590,554,124,50,284,163,2111
227,Antawn Jamison,PF,34,CLE,56,38,1842,374,876,91,263,283,613,171,234,86,289,375,93,50,30,77,137,1010
228,Othyus Jeffers,SG,25,TOT,17,1,322,31,65,1,4,30,61,30,46,25,42,67,20,17,0,14,32,93
229,Al Jefferson,C,26,UTA,82,82,2940,654,1319,0,0,654,1319,220,289,235,559,794,149,46,153,105,238,1528
230,Richard Jefferson,SF,30,SAS,81,81,2459,304,642,135,307,169,335,148,195,54,256,310,107,38,34,93,164,891
231,Jared Jeffries,PF,29,TOT,42,9,601,30,86,2,9,28,77,12,29,62,54,116,36,31,17,21,75,74
232,Brandon Jennings,PG,21,MIL,63,61,2169,361,926,98,303,263,623,199,246,42,192,234,305,95,21,146,131,1019
233,Eugene Jeter,PG,27,SAC,62,1,858,106,259,6,30,100,229,37,41,9,61,70,162,29,2,51,54,255
234,Yi Jianlian,PF,23,WAS,63,11,1112,145,347,3,13,142,334,62,91,79,169,248,25,27,32,51,115,355
235,Amir Johnson,PF,23,TOR,72,54,1853,281,495,0,1,281,494,126,160,189,272,461,81,53,88,69,263,688
236,Armon Johnson,PG,21,POR,38,0,277,46,101,5,12,41,89,13,22,11,25,36,45,5,1,38,31,110
237,Chris Johnson,C,25,TOT,14,1,138,9,21,0,0,9,21,15,20,12,20,32,3,3,9,10,21,33
238,James Johnson,SF,23,TOT,38,25,822,108,237,8,34,100,203,47,71,37,105,142,89,33,37,64,95,271
239,Joe Johnson,SG,29,ATL,72,72,2554,514,1161,89,300,425,861,195,243,59,232,291,338,47,7,146,131,1312
240,Trey Johnson,SG,26,TOT,8,0,94,12,33,1,3,11,30,9,10,2,5,7,11,1,1,5,12,34
241,Wesley Johnson,SG,23,MIN,79,63,2069,271,682,103,289,168,393,64,92,51,189,240,148,58,54,95,163,709
242,Dahntay Jones,SG,30,IND,45,2,589,100,214,14,39,86,175,69,90,4,61,65,33,20,7,31,70,283
243,Dominique Jones,SG,22,DAL,18,0,135,14,45,0,4,14,41,14,17,6,19,25,19,5,3,10,7,42
244,James Jones,SF,30,MIA,81,8,1549,146,346,123,287,23,59,60,72,23,137,160,43,29,19,21,129,475
245,Solomon Jones,C,26,IND,39,0,528,49,121,0,1,49,120,41,62,45,68,113,30,12,22,35,94,139
246,DeAndre Jordan,C,22,LAC,80,66,2047,234,341,0,1,234,340,98,217,207,368,575,42,41,142,101,255,566
247,Chris Kaman,C,28,LAC,32,15,838,177,376,0,0,177,376,43,57,51,174,225,46,16,48,58,75,397
248,Jason Kapono,SF,29,PHI,24,2,112,7,28,1,8,6,20,1,2,3,8,11,4,2,1,2,4,16
249,Jason Kidd*,PG,37,DAL,80,80,2653,215,596,133,391,82,205,67,77,35,316,351,655,134,29,179,119,630
250,Andrei Kirilenko,SF,29,UTA,64,62,1999,253,542,36,98,217,444,208,270,100,227,327,192,81,74,117,113,750
251,Linas Kleiza,SF,26,TOR,39,23,1032,178,406,39,131,139,275,41,65,37,140,177,40,19,7,65,99,436
252,Kyle Korver,SG,29,CHI,82,0,1649,242,557,120,289,122,268,77,87,12,138,150,124,35,20,60,156,681
253,Kosta Koufos,C,21,TOT,50,2,434,68,150,0,2,68,148,24,43,57,73,130,7,10,25,31,59,160
254,Nenad Krstić,C,27,TOT,71,67,1571,231,452,0,0,231,452,113,146,124,211,335,27,26,25,56,184,575
255,Carl Landry,PF,27,TOT,76,26,2008,345,687,0,4,345,683,213,288,165,182,347,63,40,32,109,196,903
256,Acie Law,PG,26,TOT,51,0,726,81,186,6,36,75,150,47,64,12,51,63,84,32,0,43,61,215
257,Gani Lawal,PF,22,PHO,1,0,2,0,0,0,0,0,0,0,0,0,0,0,0,0,0,0,1,0
258,Ty Lawson,PG,23,DEN,80,31,2103,346,688,69,171,277,517,172,225,67,142,209,377,80,4,137,133,933
259,Courtney Lee,SG,25,HOU,81,1,1723,253,576,71,174,182,402,95,120,51,158,209,100,58,18,68,102,672
260,David Lee,PF,27,GSW,73,73,2634,496,978,1,3,495,975,210,267,217,497,714,233,74,31,170,211,1203
262,Jeremy Lin,PG,22,GSW,29,0,285,28,72,1,5,27,67,19,25,12,22,34,42,33,9,18,31,76
263,Shaun Livingston,PG,25,CHA,73,0,1261,185,397,1,4,184,393,108,125,29,120,149,164,47,29,88,109,479
264,Brook Lopez,C,22,NJN,82,82,2889,644,1309,0,1,644,1308,385,489,197,291,488,129,47,120,176,240,1673
265,Robin Lopez,C,22,PHO,67,56,991,179,357,0,0,179,357,74,100,82,134,216,8,18,45,48,143,432
266,Kevin Love,PF,22,MIN,73,73,2611,482,1026,88,211,394,815,424,499,330,782,1112,184,45,28,155,148,1476
267,Kyle Lowry,PG,24,HOU,75,71,2563,345,809,129,343,216,466,192,251,89,220,309,500,102,23,158,207,1011
268,John Lucas III,PG,28,CHI,2,0,10,1,3,0,1,1,2,0,2,0,0,0,1,0,0,0,0,2
269,Corey Maggette,SF,31,MIL,67,18,1401,253,559,28,78,225,481,271,325,44,197,241,84,21,5,127,175,805
270,Jamaal Magloire,C,32,MIA,18,0,158,13,22,0,0,13,22,9,18,17,44,61,3,4,2,5,26,35
271,Ian Mahinmi,C,24,DAL,56,0,488,55,98,0,2,55,96,63,82,43,77,120,8,14,15,25,105,173
272,Shawn Marion,SF,32,DAL,80,27,2253,434,834,5,33,429,801,126,164,168,383,551,110,68,50,130,144,999
273,Sean Marks,C,35,POR,29,0,208,19,44,2,2,17,42,5,8,16,24,40,4,3,5,11,44,45
274,Cartier Martin,SF,26,WAS,52,1,542,71,182,39,99,32,83,28,40,20,54,74,18,18,6,16,52,209
275,Kenyon Martin,PF,33,DEN,48,48,1233,185,362,2,9,183,353,42,72,67,230,297,109,43,35,59,136,414
276,Kevin Martin,SG,27,HOU,80,80,2603,553,1267,176,459,377,808,594,669,28,230,258,198,80,15,184,155,1876
277,Roger Mason,SG,30,NYK,26,0,319,26,77,16,44,10,33,7,10,5,38,43,20,6,2,6,25,75
278,Wesley Matthews,SG,24,POR,82,69,2758,440,979,154,378,286,601,266,315,48,210,258,164,102,9,138,195,1300
279,Jason Maxiell,PF,27,DET,57,14,930,93,189,0,0,93,189,51,99,66,107,173,17,24,21,44,92,237
280,Eric Maynor,PG,23,OKC,82,0,1200,134,333,37,96,97,237,43,59,25,96,121,238,35,6,77,96,348
281,O.J. Mayo,SG,23,MEM,71,17,1869,304,747,96,264,208,483,99,131,35,135,170,145,73,26,99,127,803
282,Luc Mbah a Moute,PF,24,MIL,79,52,2093,198,428,0,7,198,421,133,188,169,251,420,68,72,28,77,180,529
283,Antonio McDyess,PF,36,SAS,73,16,1387,169,344,0,1,169,343,52,77,122,273,395,84,36,39,72,163,390
284,JaVale McGee,C,23,WAS,79,75,2193,332,604,0,3,332,601,134,230,223,411,634,38,41,193,102,232,798
285,Tracy McGrady*,SG,31,DET,72,39,1686,227,514,30,88,197,426,90,129,49,202,251,252,66,34,102,101,574
286,Dominic McGuire,SF,25,CHA,52,8,760,72,182,0,2,72,180,30,39,63,136,199,43,10,33,25,94,174
287,Josh McRoberts,PF,23,IND,72,51,1597,211,386,23,60,188,326,88,119,109,273,382,150,47,57,93,165,533
288,Jodie Meeks,SG,23,PHI,74,64,2062,242,570,138,348,104,222,152,170,21,150,171,78,63,4,60,97,774
289,Pops Mensah-Bonsu,PF,27,NOH,7,0,35,1,3,0,0,1,3,0,0,3,8,11,2,0,0,2,11,2
290,C.J. Miles,SF,23,UTA,78,19,1969,366,899,109,339,257,560,159,196,54,201,255,135,74,38,93,221,1000
291,Darko Miličić,C,25,MIN,69,69,1686,271,578,0,0,271,578,64,115,133,227,360,104,54,140,151,229,606
292,Andre Miller,PG,34,POR,81,81,2650,388,844,4,37,384,807,249,292,97,205,302,566,114,12,197,171,1029
293,Brad Miller,C,34,HOU,60,5,1015,132,296,40,107,92,189,78,94,44,178,222,145,28,21,54,98,382
294,Mike Miller,SG,30,MIA,41,2,838,81,202,43,118,38,84,23,34,38,146,184,51,20,2,41,88,228
295,Patty Mills,PG,22,POR,64,0,783,135,328,47,133,88,195,36,47,19,32,51,109,27,1,62,63,353
296,Paul Millsap,PF,25,UTA,76,76,2605,525,988,9,23,516,965,256,338,164,415,579,187,103,69,145,272,1315
297,Yao Ming*,C,30,HOU,5,5,91,18,37,0,0,18,37,15,16,7,20,27,4,0,8,7,13,51
298,Nazr Mohammed,C,33,TOT,75,37,1280,234,448,0,1,234,447,67,112,140,228,368,23,30,56,70,184,535
299,Greg Monroe,C,20,DET,80,48,2222,303,550,0,1,303,549,145,233,248,353,601,105,93,45,81,196,751
300,Jamario Moon,SF,30,TOT,59,20,1042,101,248,38,123,63,125,15,17,23,142,165,52,28,33,22,65,255
301,Anthony Morrow,SG,25,NJN,58,47,1856,279,620,110,260,169,360,96,107,37,135,172,68,19,7,54,135,764
302,Timofey Mozgov,C,24,TOT,45,14,524,63,133,0,0,63,133,37,52,46,75,121,15,15,25,35,84,163
303,Byron Mullens,PF,21,OKC,13,0,85,9,28,0,0,9,28,7,14,6,18,24,0,2,3,8,11,25
304,Troy Murphy,PF,30,TOT,35,4,466,42,114,5,33,37,81,20,30,22,91,113,23,15,3,20,47,109
305,Hamady N'Diaye,C,24,WAS,16,0,80,4,5,0,0,4,5,6,12,2,5,7,0,2,5,3,18,14
306,Eduardo Nájera,PF,34,CHA,31,0,372,26,72,11,34,15,38,6,11,14,30,44,20,11,6,13,52,69
307,Steve Nash*,PG,36,PHO,75,75,2497,399,811,81,205,318,606,227,249,40,220,260,855,48,4,265,87,1106
308,Gary Neal,SG,26,SAS,80,1,1685,285,632,129,308,156,324,84,104,21,175,196,96,27,4,78,148,783
309,Jameer Nelson,PG,28,ORL,76,76,2319,374,838,119,297,255,541,130,162,37,189,226,456,75,3,194,209,997
310,Joakim Noah,C,25,CHI,48,48,1576,211,402,0,1,211,401,139,188,182,316,498,107,48,72,90,156,561
311,Andrés Nocioni,SF,31,PHI,54,17,931,118,277,42,118,76,159,49,61,19,150,169,45,14,15,47,100,327
312,Steve Novak,SF,27,TOT,30,0,215,35,67,26,46,9,21,8,8,4,24,28,3,1,5,4,14,104
313,Dirk Nowitzki,PF,32,DAL,73,73,2504,610,1179,66,168,544,1011,395,443,50,463,513,190,38,47,137,172,1681
314,Jermaine O'Neal,C,32,BOS,24,10,431,50,109,0,1,50,108,29,43,25,63,88,12,2,30,27,65,129
315,Shaquille O'Neal*,C,38,BOS,37,36,752,134,201,0,0,134,201,73,131,48,130,178,26,16,42,56,120,341
316,Fabricio Oberto,C,35,POR,5,0,45,3,5,0,0,3,5,1,2,3,4,7,0,0,0,3,10,7
317,Lamar Odom,PF,31,LAL,82,35,2639,473,893,68,178,405,715,166,246,175,535,710,249,47,61,139,200,1180
318,Emeka Okafor,C,28,NOH,72,72,2287,300,524,0,1,300,523,145,258,230,454,684,42,40,127,119,230,745
319,Mehmet Okur,C,31,UTA,13,0,168,22,62,5,16,17,46,15,20,9,21,30,19,4,4,7,18,64
320,Travis Outlaw,SF,26,NJN,82,55,2358,274,731,76,252,198,479,132,171,54,271,325,84,34,36,71,148,756
321,Larry Owens,SF,28,TOT,12,0,143,15,32,6,13,9,19,4,9,1,14,15,8,9,5,5,18,40
322,Zaza Pachulia,C,26,ATL,79,7,1244,107,232,0,0,107,232,135,179,119,214,333,58,34,22,69,184,349
323,Anthony Parker,SF,35,CLE,72,65,2091,220,552,86,227,134,325,74,95,33,185,218,218,67,10,80,109,600
324,Tony Parker,PG,28,SAS,78,78,2528,555,1069,25,70,530,999,233,303,30,208,238,513,90,3,200,135,1368
325,Patrick Patterson,PF,21,HOU,52,6,868,149,267,0,2,149,265,30,42,86,114,200,41,17,37,31,77,328
326,Chris Paul,PG,25,NOH,80,80,2880,430,928,71,183,359,745,337,384,38,289,327,782,188,5,177,196,1268
328,Nikola Peković,C,25,MIN,65,11,887,136,263,0,0,136,263,87,114,90,103,193,27,18,35,91,181,359
329,Kendrick Perkins,C,26,TOT,29,24,742,67,130,0,0,67,130,40,72,62,170,232,26,9,26,56,91,174
330,Morris Peterson,SG,33,OKC,4,0,23,2,5,0,1,2,4,0,0,0,3,3,1,0,0,0,5,4
331,Johan Petro,C,25,NJN,77,1,893,129,290,0,4,129,286,15,28,62,150,212,44,34,34,46,178,273
332,Paul Pierce,SF,33,BOS,80,80,2774,507,1021,111,297,396,724,386,449,34,396,430,260,80,51,171,231,1511
334,Dexter Pittman,C,22,MIA,2,0,11,1,3,0,0,1,3,0,0,1,2,3,0,0,0,2,2,2
335,Quincy Pondexter,SF,22,NOH,66,6,734,73,180,18,50,55,130,24,34,23,65,88,28,17,10,16,63,188
336,James Posey,SF,34,IND,49,0,839,81,241,67,212,14,29,11,15,10,137,147,34,24,6,24,103,240
338,Josh Powell,PF,28,ATL,54,0,653,94,208,0,1,94,207,36,45,49,86,135,22,5,5,53,78,224
339,A.J. Price,PG,24,IND,50,0,795,114,320,41,149,73,171,54,81,16,56,72,111,29,1,53,61,323
340,Ronnie Price,SG,27,UTA,59,0,717,74,210,20,69,54,141,29,39,22,39,61,56,42,5,55,106,197
341,Tayshaun Prince,SF,30,DET,78,78,2562,473,1001,34,98,439,903,118,168,78,251,329,215,30,41,82,90,1098
342,Joel Przybilla,C,31,TOT,36,9,519,25,44,0,0,25,44,14,27,37,108,145,13,5,15,29,79,64
343,Chris Quinn,PG,27,SAS,41,0,292,33,91,11,37,22,54,4,8,3,22,25,42,5,1,12,29,81
344,Vladimir Radmanović,PF,30,GSW,74,6,1169,137,318,70,173,67,145,30,34,64,148,212,79,44,44,57,157,374
346,Zach Randolph,PF,29,MEM,75,74,2724,598,1188,8,43,590,1145,300,396,326,588,914,163,63,25,151,175,1504
347,Theo Ratliff,C,37,LAL,10,0,71,1,6,0,0,1,6,0,2,6,7,13,3,2,5,3,7,2
348,Andy Rautins,SG,24,NYK,5,0,24,3,7,1,4,2,3,1,2,0,1,1,3,1,0,7,0,8
349,Michael Redd,SG,31,MIL,10,0,134,18,45,4,17,14,28,4,4,0,8,8,12,2,1,4,4,44
350,J.J. Redick,SG,26,ORL,59,5,1513,197,447,87,219,110,228,112,128,6,107,113,102,29,3,53,80,593
351,Jason Richardson,SG,30,TOT,80,80,2715,472,1056,189,479,283,577,116,159,67,264,331,147,93,13,95,162,1249
352,Quentin Richardson,SF,30,ORL,57,19,955,87,255,42,146,45,109,33,44,39,139,178,38,25,5,33,74,249
353,Luke Ridnour,PG,29,MIN,71,66,2159,319,681,81,184,238,497,121,137,37,162,199,384,89,10,158,146,840
354,Nate Robinson,PG,26,TOT,59,11,1013,150,376,65,200,85,176,36,44,15,75,90,111,29,4,68,115,401
355,Rajon Rondo,PG,24,BOS,68,68,2527,318,670,10,43,308,627,75,132,87,210,297,760,153,11,234,120,721
356,Derrick Rose,PG,22,CHI,81,81,3026,711,1597,128,385,583,1212,476,555,81,249,330,623,85,51,278,136,2026
357,Quinton Ross,SF,29,NJN,36,4,353,26,59,0,3,26,56,5,14,10,20,30,10,3,6,7,40,57
358,Brandon Roy,SG,26,POR,47,23,1310,209,523,38,114,171,409,117,138,28,93,121,129,37,12,55,76,573
359,Brandon Rush,SG,25,IND,67,21,1754,217,515,93,223,124,292,80,106,33,184,217,62,41,35,69,107,607
360,John Salmons,SG,31,MIL,73,70,2554,373,898,83,219,290,679,195,240,27,239,266,252,72,28,137,157,1024
361,Samardo Samuels,PF,22,CLE,37,10,701,110,241,0,3,110,238,68,110,75,83,158,17,15,18,53,88,288
362,Larry Sanders,C,22,MIL,60,12,872,116,268,0,0,116,268,28,50,59,119,178,16,22,72,38,117,260
363,Brian Scalabrine,PF,32,CHI,18,0,88,10,19,0,5,10,14,0,0,1,7,8,6,3,4,5,18,20
364,Luis Scola,PF,30,HOU,74,74,2412,569,1129,0,3,569,1126,214,290,147,459,606,185,48,44,147,227,1352
365,Thabo Sefolosha,SG,26,OKC,79,79,2049,157,333,28,102,129,231,59,79,65,281,346,111,97,38,55,171,401
366,Kevin Séraphin,PF,21,WAS,58,1,635,66,147,0,0,66,147,22,31,80,72,152,10,17,28,42,126,154
367,Ramon Sessions,PG,24,CLE,81,38,2133,362,776,3,15,359,761,348,423,46,209,255,419,60,8,178,93,1075
368,Mustafa Shakur,PG,26,WAS,22,0,159,21,59,1,10,20,49,8,15,7,15,22,25,5,3,18,15,51
369,Garret Siler,C,24,PHO,21,0,101,17,31,0,0,17,31,11,22,16,12,28,3,1,4,10,20,45
370,Bobby Simmons,SF,30,SAS,2,0,16,0,3,0,3,0,0,0,0,0,0,0,2,0,0,0,2,0
371,Brian Skinner,C,34,MIL,2,0,6,0,0,0,0,0,0,0,0,0,0,0,0,0,0,0,0,0
372,Craig Smith,PF,27,LAC,48,0,586,104,188,0,5,104,183,50,68,43,74,117,31,16,7,33,84,258
373,Ish Smith,PG,22,TOT,43,3,442,43,115,3,10,40,105,12,21,7,40,47,79,18,2,34,37,101
374,J.R. Smith,SF,25,DEN,79,6,1968,341,784,124,318,217,466,163,221,45,277,322,175,92,16,100,173,969
375,Jason Smith,C,24,NOH,77,6,1102,136,307,0,2,136,305,59,70,89,152,241,36,26,32,53,150,331
376,Joe Smith,PF,35,TOT,16,3,69,3,16,0,0,3,16,2,2,3,18,21,4,0,4,5,13,8
377,Josh Smith,PF,25,ATL,77,77,2645,497,1041,51,154,446,887,229,316,134,523,657,255,99,120,197,217,1274
378,Darius Songaila,C,32,PHI,10,0,71,7,15,0,0,7,15,2,4,2,8,10,2,0,0,4,16,16
379,Marreese Speights,C,23,PHI,64,1,734,144,291,1,4,143,287,55,73,64,146,210,30,8,19,40,120,344
380,Tiago Splitter,C,26,SAS,60,6,738,101,191,0,1,101,190,76,140,72,129,201,26,29,17,32,91,278
381,Jerry Stackhouse,SG,36,MIA,7,1,50,3,12,1,4,2,8,5,7,1,6,7,3,0,2,2,3,12
382,Lance Stephenson,SG,20,IND,12,0,115,13,39,0,5,13,34,11,14,1,17,18,21,4,0,16,14,37
383,DeShawn Stevenson,SG,29,DAL,72,54,1158,128,330,94,249,34,81,33,43,20,86,106,77,21,5,44,71,383
384,Peja Stojaković,SF,33,TOT,33,13,617,100,227,57,136,43,91,23,25,14,61,75,29,13,2,17,24,280
385,Amar'e Stoudemire,C,28,NYK,78,78,2870,744,1482,10,23,734,1459,473,597,198,438,636,202,71,150,250,274,1971
386,Rodney Stuckey,PG,24,DET,70,54,2183,363,827,26,90,337,737,330,381,70,146,216,361,76,10,155,177,1082
387,DaJuan Summers,SF,23,DET,22,1,199,28,69,9,21,19,48,9,20,2,10,12,2,3,1,13,21,74
388,Pape Sy,SF,22,ATL,3,0,21,2,6,0,1,2,5,3,3,2,1,3,2,1,0,3,1,7
389,Jermaine Taylor,SG,24,TOT,34,8,483,94,196,14,45,80,151,21,28,26,36,62,32,14,5,46,39,223
390,Jeff Teague,PG,22,ATL,70,7,963,133,304,18,48,115,256,77,97,11,91,102,138,45,25,64,82,361
391,Sebastian Telfair,PG,25,MIN,37,8,711,97,241,28,78,69,163,44,60,17,37,54,111,25,3,64,64,266
393,Jason Terry,SG,33,DAL,82,10,2564,492,1091,127,351,365,740,182,214,24,129,153,334,93,13,167,140,1293
394,Hasheem Thabeet,C,23,TOT,47,0,373,17,40,0,0,17,40,19,35,24,51,75,4,9,16,17,76,53
395,Etan Thomas,C,32,ATL,13,0,82,10,21,0,0,10,21,12,15,6,17,23,2,1,4,5,11,32
396,Kurt Thomas,PF,38,CHI,52,37,1178,95,186,1,1,94,185,20,32,75,226,301,60,32,42,42,164,211
397,Tyrus Thomas,C,24,CHA,41,2,861,156,331,0,3,156,328,107,136,65,159,224,29,30,66,65,113,419
398,Jason Thompson,PF,24,SAC,75,39,1748,271,534,0,3,271,531,121,200,144,310,454,88,28,44,99,212,663
400,Marcus Thornton,SG,23,TOT,73,23,1775,350,807,88,240,262,567,145,184,61,197,258,135,64,9,93,110,933
401,Anthony Tolliver,SF,25,MIN,65,4,1362,141,313,47,115,94,198,105,131,92,203,295,82,28,28,49,145,434
402,Ronny Turiaf,C,28,NYK,64,21,1141,103,163,0,0,103,163,61,98,64,143,207,92,35,73,41,160,267
404,Evan Turner,SG,22,PHI,78,14,1797,225,529,14,44,211,485,101,125,42,264,306,159,49,14,80,138,565
405,Ekpe Udoh,C,23,GSW,58,18,1030,97,222,0,0,97,222,42,64,80,101,181,40,22,86,48,144,236
406,Ime Udoka,SF,33,SAS,20,0,130,5,21,0,8,5,13,4,8,5,14,19,13,8,1,5,14,14
407,Beno Udrih,PG,28,SAC,79,64,2734,412,824,65,182,347,642,197,228,41,224,265,386,94,9,141,181,1086
408,Ben Uzoh,PG,22,NJN,42,0,438,61,144,3,8,58,136,33,56,30,31,61,69,13,8,25,29,158
409,Anderson Varejão,C,28,CLE,31,31,994,114,216,0,2,114,214,54,81,98,203,301,45,27,38,40,87,282
410,Greivis Vásquez,SG,24,MEM,70,1,860,95,233,25,86,70,147,34,44,12,61,73,151,22,4,70,83,249
411,Charlie Villanueva,PF,26,DET,76,11,1666,313,708,125,323,188,385,89,116,50,245,295,48,42,42,66,175,840
412,Sasha Vujačić,SG,26,TOT,67,17,1648,239,595,97,262,142,333,81,96,30,156,186,132,54,5,66,136,656
413,Dwyane Wade,SG,29,MIA,76,76,2823,692,1384,63,206,629,1178,494,652,123,362,485,346,111,87,237,197,1941
414,Von Wafer,SG,25,BOS,58,2,553,67,159,18,67,49,92,32,38,7,42,49,35,18,5,20,39,184
415,Henry Walker,SG,23,NYK,61,1,784,104,236,59,153,45,83,31,44,16,106,122,34,21,6,37,81,298
416,John Wall,PG,20,WAS,69,64,2606,398,972,34,115,364,857,301,393,35,282,317,574,121,35,261,175,1131
417,Ben Wallace,C,36,DET,54,49,1238,67,149,1,2,66,147,19,57,129,221,350,72,54,54,44,81,154
419,Luke Walton,SF,30,LAL,54,0,484,38,116,8,34,30,82,7,10,9,58,67,62,9,4,31,38,91
420,Willie Warren,PG,21,LAC,19,0,134,13,35,5,15,8,20,6,8,1,11,12,27,6,0,8,16,37
421,Hakim Warrick,PF,28,PHO,80,6,1416,228,446,1,11,227,435,212,294,88,208,296,69,32,9,79,100,669
422,C.J. Watson,PG,26,CHI,82,1,1091,146,394,44,112,102,282,69,93,16,78,94,186,55,11,73,82,405
423,Earl Watson,PG,31,UTA,80,13,1567,126,307,36,107,90,200,55,82,52,130,182,278,61,17,116,146,343
424,Kyle Weaver,SG,24,UTA,5,0,69,9,25,3,7,6,18,7,8,2,8,10,7,2,2,7,3,28
425,Martell Webster,SF,24,MIN,46,1,1094,152,340,55,132,97,208,94,122,36,111,147,53,28,9,58,101,453
426,Sonny Weems,SF,24,TOR,59,28,1413,228,513,17,61,211,452,72,94,39,114,153,104,34,2,86,87,545
427,David West,PF,30,NOH,70,70,2451,528,1040,2,9,526,1031,264,327,155,374,529,164,67,62,142,202,1322
428,Delonte West,PG,27,BOS,24,2,453,55,120,12,33,43,87,13,15,6,31,37,64,20,10,30,29,135
429,Mario West,SG,26,NJN,6,3,116,9,21,1,4,8,17,3,5,2,9,11,10,7,0,2,13,22
430,Russell Westbrook,PG,22,OKC,82,82,2847,614,1390,34,103,580,1287,531,631,121,258,379,670,155,30,316,207,1793
432,Hassan Whiteside,C,21,SAC,1,0,2,0,0,0,0,0,0,0,0,0,0,0,0,0,0,0,2,0
433,Chris Wilcox,PF,28,DET,57,29,995,187,322,0,1,187,321,50,89,95,176,271,43,29,17,43,145,424
434,Damien Wilkins,SF,31,ATL,52,0,676,69,137,2,10,67,127,40,56,23,67,90,41,27,9,21,72,180
435,Deron Williams,PG,26,TOT,65,65,2465,428,975,105,317,323,658,348,412,40,220,260,667,79,15,230,190,1309
436,Jason Williams,PG,35,TOT,27,0,295,22,67,10,38,12,29,0,0,3,27,30,52,11,1,18,8,54
437,Jawad Williams,SF,27,CLE,26,1,391,41,126,13,45,28,81,9,12,7,41,48,22,9,3,16,34,104
438,Lou Williams,SG,24,PHI,75,0,1747,323,795,88,253,235,542,293,356,32,117,149,252,47,17,102,128,1027
439,Marvin Williams,SF,24,ATL,65,52,1865,246,537,37,110,209,427,147,174,68,245,313,88,34,23,62,104,676
440,Mo Williams,PG,28,TOT,58,56,1788,291,730,79,244,212,486,151,177,21,132,153,380,53,10,171,150,812
441,Reggie Williams,SF,24,GSW,80,9,1626,268,572,102,241,166,331,100,134,45,171,216,121,28,3,57,124,738
442,Shawne Williams,PF,24,NYK,64,11,1323,164,385,85,212,79,173,41,49,60,179,239,47,39,51,46,164,454
443,Shelden Williams,PF,27,TOT,59,38,911,103,220,0,0,103,220,58,75,93,180,273,32,23,26,43,126,264
444,Terrence Williams,SG,23,TOT,21,0,290,43,115,6,22,37,93,14,21,4,47,51,38,9,0,33,25,106
445,Metta World Peace,SF,31,LAL,82,82,2410,261,658,83,233,178,425,92,136,100,167,267,175,124,36,90,181,697
446,Antoine Wright,SG,26,SAC,7,0,31,1,8,0,4,1,4,0,0,2,1,3,0,1,0,1,3,2
447,Brandan Wright,PF,23,TOT,37,2,379,60,117,0,0,60,117,21,31,31,58,89,12,11,17,14,34,141
448,Dorell Wright,SF,25,GSW,82,82,3147,485,1146,194,516,291,630,180,228,88,343,431,242,124,63,133,171,1344
449,Julian Wright,SF,23,TOR,52,6,766,82,160,2,10,80,150,22,43,47,71,118,58,39,20,43,45,188
450,Nick Young,SG,25,WAS,64,40,2034,412,935,105,271,307,664,186,228,26,148,174,75,45,17,90,144,1115
451,Sam Young,SF,25,MEM,78,46,1577,233,494,17,50,216,444,89,116,40,147,187,71,68,23,61,120,572
452,Thaddeus Young,PF,22,PHI,82,1,2135,458,847,6,22,452,825,123,174,153,281,434,82,90,26,99,170,1045
