Rk,Player,Pos,Age,Tm,G,GS,MP,FG,FGA,3P,3PA,2P,2PA,FT,FTA,ORB,DRB,TRB,AST,STL,BLK,TOV,PF,PTS
1,Álex Abrines,SG,25,OKC,31,2,588,56,157,41,127,15,30,12,13,5,43,48,20,17,6,14,53,165
2,Quincy Acy,PF,28,PHO,10,0,123,4,18,2,15,2,3,7,10,3,22,25,8,1,4,4,24,17
3,Jaylen Adams,PG,22,ATL,34,1,428,38,110,25,74,13,36,7,9,11,49,60,65,14,5,28,45,108
4,Steven Adams,C,25,OKC,80,80,2669,481,809,0,2,481,807,146,292,391,369,760,124,117,76,135,204,1108
5,Bam Adebayo,C,21,MIA,82,28,1913,280,486,3,15,277,471,166,226,165,432,597,184,71,65,121,203,729
6,Deng Adel,SF,21,CLE,19,3,194,11,36,6,23,5,13,4,4,3,16,19,5,1,4,6,13,32
7,DeVaughn Akoon-Purcell,SG,25,DEN,7,0,22,3,10,0,4,3,6,1,2,1,3,4,6,2,0,2,4,7
8,LaMarcus Aldridge,C,33,SAS,81,81,2687,684,1319,10,42,674,1277,349,412,251,493,744,194,43,107,144,179,1727
9,Rawle Alkins,SG,21,CHI,10,1,120,13,39,3,12,10,27,8,12,11,15,26,13,1,0,8,7,37
10,Grayson Allen,SG,23,UTA,38,2,416,67,178,32,99,35,79,45,60,3,20,23,25,6,6,33,47,211
11,Jarrett Allen,C,20,BRK,80,80,2096,335,568,6,45,329,523,197,278,191,481,672,110,43,120,103,184,873
12,Kadeem Allen,SG,26,NYK,19,1,416,65,141,17,36,48,105,42,54,8,43,51,76,16,4,26,46,189
13,Al-Farouq Aminu,PF,28,POR,81,81,2292,257,593,96,280,161,313,150,173,112,498,610,104,68,33,72,143,760
14,Justin Anderson,SF,25,ATL,48,4,463,64,157,24,77,40,80,26,35,24,60,84,23,22,13,23,48,178
15,Kyle Anderson,SF,25,MEM,43,40,1281,150,276,9,34,141,242,37,64,48,203,251,128,54,37,58,112,346
16,Ryan Anderson,PF,30,TOT,25,8,322,21,69,9,40,12,29,12,16,18,36,54,19,4,1,14,25,63
17,Ike Anigbogu,C,20,IND,3,0,6,0,3,0,0,0,3,0,0,1,2,3,1,0,1,1,0,0
18,Giannis Antetokounmpo,PF,24,MIL,72,72,2358,721,1247,52,203,669,1044,500,686,159,739,898,424,92,110,268,232,1994
19,Kostas Antetokounmpo,PF,21,DAL,2,0,11,0,3,0,0,0,3,2,4,0,1,1,0,2,0,1,0,2
20,Carmelo Anthony,PF,34,HOU,10,2,294,49,121,21,64,28,57,15,22,9,45,54,5,4,7,8,32,134
21,OG Anunoby,SF,21,TOR,67,6,1352,183,404,67,202,116,202,36,62,58,139,197,47,46,22,55,140,469
22,Ryan Arcidiacono,PG,24,CHI,81,32,1961,187,418,81,217,106,201,89,102,27,192,219,269,65,4,63,171,544
23,Trevor Ariza,SF,33,TOT,69,69,2349,294,736,145,434,149,302,130,164,50,321,371,252,91,21,106,130,863
24,D.J. Augustin,PG,31,ORL,81,81,2269,318,677,131,311,187,366,181,209,41,162,203,426,52,4,128,115,948
25,Deandre Ayton,C,20,PHO,71,70,2183,509,870,0,4,509,866,141,189,223,506,729,125,61,67,126,209,1159
26,Dwayne Bacon,SG,23,CHO,43,13,759,122,257,38,87,84,170,34,46,8,81,89,47,12,5,18,72,316
27,Marvin Bagley,PF,19,SAC,62,4,1567,356,706,30,96,326,610,181,262,162,309,471,62,33,59,98,120,923
28,Ron Baker,SG,25,TOT,15,0,152,4,20,1,13,3,7,5,6,1,10,11,15,6,1,5,18,14
29,Wade Baldwin,PG,22,POR,16,0,94,10,33,2,9,8,24,8,11,2,13,15,12,1,2,14,11,30
30,Lonzo Ball,PG,21,LAL,47,45,1423,185,456,75,228,110,228,20,48,54,197,251,255,69,19,103,114,465
31,Mo Bamba,C,20,ORL,47,1,766,117,243,21,70,96,173,37,63,64,169,233,39,13,64,43,102,292
32,J.J. Barea,PG,34,DAL,38,0,752,161,385,38,128,123,257,55,78,13,82,95,211,22,1,72,50,415
34,Will Barton,SG,28,DEN,43,38,1189,185,460,67,196,118,264,57,74,32,167,199,124,18,22,65,82,494
35,Keita Bates-Diop,SF,23,MIN,30,3,503,60,142,13,52,47,90,18,28,16,67,83,17,18,14,14,29,151
36,Nicolas Batum,SF,30,CHO,75,72,2354,253,562,116,298,137,264,77,89,71,319,390,247,71,43,117,140,699
37,Jerryd Bayless,PG,30,MIN,34,6,657,82,230,29,98,53,132,16,28,11,51,62,119,18,2,32,56,209
38,Aron Baynes,C,32,BOS,51,18,821,105,223,21,61,84,162,53,62,88,152,240,57,12,34,40,125,284
39,Kent Bazemore,SG,29,ATL,67,35,1643,278,691,96,300,182,391,127,175,37,224,261,152,89,42,121,170,779
40,Bradley Beal,SG,25,WAS,82,82,3028,764,1609,209,596,555,1013,362,448,89,322,411,448,121,58,224,226,2099
41,Malik Beasley,SG,22,DEN,81,18,1879,349,737,163,405,186,332,56,66,35,165,200,97,55,10,55,116,917
42,Michael Beasley,PF,30,LAL,26,2,277,75,153,3,17,72,136,28,39,13,47,60,25,9,10,27,42,181
43,Marco Belinelli,SG,32,SAS,79,1,1815,285,690,147,395,138,295,112,124,16,182,198,132,35,8,72,121,829
44,Jordan Bell,C,24,GSW,68,3,788,99,192,0,2,99,190,25,41,55,129,184,76,20,51,42,80,223
45,DeAndre' Bembry,SG,24,ATL,82,15,1931,275,616,50,173,225,443,87,136,54,304,358,202,105,41,142,190,687
46,Dragan Bender,PF,21,PHO,46,27,826,88,197,22,101,66,96,32,54,34,149,183,56,18,22,37,90,230
47,Dairis Bertāns,SG,29,NOP,12,0,167,12,47,10,34,2,13,0,0,2,7,9,10,1,0,2,7,34
48,Dāvis Bertāns,PF,26,SAS,76,12,1632,204,453,145,338,59,115,53,60,23,241,264,100,35,33,43,133,606
49,Patrick Beverley,PG,30,LAC,78,49,2137,194,477,112,282,82,195,96,123,76,312,388,300,67,43,85,265,596
50,Khem Birch,C,26,ORL,50,1,643,91,151,0,1,91,150,58,83,79,111,190,38,18,29,20,72,240
51,Bismack Biyombo,C,26,CHO,54,32,783,89,156,0,0,89,156,58,91,81,166,247,33,11,41,34,103,236
52,Nemanja Bjelica,PF,30,SAC,77,70,1788,284,593,103,257,181,336,70,92,125,319,444,147,54,56,82,197,741
53,Antonio Blakeney,SG,22,CHI,57,3,829,166,396,36,91,130,305,50,76,7,99,106,42,12,9,35,41,418
54,Eric Bledsoe,PG,29,MIL,78,78,2272,470,971,124,377,346,594,177,236,82,280,362,430,116,29,165,156,1241
55,Jaron Blossomgame,SF,25,CLE,27,4,439,47,106,10,39,37,67,10,13,26,72,98,13,7,8,11,20,114
56,Bogdan Bogdanović,SG,26,SAC,70,17,1947,361,863,134,372,227,491,134,162,40,203,243,267,72,15,117,142,990
57,Bojan Bogdanović,SF,29,IND,81,81,2573,522,1051,164,386,358,665,246,305,33,300,333,161,69,1,134,138,1454
58,Andrew Bogut,C,34,GSW,11,5,134,18,36,0,0,18,36,3,3,12,43,55,11,3,8,8,22,39
59,Jonah Bolden,PF,23,PHI,44,10,639,80,162,34,96,46,66,13,27,47,118,165,40,17,39,36,99,207
60,Isaac Bonga,PG,19,LAL,22,0,120,5,33,0,8,5,25,9,15,9,16,25,15,9,4,6,9,19
61,Devin Booker,SG,22,PHO,64,64,2242,586,1255,135,414,451,841,393,454,39,226,265,433,56,13,264,200,1700
62,Chris Boucher,PF,26,TOR,28,0,163,34,76,12,37,22,39,13,15,16,40,56,2,6,24,7,31,93
63,Avery Bradley,SG,28,TOT,63,63,1905,248,608,86,245,162,363,43,50,43,132,175,152,41,16,89,167,625
64,Tony Bradley,C,21,UTA,3,0,36,8,16,0,0,8,16,1,2,9,6,15,1,2,2,3,6,17
65,Corey Brewer,SF,32,TOT,31,3,492,53,123,14,44,39,79,31,43,26,50,76,39,32,7,19,63,151
66,Mikal Bridges,SF,22,PHO,82,56,2417,242,563,105,313,137,250,95,118,56,208,264,173,129,38,70,201,684
67,Miles Bridges,SF,20,CHO,80,25,1696,237,511,65,200,172,311,58,77,67,256,323,95,55,49,50,111,597
68,Isaiah Briscoe,PG,22,ORL,39,0,559,55,138,11,34,44,104,15,26,5,69,74,87,11,2,31,66,136
69,Ryan Broekhoff,SG,28,DAL,42,0,453,57,126,38,93,19,33,15,19,8,55,63,22,6,4,16,35,167
70,Malcolm Brogdon,SG,26,MIL,64,64,1832,378,748,104,244,274,504,141,152,65,223,288,205,46,13,91,102,1001
71,Dillon Brooks,SF,23,MEM,18,0,330,49,122,15,40,34,82,22,30,9,22,31,16,10,4,19,50,135
72,MarShon Brooks,SG,30,MEM,29,0,387,76,169,15,54,61,115,23,33,12,33,45,25,9,4,21,33,190
73,Bruce Brown,SG,22,DET,74,56,1449,125,314,24,93,101,221,45,60,48,137,185,91,40,36,46,178,319
74,Jaylen Brown,SG,22,BOS,74,25,1913,368,792,95,276,273,516,133,202,65,248,313,100,69,32,99,186,964
75,Lorenzo Brown,PG,28,TOR,26,0,212,23,71,6,28,17,43,3,3,5,26,31,28,12,5,16,22,55
76,Sterling Brown,SG,23,MIL,58,7,1034,145,312,53,147,92,165,29,42,29,155,184,84,25,8,46,88,372
77,Troy Brown,SF,19,WAS,52,10,730,97,234,22,69,75,165,32,47,35,110,145,80,21,5,30,56,248
78,Jalen Brunson,PG,22,DAL,73,38,1591,264,565,63,181,201,384,87,120,25,144,169,230,37,4,88,127,678
79,Thomas Bryant,C,21,WAS,72,53,1496,309,502,33,99,276,403,107,137,113,341,454,92,25,67,60,126,758
80,Reggie Bullock,SG,27,TOT,63,60,1879,245,594,148,393,97,201,73,85,22,151,173,129,40,12,65,109,711
81,Trey Burke,PG,26,TOT,58,8,1125,236,548,56,159,180,389,103,124,28,71,99,159,33,7,49,58,631
82,Alec Burks,SG,27,TOT,64,24,1375,192,474,61,168,131,306,116,141,30,205,235,128,39,21,65,91,561
83,Deonte Burton,SG,25,OKC,32,0,240,33,82,8,27,25,55,8,12,4,24,28,9,6,8,9,31,82
85,Bruno Caboclo,SF,23,MEM,34,19,800,96,225,48,130,48,95,42,50,42,116,158,50,14,33,38,81,282
86,José Calderón,PG,37,DET,49,0,632,45,120,14,57,31,63,9,11,11,49,60,115,16,3,35,64,113
87,Kentavious Caldwell-Pope,SG,25,LAL,82,23,2035,325,756,151,435,174,321,137,158,48,190,238,110,73,13,65,137,938
88,Isaiah Canaan,PG,27,TOT,30,16,629,64,164,34,96,30,68,19,24,6,52,58,84,14,2,35,52,181
89,Clint Capela,C,24,HOU,67,67,2249,474,732,0,0,474,732,166,261,298,550,848,96,44,102,94,168,1114
90,DeMarre Carroll,PF,32,BRK,67,8,1703,227,575,106,310,121,265,184,242,68,281,349,85,31,10,73,114,744
91,Jevon Carter,PG,23,MEM,39,3,577,56,185,34,102,22,83,26,32,14,52,66,69,26,11,33,55,172
92,Vince Carter,PF,42,ATL,76,9,1330,196,468,123,316,73,152,47,66,31,163,194,87,44,27,48,141,562
93,Wendell Carter,C,19,CHI,44,44,1110,180,371,6,32,174,339,89,112,87,220,307,78,26,58,65,152,455
94,Michael Carter-Williams,PG,27,TOT,28,1,372,46,123,10,38,36,85,32,53,19,51,70,70,20,15,20,48,134
95,Alex Caruso,PG,24,LAL,25,4,531,77,173,24,50,53,123,51,64,20,47,67,77,24,9,42,54,229
96,Omri Casspi,SF,30,MEM,36,0,520,86,161,15,43,71,118,39,58,17,98,115,26,20,9,23,35,226
97,Willie Cauley-Stein,C,25,SAC,81,81,2213,412,741,1,2,411,739,140,254,181,497,678,194,96,51,84,227,965
98,Troy Caupain,PG,23,ORL,4,0,16,4,8,2,3,2,5,0,0,1,2,3,4,1,0,0,0,10
99,Tyler Cavanaugh,PF,24,UTA,11,0,39,3,10,1,5,2,5,2,2,3,5,8,1,0,0,1,3,9
100,Tyson Chandler,C,36,TOT,55,6,875,61,99,0,1,61,98,51,87,92,215,307,37,21,23,42,110,173
102,Joe Chealey,PG,23,CHO,1,0,8,1,3,0,0,1,3,0,0,0,0,0,1,0,0,0,1,2
103,Chris Chiozza,PG,23,HOU,7,0,33,2,8,2,5,0,3,0,0,1,3,4,4,1,1,1,2,6
104,Marquese Chriss,PF,21,TOT,43,2,499,67,180,16,72,51,108,32,45,40,102,142,22,17,11,36,81,182
105,Gary Clark,PF,24,HOU,51,2,641,50,151,41,138,9,13,7,7,24,92,116,18,20,26,7,47,148
106,Ian Clark,SG,27,NOP,60,6,973,151,383,66,202,85,181,33,37,13,76,89,94,22,8,58,95,401
107,Jordan Clarkson,SG,26,CLE,81,0,2214,529,1180,144,445,385,735,162,192,82,188,270,196,57,13,135,112,1364
108,John Collins,PF,21,ATL,61,59,1829,465,831,55,158,410,673,203,266,219,376,595,121,22,39,120,199,1188
109,Zach Collins,C,21,POR,77,0,1356,189,400,40,121,149,279,94,126,109,215,324,71,25,66,77,174,512
110,Darren Collison,PG,31,IND,76,76,2143,308,659,79,194,229,465,158,190,36,196,232,459,110,9,125,138,853
111,Bonzie Colson,SF,23,MIL,8,2,98,13,39,5,21,8,18,8,9,8,22,30,3,5,1,3,3,39
112,Mike Conley,PG,31,MEM,70,70,2342,490,1120,155,426,335,694,343,406,40,199,239,449,94,22,130,123,1478
113,Pat Connaughton,SG,26,MIL,61,2,1261,163,350,66,200,97,150,29,40,61,197,258,122,33,25,33,81,421
114,Quinn Cook,PG,25,GSW,74,10,1059,204,439,81,200,123,239,20,26,22,135,157,116,20,3,50,92,509
115,DeMarcus Cousins,C,28,GSW,30,30,771,178,371,26,95,152,276,106,144,43,204,247,107,40,44,72,109,488
116,Robert Covington,SF,28,TOT,35,35,1203,156,362,85,225,71,137,68,89,28,165,193,46,74,47,47,126,465
117,Allen Crabbe,SG,26,BRK,43,20,1133,137,373,98,259,39,114,41,56,16,132,148,46,23,13,46,102,413
118,Torrey Craig,SF,28,DEN,75,37,1503,160,362,61,188,99,174,49,70,89,174,263,72,37,46,44,175,430
119,Jamal Crawford,SG,38,PHO,64,0,1211,174,438,67,202,107,236,93,110,8,77,85,229,33,12,99,75,508
120,Mitch Creek,SF,26,TOT,5,0,48,8,16,0,2,8,14,5,7,6,6,12,6,2,0,1,3,21
121,Jae Crowder,SF,28,UTA,80,11,2166,318,797,173,522,145,275,142,197,60,324,384,133,64,31,85,170,951
122,Dante Cunningham,PF,31,SAS,64,21,928,75,158,30,65,45,93,14,18,48,140,188,50,27,13,22,71,194
123,Seth Curry,SG,28,POR,74,2,1399,212,465,113,251,99,214,44,52,27,93,120,66,36,12,61,97,581
124,Stephen Curry,PG,30,GSW,69,69,2331,632,1340,354,810,278,530,263,287,45,324,369,361,92,25,192,166,1881
125,Troy Daniels,SG,27,PHO,51,1,760,113,275,74,194,39,81,18,23,13,60,73,26,26,5,27,79,318
126,Anthony Davis,C,25,NOP,56,56,1850,530,1026,48,145,482,881,344,433,174,498,672,218,88,135,112,132,1452
127,Deyonta Davis,C,22,ATL,9,0,118,15,22,0,1,15,21,6,10,10,26,36,5,3,5,3,12,36
128,Ed Davis,C,29,BRK,81,1,1446,186,302,0,2,186,300,100,162,216,478,694,61,35,33,64,226,472
129,Tyler Davis,C,21,OKC,1,0,1,0,1,0,0,0,1,0,0,1,0,1,0,0,0,0,0,0
130,Dewayne Dedmon,C,29,ATL,64,52,1609,259,526,83,217,176,309,92,113,105,375,480,90,69,71,84,214,693
131,Sam Dekker,PF,24,TOT,47,5,788,120,256,19,62,101,194,28,46,53,95,148,46,38,7,24,47,287
132,Ángel Delgado,C,24,LAC,2,0,15,1,5,0,0,1,5,1,2,2,2,4,0,1,0,0,2,3
133,Matthew Dellavedova,PG,28,TOT,48,0,812,98,242,44,130,54,112,42,52,6,71,77,181,14,2,68,75,282
134,Luol Deng,SF,33,MIN,22,2,392,59,118,14,44,45,74,25,35,20,53,73,18,15,8,14,24,157
135,DeMar DeRozan,SG,29,SAS,77,77,2688,631,1313,7,45,624,1268,366,441,54,408,462,475,86,36,199,177,1635
136,Marcus Derrickson,PF,22,GSW,11,0,67,16,33,10,20,6,13,4,5,8,5,13,1,0,1,3,9,46
137,Cheick Diallo,PF,22,NOP,64,1,896,168,271,1,4,167,267,50,67,75,257,332,33,29,33,49,113,387
138,Hamidou Diallo,SG,20,OKC,51,3,526,75,165,4,24,71,141,36,59,38,59,97,17,21,10,23,77,190
139,Gorgui Dieng,C,29,MIN,76,2,1031,189,377,19,56,170,321,88,106,81,230,311,72,48,41,57,134,485
140,Spencer Dinwiddie,PG,25,BRK,68,4,1914,366,828,124,370,242,458,287,356,26,140,166,311,40,17,152,187,1143
141,Donte DiVincenzo,SG,22,MIL,27,0,411,50,124,22,83,28,41,9,12,16,49,65,31,13,6,19,38,131
142,Luka Dončić,SG,19,DAL,72,72,2318,506,1186,168,514,338,672,346,485,86,477,563,429,77,25,247,137,1526
143,Tyler Dorsey,SG,22,TOT,48,11,698,107,264,44,132,63,132,38,61,27,86,113,56,14,2,27,53,296
144,Damyean Dotson,SG,24,NYK,73,40,2004,290,698,126,342,164,356,73,98,34,228,262,135,58,10,71,135,779
145,PJ Dozier,SG,22,BOS,6,0,51,8,21,2,8,6,13,1,2,6,11,17,5,2,0,0,2,19
146,Goran Dragić,PG,32,MIA,36,22,991,179,433,57,164,122,269,79,101,20,91,111,174,30,5,71,81,494
147,Andre Drummond,C,25,DET,79,79,2647,561,1052,5,38,556,1014,243,412,423,809,1232,112,136,138,175,272,1370
148,Jared Dudley,PF,33,BRK,59,25,1220,101,239,53,151,48,88,32,46,34,121,155,83,36,16,43,131,287
149,Kris Dunn,PG,24,CHI,46,44,1389,215,506,34,96,181,410,55,69,19,168,187,277,68,21,104,166,519
150,Kevin Durant,SF,30,GSW,78,78,2702,721,1383,137,388,584,995,448,506,33,464,497,457,58,84,225,155,2027
151,Trevon Duval,PG,20,MIL,3,0,6,2,3,1,1,1,2,0,0,0,1,1,2,0,0,0,0,5
152,Vince Edwards,SF,22,HOU,2,0,16,1,4,1,4,0,0,0,0,1,1,2,0,0,0,0,0,3
153,Henry Ellenson,PF,22,TOT,19,0,259,39,95,17,38,22,57,19,25,5,61,66,16,7,2,9,27,114
154,Wayne Ellington,SG,31,TOT,53,38,1297,184,457,138,372,46,85,39,49,14,93,107,72,54,6,40,92,545
155,Joel Embiid,C,24,PHI,64,64,2154,580,1199,79,263,501,936,522,649,160,711,871,234,46,122,226,211,1761
156,James Ennis,SF,28,TOT,58,27,1230,138,294,55,156,83,138,58,81,60,122,182,41,41,23,34,150,389
157,Drew Eubanks,PF,21,SAS,23,0,113,15,26,0,0,15,26,11,13,6,28,34,7,2,5,8,11,41
158,Jacob Evans,SG,21,GSW,30,1,204,18,53,4,15,14,38,0,1,6,19,25,23,5,3,11,28,40
159,Jawun Evans,PG,22,TOT,8,0,65,3,14,0,3,3,11,0,0,1,11,12,10,3,0,6,8,6
160,Tyreke Evans,SG,29,IND,69,18,1402,257,660,77,216,180,444,115,160,33,168,201,166,58,18,118,117,706
161,Dante Exum,PG,23,UTA,42,1,664,101,241,18,62,83,179,68,86,16,52,68,110,14,5,52,69,288
162,Kenneth Faried,C,29,TOT,37,13,728,156,265,8,25,148,240,64,99,97,153,250,20,17,23,33,82,384
163,Derrick Favors,C,27,UTA,76,70,1766,363,619,17,78,346,541,154,228,207,353,560,89,56,106,84,163,897
164,Cristiano Felício,C,26,CHI,60,0,746,95,179,0,4,95,175,50,73,79,139,218,37,11,7,33,69,240
165,Raymond Felton,PG,34,OKC,33,0,379,55,135,20,61,35,74,12,13,4,30,34,52,10,6,14,29,142
166,Terrance Ferguson,SG,20,OKC,74,74,1931,185,431,106,290,79,141,37,51,33,108,141,72,40,16,47,231,513
167,Yogi Ferrell,PG,25,SAC,71,3,1067,153,352,54,149,99,203,60,67,13,96,109,137,36,4,40,64,420
168,Dorian Finney-Smith,SF,25,DAL,81,26,1985,228,528,79,254,149,274,73,103,138,251,389,95,69,36,74,186,608
169,Bryn Forbes,SG,25,SAS,82,81,2293,361,791,176,413,185,378,69,78,18,221,239,175,45,4,80,159,967
170,Evan Fournier,SG,26,ORL,81,81,2553,468,1069,153,450,315,619,137,170,38,220,258,295,71,12,154,225,1226
171,De'Aaron Fox,PG,21,SAC,81,81,2546,505,1102,86,232,419,870,303,417,43,261,304,590,133,45,227,204,1399
172,Melvin Frazier,SG,22,ORL,10,0,44,7,21,0,6,7,15,1,4,3,2,5,1,1,0,1,6,15
173,Tim Frazier,PG,28,TOT,59,19,1120,116,261,37,101,79,160,41,54,41,127,168,248,30,5,76,112,310
174,Jimmer Fredette,SG,29,PHO,6,0,65,8,29,0,13,8,16,6,6,1,6,7,8,3,0,5,5,22
175,Channing Frye,C,35,CLE,36,6,341,43,117,32,79,11,38,11,14,4,48,52,20,6,5,13,44,129
176,Markelle Fultz,SG,20,PHI,19,15,427,65,155,4,14,61,141,21,37,26,44,70,59,17,5,25,52,155
177,Danilo Gallinari,SF,30,LAC,68,68,2059,409,884,161,372,248,512,367,406,54,363,417,178,49,23,99,129,1346
178,Langston Galloway,SG,27,DET,80,4,1745,228,587,135,380,93,207,81,96,49,122,171,85,37,8,24,135,672
179,Billy Garrett,SG,24,NYK,4,0,63,11,27,0,8,11,19,4,4,0,3,3,7,1,1,2,3,26
180,Marc Gasol,C,34,TOT,79,72,2436,390,870,99,273,291,597,192,253,80,547,627,349,84,86,155,217,1071
181,Pau Gasol,C,38,TOT,30,6,360,42,94,6,13,36,81,28,40,22,115,137,52,5,15,16,29,118
182,Rudy Gay,PF,32,SAS,69,51,1842,376,746,74,184,302,562,120,147,63,407,470,182,54,34,114,159,946
183,Paul George,SF,28,OKC,77,77,2841,707,1614,292,757,415,857,453,540,105,523,628,318,170,34,205,214,2159
184,Taj Gibson,PF,33,MIN,70,57,1686,304,537,11,34,293,503,134,177,172,286,458,84,53,39,73,186,753
185,Harry Giles,PF,20,SAC,58,0,820,175,348,0,6,175,342,58,91,66,156,222,85,31,22,73,150,408
186,Shai Gilgeous-Alexander,PG,20,LAC,82,73,2174,341,716,51,139,290,577,156,195,57,175,232,270,96,45,141,175,889
187,Rudy Gobert,C,26,UTA,81,80,2577,476,712,0,0,476,712,332,522,309,732,1041,161,66,187,130,231,1284
188,Brandon Goodwin,PG,23,DEN,16,0,57,6,23,2,6,4,17,9,11,1,2,3,14,0,0,3,7,23
189,Aaron Gordon,PF,23,ORL,78,78,2633,470,1046,121,347,349,699,185,253,129,445,574,289,57,56,162,172,1246
190,Eric Gordon,SG,30,HOU,68,53,2158,384,938,216,600,168,338,119,152,17,131,148,129,41,27,90,143,1103
191,Marcin Gortat,C,34,LAC,47,43,751,99,186,0,0,99,186,35,48,67,194,261,65,6,24,50,92,233
192,Devonte' Graham,PG,23,CHO,46,3,676,74,216,34,121,40,95,35,46,10,53,63,121,23,2,30,48,217
193,Treveon Graham,SG,25,BRK,35,21,715,64,191,38,128,26,63,18,22,23,84,107,34,13,7,17,68,184
194,Jerami Grant,PF,24,OKC,80,77,2612,409,823,115,293,294,530,157,221,96,321,417,79,61,100,67,214,1090
195,Jerian Grant,PG,26,ORL,60,1,939,92,220,40,110,52,110,26,40,19,79,98,156,44,6,51,78,250
196,Donte Grantham,SF,23,OKC,3,0,2,0,2,0,2,0,0,0,0,0,0,0,0,0,0,0,0,0
197,Danny Green,SG,31,TOR,80,80,2216,293,630,198,435,95,195,37,44,60,257,317,126,73,53,75,171,821
198,Draymond Green,PF,28,GSW,66,66,2065,188,422,47,165,141,257,63,91,60,421,481,454,95,70,169,197,486
199,Gerald Green,SG,33,HOU,73,0,1473,231,578,156,441,75,137,57,68,30,152,182,40,33,27,55,126,675
200,JaMychal Green,PF,28,TOT,65,6,1371,230,476,71,176,159,300,80,101,104,305,409,50,45,34,87,193,611
201,Jeff Green,PF,32,WAS,77,44,2097,326,687,111,320,215,367,183,206,57,252,309,137,43,39,101,160,946
202,Blake Griffin,PF,29,DET,75,75,2622,619,1341,189,522,430,819,414,550,100,465,565,402,52,28,253,199,1841
203,Daniel Hamilton,SG,23,ATL,19,3,204,23,60,8,23,15,37,3,6,10,37,47,22,6,1,16,19,57
204,Dusty Hannahs,SG,25,MEM,2,0,26,3,12,0,5,3,7,2,2,0,1,1,5,1,0,1,1,8
205,Tim Hardaway,SG,26,TOT,65,63,2057,390,993,162,477,228,516,232,276,33,189,222,159,54,8,105,141,1174
206,James Harden,PG,29,HOU,78,78,2867,843,1909,378,1028,465,881,754,858,66,452,518,586,158,58,387,244,2818
207,Maurice Harkless,SF,25,POR,60,53,1415,189,388,33,120,156,268,49,73,77,192,269,74,67,53,45,163,460
208,Montrezl Harrell,C,25,LAC,82,5,2158,546,888,3,17,543,871,266,414,184,351,535,162,71,110,132,255,1361
209,Devin Harris,PG,35,DAL,68,2,1071,132,347,62,200,70,147,102,134,12,100,112,122,35,16,56,133,428
210,Gary Harris,SG,24,DEN,57,48,1639,270,637,82,242,188,395,115,144,41,119,160,127,55,19,68,113,737
211,Joe Harris,SG,27,BRK,76,76,2293,374,748,183,386,191,362,110,133,52,239,291,181,38,17,121,182,1041
212,Tobias Harris,PF,26,TOT,82,82,2847,611,1254,156,393,455,861,266,307,69,576,645,229,51,37,151,184,1644
213,Andrew Harrison,PG,24,TOT,17,0,187,16,53,5,25,11,28,17,18,6,14,20,24,4,2,12,34,54
214,Shaquille Harrison,PG,25,CHI,73,11,1430,184,426,24,89,160,337,82,123,33,189,222,139,89,30,60,124,474
215,Josh Hart,SG,23,LAL,67,22,1715,189,464,92,274,97,190,55,80,35,213,248,93,64,40,58,147,525
216,Isaiah Hartenstein,PF,20,HOU,28,0,221,20,41,2,6,18,35,11,14,21,26,47,15,7,12,13,56,53
217,Udonis Haslem,C,38,MIA,10,1,74,11,33,0,12,11,21,3,4,3,24,27,2,0,0,3,9,25
218,Gordon Hayward,PF,28,BOS,72,18,1863,296,635,77,231,219,404,156,187,51,271,322,244,62,23,105,104,825
219,John Henson,C,28,MIL,14,0,188,31,67,11,31,20,36,6,10,16,55,71,14,7,11,12,16,79
220,Juan Hernangómez,PF,23,DEN,70,25,1358,138,314,66,181,72,133,66,86,64,201,265,55,27,24,37,94,408
221,Willy Hernangómez,C,24,CHO,58,3,812,153,295,15,39,138,256,100,144,117,194,311,60,16,20,58,98,421
222,Mario Hezonja,SF,23,NYK,58,24,1206,191,464,42,152,149,312,87,114,28,211,239,88,57,8,88,110,511
223,Isaiah Hicks,PF,24,NYK,3,0,32,4,8,0,0,4,8,4,5,2,5,7,2,1,3,1,5,12
224,Buddy Hield,SG,26,SAC,82,82,2615,623,1360,278,651,345,709,171,193,106,306,412,205,58,33,146,202,1695
225,Haywood Highsmith,SF,22,PHI,5,0,40,4,10,1,5,3,5,0,2,0,5,5,2,1,0,1,1,9
226,Nenê Hilário,C,36,HOU,42,2,546,60,116,0,3,60,113,31,47,34,89,123,26,18,15,11,87,151
227,George Hill,PG,32,TOT,60,13,1302,170,376,48,153,122,223,70,85,39,109,148,135,52,8,51,102,458
228,Solomon Hill,SF,27,NOP,44,15,878,68,178,32,101,36,77,23,32,34,99,133,55,23,10,31,80,191
229,Aaron Holiday,PG,22,IND,50,0,646,105,262,43,127,62,135,41,50,5,62,67,87,21,13,40,71,294
230,Jrue Holiday,SG,28,NOP,67,67,2402,547,1159,118,363,429,796,208,271,75,259,334,518,109,54,210,148,1420
231,Justin Holiday,SG,29,TOT,82,77,2607,300,777,162,465,138,312,95,106,46,277,323,146,121,36,104,164,857
232,John Holland,SF,30,CLE,1,0,1,0,0,0,0,0,0,0,0,0,0,0,0,0,0,0,0,0
233,Rondae Hollis-Jefferson,SF,24,BRK,59,21,1234,200,487,9,49,191,438,118,183,83,227,310,96,44,27,68,107,527
234,Richaun Holmes,C,25,PHO,70,4,1184,222,365,0,0,222,365,128,175,115,216,331,60,42,79,52,194,572
235,Rodney Hood,SG,26,TOT,72,49,1893,292,671,84,236,208,435,137,155,25,132,157,126,59,12,55,146,805
236,Al Horford,C,32,BOS,68,68,1973,387,723,73,203,314,520,78,95,120,338,458,283,59,86,102,126,925
237,Danuel House,SF,25,HOU,39,13,979,118,252,74,178,44,74,56,71,25,115,140,40,21,11,35,80,366
238,Dwight Howard,C,33,WAS,9,9,230,43,69,0,0,43,69,29,48,24,59,83,4,7,4,16,34,115
239,Kevin Huerter,SG,20,ATL,75,59,2048,275,657,136,353,139,304,41,56,60,185,245,214,65,25,109,155,727
240,Isaac Humphries,C,21,ATL,5,1,56,6,21,3,11,3,10,0,0,4,7,11,0,1,0,0,7,15
241,R.J. Hunter,SG,25,BOS,1,0,26,6,13,4,10,2,3,1,2,1,2,3,3,1,0,0,3,17
242,Chandler Hutchison,SF,22,CHI,44,14,895,96,209,14,50,82,159,23,38,31,154,185,34,23,6,25,59,229
243,Serge Ibaka,C,29,TOR,74,51,2010,464,877,49,169,415,708,135,177,156,445,601,99,29,103,114,211,1112
244,Andre Iguodala,SF,35,GSW,68,13,1578,151,302,48,144,103,158,39,67,48,204,252,216,61,51,52,95,389
245,Ersan İlyasova,PF,31,MIL,67,7,1231,167,381,58,160,109,221,61,74,94,208,302,52,32,20,48,172,453
246,Joe Ingles,PF,31,UTA,82,82,2568,359,802,189,483,170,319,87,123,35,295,330,469,98,20,193,180,994
247,Andre Ingram,SG,33,LAL,4,0,15,0,6,0,3,0,3,0,0,1,1,2,0,1,0,1,0,0
248,Brandon Ingram,SF,21,LAL,52,52,1760,362,729,31,94,331,635,195,289,41,226,267,154,28,31,129,149,950
249,Kyrie Irving,PG,26,BOS,67,67,2214,604,1241,174,434,430,807,214,245,71,264,335,464,103,34,172,167,1596
250,Jonathan Isaac,PF,21,ORL,75,64,1996,262,611,86,266,176,345,110,135,99,312,411,80,59,98,75,143,720
251,Wesley Iwundu,SF,24,ORL,68,13,1233,113,274,29,79,84,195,84,103,37,147,184,73,28,22,44,123,339
252,Demetrius Jackson,PG,24,PHI,6,0,39,8,15,2,6,6,9,4,4,2,1,3,5,2,0,1,4,22
253,Frank Jackson,PG,20,NOP,61,16,1169,194,447,53,169,141,278,54,73,25,109,134,69,25,2,48,92,495
254,Jaren Jackson,PF,19,MEM,58,56,1515,298,589,51,142,247,447,151,197,73,199,272,64,52,82,98,220,798
255,Josh Jackson,SG,21,PHO,79,29,1988,347,841,73,225,274,616,143,213,66,281,347,183,74,56,173,209,910
256,Justin Jackson,SF,23,TOT,81,14,1614,217,485,87,245,130,240,62,79,44,168,212,96,32,14,29,99,583
257,Reggie Jackson,PG,28,DET,82,82,2289,441,1047,174,471,267,576,204,236,45,171,216,344,55,9,148,208,1260
258,LeBron James,SF,34,LAL,55,55,1937,558,1095,111,327,447,768,278,418,57,408,465,454,72,33,197,94,1505
259,Amile Jefferson,PF,25,ORL,12,0,68,10,16,0,0,10,16,7,8,6,15,21,3,3,3,1,8,27
260,John Jenkins,SG,27,TOT,26,0,333,42,105,22,58,20,47,15,18,6,31,37,22,0,2,9,10,121
261,Jonas Jerebko,PF,31,GSW,73,6,1218,163,355,69,188,94,167,64,80,72,216,288,96,27,18,43,137,459
262,Alize Johnson,PF,22,IND,14,0,64,4,16,1,2,3,14,4,8,4,15,19,1,1,3,0,7,13
263,Amir Johnson,C,31,PHI,51,6,529,79,157,12,40,67,117,31,41,47,100,147,60,16,13,45,99,201
264,B.J. Johnson,SF,23,TOT,7,0,49,9,18,3,7,6,11,2,2,2,6,8,0,2,0,2,4,23
265,James Johnson,PF,31,MIA,55,33,1164,164,379,50,149,114,230,50,70,22,154,176,135,35,27,74,114,428
266,Stanley Johnson,SF,22,TOT,66,7,1208,171,440,62,215,109,225,50,64,34,183,217,88,60,14,81,114,454
267,Tyler Johnson,PG,26,TOT,57,22,1529,217,526,90,260,127,266,95,127,34,139,173,166,54,27,77,97,619
268,Wesley Johnson,SF,31,TOT,38,13,534,45,128,25,76,20,52,13,19,12,60,72,23,14,12,18,63,128
269,Nikola Jokić,C,23,DEN,80,80,2504,616,1206,83,270,533,936,289,352,228,637,865,580,108,55,248,228,1604
270,Damian Jones,C,23,GSW,24,22,410,53,74,0,0,53,74,24,37,31,44,75,28,12,25,16,63,130
271,Derrick Jones,SF,21,MIA,60,14,1153,160,324,28,91,132,233,74,122,96,144,240,37,46,42,43,123,422
272,Jalen Jones,SF,25,CLE,16,0,214,26,62,10,28,16,34,19,27,11,23,34,7,9,2,8,27,81
273,Jemerrio Jones,SF,23,LAL,6,2,143,12,33,2,10,10,23,1,2,16,33,49,13,7,5,5,10,27
274,Terrence Jones,PF,27,HOU,2,0,5,1,4,0,2,1,2,0,1,0,4,4,0,0,0,1,1,2
275,Tyus Jones,PG,22,MIN,68,23,1560,185,446,40,126,145,320,58,69,23,111,134,327,81,5,47,78,468
276,DeAndre Jordan,C,30,TOT,69,69,2047,286,446,0,0,286,446,186,264,225,677,902,156,42,73,153,167,758
277,Cory Joseph,PG,27,IND,82,9,2063,226,548,55,171,171,377,30,43,39,240,279,321,94,22,80,131,537
278,Frank Kaminsky,C,25,CHO,47,0,755,138,298,50,139,88,159,79,107,39,124,163,63,12,12,41,68,405
279,Enes Kanter,C,26,TOT,67,31,1640,375,683,10,34,365,649,155,197,257,402,659,116,32,26,118,167,915
280,Luke Kennard,SG,22,DET,63,10,1437,228,520,106,269,122,251,51,61,12,171,183,114,26,10,57,92,613
281,Michael Kidd-Gilchrist,PF,25,CHO,64,3,1179,158,332,16,47,142,285,95,123,88,158,246,61,32,39,43,156,427
282,George King,SF,25,PHO,1,0,6,0,0,0,0,0,0,0,0,0,1,1,0,0,0,0,0,0
283,Maxi Kleber,PF,27,DAL,71,18,1502,175,386,77,218,98,168,58,74,90,239,329,70,36,78,54,143,485
284,Brandon Knight,PG,27,TOT,39,26,736,99,260,41,129,58,131,27,34,10,49,59,71,21,2,30,62,266
285,Kevin Knox,PF,19,NYK,75,57,2158,338,914,125,364,213,550,162,226,61,274,335,82,43,24,114,175,963
286,Furkan Korkmaz,SG,21,PHI,48,7,679,98,245,47,144,51,101,36,44,16,91,107,52,29,2,25,62,279
287,Luke Kornet,PF,23,NYK,46,18,784,107,283,70,193,37,90,38,46,28,107,135,54,27,42,25,41,322
289,Kosta Koufos,C,29,SAC,42,1,502,73,153,0,0,73,153,10,24,52,125,177,36,15,18,27,68,156
290,Rodions Kurucs,SF,20,BRK,63,46,1294,202,449,58,184,144,265,72,92,56,190,246,52,41,25,77,146,534
291,Kyle Kuzma,PF,23,LAL,70,68,2314,496,1087,128,422,368,665,188,250,60,322,382,178,41,26,133,170,1308
292,Skal Labissière,PF,22,TOT,22,1,176,26,49,6,13,20,36,9,17,9,34,43,11,5,6,11,29,67
293,Jeremy Lamb,SG,26,CHO,79,55,2250,431,979,115,330,316,649,231,260,65,369,434,172,88,32,80,140,1208
294,Zach LaVine,SG,23,CHI,63,62,2171,530,1135,120,321,410,814,312,375,40,254,294,283,60,26,215,140,1492
295,Jake Layman,SF,24,POR,71,33,1327,216,424,59,181,157,243,50,71,56,161,217,53,31,30,46,116,541
296,T.J. Leaf,PF,21,IND,58,1,522,99,183,8,31,91,152,19,31,43,82,125,24,9,19,12,35,225
297,Courtney Lee,SG,33,TOT,34,6,428,53,129,16,55,37,74,14,21,9,45,54,37,21,3,14,32,136
298,Damion Lee,SG,26,GSW,32,0,375,56,127,27,68,29,59,19,22,8,56,64,13,13,0,11,28,158
299,Walt Lemon,PG,26,CHI,6,3,167,38,87,2,5,36,82,8,11,4,23,27,30,11,1,10,14,86
300,Alex Len,C,25,ATL,77,31,1544,320,648,74,204,246,444,140,216,158,266,424,86,27,69,97,200,854
301,Kawhi Leonard,SF,27,TOR,60,60,2040,560,1129,112,302,448,827,364,426,78,361,439,199,106,24,121,87,1596
302,Meyers Leonard,C,26,POR,61,2,878,132,242,50,111,82,131,43,51,49,184,233,75,13,9,43,105,357
303,Jon Leuer,PF,29,DET,41,1,402,66,113,1,11,65,102,23,31,27,70,97,14,12,4,23,60,156
304,Caris LeVert,SF,24,BRK,40,25,1063,207,483,48,154,159,329,85,123,35,116,151,156,42,14,69,77,547
305,Damian Lillard,PG,28,POR,80,80,2838,681,1533,237,643,444,890,468,513,68,303,371,551,88,34,212,148,2067
306,Jeremy Lin,PG,30,TOT,74,4,1436,238,541,55,187,183,354,176,210,22,157,179,231,47,13,124,144,707
307,Shaun Livingston,PG,33,GSW,64,0,967,109,210,0,2,109,208,40,51,42,75,117,114,31,27,38,74,258
308,Zach Lofton,SG,26,DET,1,0,4,0,1,0,1,0,0,0,0,0,0,0,0,1,0,1,0,0
309,Kevon Looney,C,22,GSW,80,24,1481,217,347,1,10,216,337,65,105,194,223,417,123,46,53,51,211,500
310,Brook Lopez,C,30,MIL,81,81,2322,355,786,187,512,168,274,112,133,33,363,396,98,51,179,82,189,1009
311,Robin Lopez,C,30,CHI,74,36,1606,304,535,7,31,297,504,89,123,140,146,286,89,11,78,96,124,704
312,Kevin Love,PF,30,CLE,22,21,598,109,283,53,147,56,136,103,114,33,206,239,48,6,5,42,54,374
313,Kyle Lowry,PG,32,TOR,65,65,2213,304,739,157,453,147,286,161,194,41,271,312,564,91,31,182,166,926
314,Jordan Loyd,PG,25,TOR,12,0,55,8,18,4,8,4,10,9,11,1,8,9,6,0,0,2,5,29
315,Kalin Lucas,PG,29,DET,1,0,6,0,1,0,1,0,0,2,2,0,3,3,1,0,0,0,1,2
316,Timothé Luwawu-Cabarrot,SF,23,TOT,50,7,669,82,218,36,116,46,102,31,41,11,86,97,26,19,8,21,73,231
317,Tyler Lydon,PF,22,DEN,25,0,94,9,18,4,10,5,8,1,3,7,11,18,6,2,0,4,10,23
318,Trey Lyles,PF,23,DEN,64,2,1120,207,495,51,200,156,295,81,116,44,202,246,87,30,23,68,93,546
319,Scott Machado,PG,28,LAL,4,0,19,4,6,1,1,3,5,1,1,0,0,0,3,1,0,0,2,10
320,Shelvin Mack,PG,28,TOT,57,3,1246,163,403,46,130,117,273,58,84,18,86,104,183,47,4,66,84,430
321,Daryl Macon,SG,23,DAL,8,0,90,10,27,5,11,5,16,4,7,2,10,12,7,1,0,6,8,29
322,J.P. Macura,SG,23,CHO,2,0,17,3,9,0,4,3,5,0,0,0,3,3,2,0,0,0,0,6
323,Ian Mahinmi,C,32,WAS,34,6,498,47,104,3,16,44,88,42,61,48,80,128,25,25,16,21,84,139
325,Boban Marjanović,C,30,TOT,58,12,681,160,260,4,10,156,250,98,131,87,178,265,54,16,27,59,90,422
326,Lauri Markkanen,PF,21,CHI,52,51,1682,342,795,120,332,222,463,170,195,74,396,470,75,37,33,85,122,974
327,Jarell Martin,PF,24,ORL,42,1,328,43,104,20,57,23,47,9,11,11,62,73,18,3,8,11,51,115
328,Frank Mason,PG,24,SAC,38,0,435,71,169,14,64,57,105,39,57,6,37,43,84,16,4,36,34,195
329,Yante Maten,PF,22,MIA,2,0,13,1,4,0,1,1,3,0,0,1,2,3,0,1,0,0,0,2
331,Luc Mbah a Moute,PF,32,LAC,4,0,61,8,18,2,6,6,12,2,5,2,5,7,2,1,1,2,8,20
332,Tahjere McCall,SG,24,BRK,1,0,8,2,3,0,1,2,2,0,1,0,1,1,0,0,0,0,2,4
333,Patrick McCaw,SG,23,TOT,29,1,397,26,63,9,28,17,35,13,15,7,41,48,29,23,2,17,38,74
334,CJ McCollum,SG,27,POR,70,70,2375,571,1243,167,445,404,798,159,192,62,220,282,207,55,28,106,172,1468
335,T.J. McConnell,PG,26,PHI,76,3,1470,220,419,14,42,206,377,29,37,28,146,174,258,79,17,91,105,483
336,Doug McDermott,SF,27,IND,77,1,1340,207,422,84,206,123,216,66,79,17,92,109,67,18,8,42,104,564
337,JaVale McGee,C,31,LAL,75,62,1671,400,641,1,12,399,629,96,152,195,371,566,52,47,148,108,208,897
338,Rodney McGruder,SG,27,MIA,66,45,1550,186,461,79,225,107,236,52,72,60,178,238,112,36,12,64,115,503
339,Alfonzo McKinnie,SF,26,GSW,72,5,1003,134,275,42,118,92,157,27,48,81,166,247,31,18,15,30,134,337
340,Ben McLemore,SG,25,SAC,19,0,158,25,64,17,41,8,23,8,12,3,14,17,4,6,3,5,22,75
341,Jordan McRae,SG,27,WAS,27,0,333,61,130,10,35,51,95,28,35,6,34,40,30,13,7,15,26,160
342,Jodie Meeks,SG,31,TOR,8,0,104,21,39,8,18,13,21,1,1,1,11,12,8,1,1,2,5,51
343,Salah Mejri,C,32,DAL,36,4,399,55,112,11,34,44,78,20,32,36,95,131,35,10,26,21,55,141
344,De'Anthony Melton,PG,20,PHO,50,31,984,100,256,29,95,71,161,21,28,25,109,134,159,68,23,75,113,250
345,Chimezie Metu,PF,21,SAS,29,0,145,19,58,0,2,19,56,13,17,9,27,36,13,6,2,15,14,51
346,Khris Middleton,SF,27,MIL,77,77,2393,506,1148,179,474,327,674,216,258,50,411,461,331,80,7,174,172,1407
347,C.J. Miles,SF,31,TOT,53,1,856,112,311,67,203,45,108,48,58,13,82,95,36,26,15,30,79,339
348,Darius Miller,SF,28,NOP,69,15,1757,189,484,133,364,56,120,56,71,14,114,128,146,40,23,59,165,567
349,Malcolm Miller,SF,25,TOR,10,0,67,11,26,10,21,1,5,3,4,1,4,5,1,1,1,1,5,35
350,Patty Mills,PG,30,SAS,82,1,1908,282,663,159,404,123,259,88,103,24,158,182,245,49,10,93,129,811
351,Paul Millsap,PF,33,DEN,70,65,1895,322,665,58,159,264,506,181,249,153,352,505,141,83,54,95,183,883
352,Shake Milton,SG,22,PHI,20,0,268,34,87,14,44,20,43,5,7,9,26,35,18,8,8,6,29,87
353,Nikola Mirotić,PF,27,TOT,46,25,1245,238,542,116,318,122,224,105,124,60,279,339,55,31,34,48,107,697
354,Donovan Mitchell,SG,22,UTA,77,77,2598,661,1530,188,519,473,1011,319,396,59,257,316,322,106,31,218,208,1829
355,Naz Mitrou-Long,SG,25,UTA,14,0,84,6,20,2,11,4,9,2,2,1,5,6,15,1,1,8,10,16
356,Malik Monk,SG,20,CHO,73,0,1258,227,586,109,330,118,256,90,102,16,121,137,117,37,19,86,106,653
357,Greg Monroe,C,28,TOT,43,2,480,92,189,1,5,91,184,45,72,67,105,172,24,14,8,32,66,230
358,E'Twaun Moore,SG,29,NOP,53,36,1463,256,532,76,176,180,356,45,59,35,92,127,102,40,8,59,112,633
359,Eric Moreland,PF,27,TOT,5,0,43,3,7,1,1,2,6,0,0,4,16,20,4,1,1,5,9,7
360,Jaylen Morris,SG,23,MIL,4,0,29,4,10,1,3,3,7,1,2,0,5,5,4,2,0,1,1,10
361,Marcus Morris,PF,29,BOS,75,53,2091,377,844,146,389,231,455,146,173,76,382,458,109,43,25,92,181,1046
362,Markieff Morris,PF,29,TOT,58,16,1270,204,484,68,203,136,281,71,92,61,204,265,79,36,22,54,175,547
363,Monte Morris,PG,23,DEN,82,6,1970,346,702,94,227,252,475,65,81,35,159,194,297,73,4,52,102,851
364,Donatas Motiejūnas,PF,28,SAS,3,0,13,3,6,0,0,3,6,0,2,2,1,3,1,0,1,3,6,6
365,Johnathan Motley,PF,23,LAC,22,0,156,39,73,0,3,39,70,24,40,18,33,51,11,5,3,16,27,102
366,Emmanuel Mudiay,PG,22,NYK,59,42,1607,330,740,69,210,261,530,144,186,33,163,196,228,43,19,140,103,873
367,Jamal Murray,PG,21,DEN,75,74,2447,513,1173,152,414,361,759,189,223,65,252,317,363,67,27,158,153,1367
368,Džanan Musa,SG,19,BRK,9,0,39,9,22,1,10,8,12,0,2,1,4,5,2,2,0,4,1,19
369,Mike Muscala,PF,27,TOT,64,10,1306,145,361,89,256,56,105,70,85,57,187,244,76,22,38,48,130,449
370,Sviatoslav Mykhailiuk,SF,21,TOT,42,0,440,46,140,29,89,17,51,12,20,9,27,36,37,14,1,21,25,133
371,Abdel Nader,SF,25,OKC,61,1,694,91,215,32,100,59,115,27,36,14,102,116,20,20,12,26,68,241
372,Larry Nance,C,26,CLE,67,30,1795,249,479,33,98,216,381,96,134,168,384,552,214,100,40,97,192,627
373,Shabazz Napier,PG,27,BRK,56,2,983,169,435,76,228,93,207,115,138,18,82,100,143,41,16,66,67,529
374,Raul Neto,PG,26,UTA,37,1,474,74,161,20,60,54,101,28,33,6,56,62,93,14,4,35,49,196
375,Georges Niang,PF,25,UTA,59,0,516,86,181,43,105,43,76,20,24,11,76,87,35,10,6,23,57,235
376,Joakim Noah,C,33,MEM,42,1,693,110,213,0,1,110,212,78,109,58,180,238,89,20,31,50,96,298
377,Nerlens Noel,C,24,OKC,77,2,1055,162,276,0,0,162,276,54,79,127,198,325,45,66,96,48,166,378
378,Dirk Nowitzki,PF,40,DAL,51,20,795,135,376,64,205,71,171,39,50,5,153,158,35,9,18,18,76,373
379,Frank Ntilikina,PG,20,NYK,43,16,904,95,282,33,115,62,167,23,30,12,75,87,121,30,14,56,104,246
380,James Nunnally,SF,28,TOT,15,0,102,12,34,8,25,4,9,4,4,0,5,5,7,1,0,1,10,36
381,Jusuf Nurkić,C,24,POR,72,72,1974,420,826,3,29,417,797,282,365,243,505,748,233,71,103,168,250,1125
382,David Nwaba,SG,26,CLE,51,14,984,126,262,24,75,102,187,58,85,41,122,163,54,36,17,29,106,334
383,Royce O'Neale,SF,25,UTA,82,16,1671,163,343,68,176,95,167,32,42,22,263,285,124,54,24,70,172,426
384,Kyle O'Quinn,C,28,IND,45,3,371,69,136,1,12,68,124,17,21,29,90,119,56,9,25,31,68,156
385,Semi Ojeleye,PF,24,BOS,56,3,594,67,158,28,89,39,69,24,39,24,62,86,23,10,4,19,43,186
386,Jahlil Okafor,C,23,NOP,59,24,935,212,362,1,5,211,357,59,89,82,196,278,40,15,40,52,96,484
387,Élie Okobo,PG,21,PHO,53,16,958,114,290,39,132,75,158,37,47,12,86,98,127,32,7,69,109,304
388,Josh Okogie,SG,20,MIN,74,52,1757,196,508,60,215,136,293,118,162,41,177,218,91,88,33,63,166,570
389,Victor Oladipo,SG,26,IND,36,36,1147,249,588,74,216,175,372,103,141,21,181,202,186,60,11,82,72,675
390,Kelly Olynyk,PF,27,MIA,79,36,1812,261,564,113,319,148,245,152,185,72,303,375,140,53,37,114,183,787
391,Cedi Osman,SF,23,CLE,76,75,2444,360,844,130,374,230,470,141,181,45,312,357,195,60,11,114,195,991
392,Kelly Oubre,SF,23,TOT,69,19,1935,375,842,108,338,267,504,189,244,71,254,325,84,84,59,103,181,1047
393,Zaza Pachulia,C,34,DET,68,3,878,85,193,0,4,85,189,97,124,99,166,265,91,31,17,57,151,267
394,Jabari Parker,PF,23,TOT,64,17,1724,369,749,61,195,308,554,131,184,79,342,421,152,46,30,151,145,930
395,Tony Parker,PG,36,CHO,56,0,1003,213,463,13,51,200,412,91,124,14,69,83,207,21,7,75,53,530
396,Chandler Parsons,SF,30,MEM,25,3,496,68,182,29,94,39,88,22,25,4,66,70,43,19,5,32,45,187
397,Patrick Patterson,PF,29,OKC,63,5,861,82,219,46,137,36,82,19,30,42,105,147,31,16,13,22,46,229
398,Justin Patton,C,21,PHI,3,0,21,2,7,0,2,2,5,1,2,2,4,6,3,2,0,0,5,5
399,Chris Paul,PG,33,HOU,58,58,1857,302,720,127,355,175,365,175,203,36,229,265,473,114,18,152,146,906
400,Cameron Payne,PG,24,TOT,40,13,712,96,223,25,84,71,139,33,41,13,59,72,106,28,9,45,64,250
401,Elfrid Payton,PG,24,NOP,42,42,1250,179,412,33,105,146,307,55,74,49,171,220,320,44,17,112,81,446
402,Gary Payton,PG,26,WAS,3,0,16,5,8,1,2,4,6,0,0,1,1,2,4,3,1,1,2,11
403,Theo Pinson,SG,23,BRK,18,0,211,25,73,12,46,13,27,19,22,4,32,36,21,6,0,18,15,81
404,Mason Plumlee,C,28,DEN,82,17,1731,262,442,2,10,260,432,111,198,165,359,524,243,66,76,126,252,637
405,Miles Plumlee,C,30,ATL,18,0,173,32,48,0,0,32,48,16,30,16,23,39,17,6,4,10,14,80
406,Jakob Pöltl,C,23,SAS,77,24,1273,187,290,0,0,187,290,49,92,178,232,410,93,29,68,48,124,423
407,Quincy Pondexter,SF,30,SAS,53,0,292,29,58,6,18,23,40,34,42,8,38,46,24,11,1,13,24,98
408,Otto Porter,SF,25,TOT,56,43,1683,299,643,104,256,195,387,78,96,54,260,314,120,82,31,65,108,780
409,Bobby Portis,PF,23,TOT,50,28,1299,279,628,75,191,204,437,77,97,109,294,403,72,35,20,74,145,710
410,Dwight Powell,C,27,DAL,77,22,1662,290,486,39,127,251,359,196,254,140,271,411,112,44,50,67,201,815
411,Norman Powell,SG,25,TOR,60,3,1126,193,400,68,170,125,230,62,75,16,123,139,91,39,13,65,96,516
412,Alex Poythress,PF,25,ATL,21,1,305,40,81,9,23,31,58,18,29,29,47,76,17,4,10,13,47,107
413,Zhou Qi,PF,23,HOU,1,0,1,1,1,0,0,1,1,0,0,0,0,0,0,0,0,0,0,2
414,Ivan Rabb,PF,21,MEM,49,13,721,116,212,3,15,113,197,49,69,70,136,206,54,17,14,35,90,284
415,Chasson Randle,PG,25,WAS,49,2,743,91,217,46,115,45,102,43,62,10,46,56,97,25,3,43,91,271
416,Julius Randle,PF,24,NOP,73,49,2232,571,1089,67,195,504,894,356,487,162,472,634,229,52,45,208,246,1565
417,J.J. Redick,SG,34,PHI,76,63,2379,452,1027,240,605,212,422,228,255,20,166,186,206,32,17,101,129,1372
418,Davon Reed,SG,23,IND,10,0,47,5,12,2,4,3,8,0,0,2,4,6,3,1,0,1,3,12
419,Cameron Reynolds,SG,23,MIN,19,0,259,33,78,21,51,12,27,8,9,4,27,31,13,6,2,5,26,95
420,Josh Richardson,SG,25,MIA,73,73,2539,423,1026,164,460,259,566,199,231,54,209,263,298,79,34,113,200,1209
421,Malachi Richardson,SG,23,TOR,22,0,103,9,29,8,25,1,4,4,5,2,11,13,0,1,0,8,13,30
422,Austin Rivers,SG,26,TOT,76,15,2028,232,572,104,327,128,245,50,95,25,137,162,167,47,23,68,207,618
423,Devin Robinson,SF,23,WAS,7,0,95,19,32,0,2,19,30,9,14,6,14,20,6,4,6,2,11,47
424,Duncan Robinson,PF,24,MIA,15,1,161,18,46,10,35,8,11,4,6,2,17,19,5,5,0,4,11,50
425,Glenn Robinson,SF,25,DET,47,18,610,74,176,18,62,56,114,32,40,17,54,71,21,14,8,18,45,198
426,Jerome Robinson,SG,21,LAC,33,0,320,44,110,18,57,26,53,6,9,3,38,41,19,11,3,13,46,112
427,Mitchell Robinson,C,20,NYK,66,19,1360,202,291,0,0,202,291,81,135,177,246,423,37,52,161,35,217,485
428,Rajon Rondo,PG,32,LAL,46,29,1369,175,432,51,142,124,290,23,36,34,209,243,367,57,7,127,100,424
429,Derrick Rose,PG,30,MIN,51,13,1392,363,753,54,146,309,607,137,160,33,107,140,220,31,12,82,57,917
430,Terrence Ross,SG,27,ORL,81,0,2150,440,1027,217,566,223,461,126,144,27,253,280,135,72,29,90,119,1223
431,Terry Rozier,PG,24,BOS,79,14,1791,258,666,119,337,139,329,73,93,32,275,307,231,68,21,68,101,708
432,Ricky Rubio,PG,28,UTA,68,67,1899,295,730,79,254,216,476,195,228,33,210,243,416,91,10,180,180,864
433,D'Angelo Russell,PG,22,BRK,81,81,2448,659,1517,234,635,425,882,160,205,53,262,315,563,100,20,253,141,1712
434,Domantas Sabonis,C,22,IND,74,5,1838,413,700,9,17,404,683,208,291,186,504,690,212,48,30,160,239,1043
435,Brandon Sampson,SG,21,CHI,14,2,214,28,60,11,29,17,31,4,6,3,13,16,10,8,3,12,19,71
436,JaKarr Sampson,SF,25,CHI,4,0,127,29,54,5,14,24,40,17,21,5,27,32,4,4,3,4,8,80
437,Dario Šarić,PF,24,TOT,81,41,2023,304,696,118,323,186,373,132,150,126,331,457,127,45,9,97,182,858
438,Tomáš Satoranský,PG,27,WAS,80,54,2164,257,530,64,162,193,368,131,160,82,197,279,399,82,13,120,172,709
439,Dennis Schröder,PG,25,OKC,79,14,2314,457,1104,124,364,333,740,186,227,38,246,284,323,65,12,172,189,1224
440,Mike Scott,PF,30,TOT,79,3,1395,168,420,101,252,67,168,22,33,43,233,276,66,26,13,44,156,459
441,Thabo Sefolosha,SF,34,UTA,50,2,609,71,149,34,78,37,71,14,22,8,115,123,27,43,5,25,41,190
442,Wayne Selden,SG,24,TOT,75,13,1439,196,483,55,174,141,309,67,92,37,143,180,109,33,13,79,131,514
443,Collin Sexton,PG,20,CLE,82,72,2605,519,1206,119,296,400,910,214,255,57,179,236,243,44,6,185,186,1371
444,Landry Shamet,SG,21,TOT,79,27,1802,240,557,167,396,73,161,75,93,21,113,134,117,37,10,45,155,722
445,Iman Shumpert,SG,28,TOT,62,41,1481,167,446,95,273,72,173,36,45,27,156,183,112,59,24,50,127,465
446,Pascal Siakam,PF,24,TOR,80,79,2548,519,945,79,214,440,731,237,302,124,425,549,248,73,52,154,241,1354
447,Jordan Sibert,SG,26,ATL,1,0,4,1,1,1,1,0,0,0,0,0,0,0,0,0,0,0,0,3
448,Ben Simmons,PG,22,PHI,79,79,2700,540,960,0,6,540,954,257,428,172,525,697,610,112,61,274,209,1337
450,Kobi Simmons,PG,21,CLE,1,0,2,0,0,0,0,0,0,0,0,0,0,0,0,0,0,0,0,0
451,Anfernee Simons,SG,19,POR,20,1,141,28,63,10,29,18,34,9,16,3,10,13,13,1,0,11,9,75
452,Marcus Smart,SG,24,BOS,80,60,2200,239,567,126,346,113,221,104,129,57,177,234,321,143,28,123,201,708
453,Dennis Smith,PG,21,TOT,53,50,1508,278,650,67,208,211,442,99,156,32,123,155,252,67,20,154,129,722
454,Ish Smith,PG,30,DET,56,0,1251,205,489,44,135,161,354,47,62,23,122,145,203,28,11,61,109,501
455,J.R. Smith,SG,33,CLE,11,4,222,27,79,12,39,15,40,8,10,0,18,18,21,11,3,11,19,74
457,Zhaire Smith,SG,19,PHI,6,2,111,14,34,6,16,8,18,6,8,3,10,13,10,2,2,6,8,40
458,Tony Snell,SF,27,MIL,74,12,1304,163,361,81,204,82,157,37,42,29,128,157,68,26,18,23,90,444
459,Ray Spalding,PF,21,TOT,14,3,148,25,47,0,3,25,44,4,12,15,33,48,5,9,8,9,23,54
460,Omari Spellman,PF,21,ATL,46,11,805,98,244,44,128,54,116,32,45,72,122,194,47,26,25,31,67,272
461,Nik Stauskas,SG,25,TOT,68,0,1015,136,338,70,188,66,150,57,64,18,109,127,81,21,7,51,50,399
462,D.J. Stephens,SG,28,MEM,1,0,7,1,2,0,0,1,2,0,0,0,0,0,0,1,0,1,0,2
463,Lance Stephenson,SG,28,LAL,68,3,1123,184,432,73,197,111,235,50,73,32,183,215,140,41,7,86,111,491
464,Edmond Sumner,PG,23,IND,23,2,210,22,64,7,27,15,37,15,24,9,15,24,10,12,5,10,26,66
465,Caleb Swanigan,PF,21,TOT,21,0,178,18,53,1,7,17,46,6,9,17,47,64,11,6,1,18,28,43
466,Jayson Tatum,SF,20,BOS,79,79,2455,466,1036,116,311,350,725,195,228,70,407,477,168,84,57,122,168,1243
467,Jeff Teague,PG,30,MIN,42,41,1264,176,416,35,105,141,311,123,153,16,90,106,343,43,18,97,90,510
468,Garrett Temple,SG,32,TOT,75,55,2040,208,493,90,264,118,229,80,107,28,188,216,106,76,30,70,204,586
469,Miloš Teodosić,PG,31,LAC,15,0,150,17,40,10,27,7,13,4,7,3,13,16,32,3,1,21,27,48
470,Jared Terrell,SG,23,MIN,14,0,111,12,39,4,17,8,22,3,6,1,5,6,12,3,2,10,16,31
471,Emanuel Terry,PF,22,TOT,3,0,23,4,7,0,0,4,7,2,4,3,4,7,2,3,0,2,4,10
472,Daniel Theis,C,26,BOS,66,2,908,146,266,26,67,120,199,56,76,87,138,225,68,21,42,33,161,374
473,Isaiah Thomas,SG,29,DEN,12,0,181,34,99,12,43,22,56,17,27,5,8,13,23,5,1,18,17,97
474,Khyri Thomas,SG,22,DET,26,0,195,22,69,10,35,12,34,7,11,4,16,20,8,7,5,4,22,61
475,Lance Thomas,PF,30,NYK,46,17,783,78,197,22,79,56,118,27,36,21,96,117,27,17,7,24,83,205
476,Klay Thompson,SG,28,GSW,78,78,2652,655,1402,241,599,414,803,129,158,37,262,299,186,84,47,115,157,1680
477,Tristan Thompson,C,27,CLE,43,40,1198,201,380,0,0,201,380,68,106,173,265,438,86,28,16,59,89,470
478,Sindarius Thornwell,SG,24,LAC,64,1,313,17,49,3,15,14,34,25,34,5,39,44,18,14,7,20,41,62
479,Anthony Tolliver,PF,33,MIN,65,0,1079,99,259,81,215,18,44,47,60,15,162,177,46,17,21,36,91,326
480,Karl-Anthony Towns,C,23,MIN,77,77,2545,681,1314,142,355,539,959,376,450,263,691,954,259,67,125,240,292,1880
481,Gary Trent,SG,20,POR,15,1,111,16,50,5,21,11,29,3,7,1,10,11,5,1,2,4,4,40
482,Allonzo Trier,SG,23,NYK,64,3,1459,232,518,52,132,180,386,179,223,31,166,197,119,28,14,116,117,695
483,P.J. Tucker,PF,33,HOU,82,82,2802,207,523,146,387,61,136,41,59,121,358,479,96,132,39,63,252,601
484,Evan Turner,PG,30,POR,73,2,1605,204,443,11,52,193,391,75,106,37,291,328,283,33,18,114,110,494
485,Myles Turner,C,22,IND,74,74,2119,380,780,76,196,304,584,148,201,101,430,531,115,60,199,100,195,984
486,Ekpe Udoh,C,31,UTA,51,1,320,50,72,0,0,50,72,19,30,27,63,90,28,10,31,13,36,119
487,Tyler Ulis,PG,23,CHI,1,0,1,0,0,0,0,0,0,0,0,0,0,0,0,0,0,0,0,0
488,Jonas Valančiūnas,C,26,TOT,49,27,1091,301,538,14,48,287,490,147,185,106,313,419,70,19,53,90,146,763
489,Jarred Vanderbilt,PF,19,DEN,17,0,69,9,19,0,1,9,18,6,10,7,16,23,3,6,1,8,8,24
490,Fred VanVleet,PG,24,TOR,64,28,1760,246,600,112,296,134,304,97,115,21,146,167,307,57,20,82,110,701
491,Noah Vonleh,PF,23,NYK,68,57,1722,207,440,46,137,161,303,111,156,113,415,528,129,46,51,88,174,571
492,Nikola Vučević,C,28,ORL,80,80,2510,701,1354,84,231,617,1123,179,227,224,736,960,307,81,89,159,157,1665
493,Dwyane Wade,SG,37,MIA,72,2,1885,416,960,86,261,330,699,165,233,69,216,285,301,59,38,166,118,1083
494,Moritz Wagner,C,21,LAL,43,5,446,71,171,22,77,49,94,43,53,17,68,85,24,11,13,39,57,207
495,Dion Waiters,SG,27,MIA,44,28,1138,198,478,109,289,89,189,22,44,7,109,116,121,29,9,64,72,527
496,Kemba Walker,PG,28,CHO,82,82,2863,731,1684,260,731,471,953,380,450,52,309,361,484,102,34,211,131,2102
497,Lonnie Walker,SG,20,SAS,17,0,118,16,46,5,13,11,33,8,10,0,17,17,9,7,3,4,7,45
498,John Wall,PG,28,WAS,32,32,1104,245,552,51,169,194,383,122,175,15,101,116,279,49,29,121,71,663
499,Tyrone Wallace,PG,24,LAC,62,0,628,92,217,4,19,88,198,30,57,20,81,101,42,21,7,36,83,218
500,Taurean Waller-Prince,SF,24,ATL,55,47,1552,262,594,123,315,139,279,95,116,22,177,199,118,53,19,100,141,742
501,Brad Wanamaker,PG,29,BOS,36,0,343,50,105,16,39,34,66,24,28,3,38,41,56,12,2,19,34,140
502,T.J. Warren,SF,25,PHO,43,36,1360,297,611,77,180,220,431,101,124,31,143,174,64,51,29,52,119,772
503,Julian Washburn,SF,27,MEM,18,3,254,16,48,5,24,11,24,3,4,8,33,41,14,13,2,7,16,40
504,Yuta Watanabe,SF,24,MEM,15,0,174,15,51,2,16,13,35,7,10,4,27,31,8,4,1,6,11,39
505,Thomas Welsh,C,22,DEN,11,0,36,7,13,3,7,4,6,1,2,0,4,4,5,0,0,1,3,18
506,Russell Westbrook,PG,30,OKC,73,73,2630,630,1473,119,411,511,1062,296,451,109,698,807,784,142,33,325,245,1675
507,Derrick White,PG,24,SAS,67,55,1728,260,543,48,142,212,401,95,123,35,212,247,263,67,47,97,145,663
508,Okaro White,PF,26,WAS,3,0,6,0,2,0,2,0,0,0,0,1,1,2,0,0,0,0,0,0
509,Hassan Whiteside,C,29,MIA,72,53,1674,388,680,2,16,386,664,109,243,257,560,817,56,46,136,97,192,887
510,Andrew Wiggins,SF,23,MIN,73,73,2543,498,1209,118,348,380,861,207,296,83,269,352,184,70,48,138,153,1321
511,Alan Williams,PF,26,BRK,5,0,26,8,13,0,1,8,12,2,4,4,15,19,3,1,0,1,2,18
512,C.J. Williams,SG,28,MIN,15,0,128,17,35,5,16,12,19,0,1,1,7,8,12,6,0,5,16,39
513,Johnathan Williams,C,23,LAL,24,0,372,65,110,0,2,65,108,27,48,48,51,99,13,8,7,16,62,157
514,Kenrich Williams,SF,24,NOP,46,29,1079,107,279,52,156,55,123,13,19,55,164,219,83,45,19,36,95,279
515,Lou Williams,SG,32,LAC,75,1,1993,484,1138,105,291,379,847,425,485,40,182,222,402,57,11,181,80,1498
516,Marvin Williams,PF,32,CHO,75,75,2133,275,652,140,382,135,270,66,86,76,331,407,92,71,61,47,156,756
517,Robert Williams,C,21,BOS,32,2,283,36,51,0,0,36,51,9,15,27,54,81,7,9,40,10,36,81
518,Troy Williams,SF,24,SAC,21,0,312,44,98,14,44,30,54,9,15,12,47,59,11,10,8,9,37,111
519,D.J. Wilson,PF,22,MIL,48,3,882,104,251,46,127,58,124,26,47,45,177,222,52,18,20,32,85,280
520,Justise Winslow,SF,22,MIA,66,52,1959,324,749,96,256,228,493,86,137,63,292,355,282,72,19,142,177,830
521,Christian Wood,PF,23,TOT,21,2,251,61,117,9,26,52,91,41,56,17,66,83,8,7,10,17,17,172
522,Delon Wright,PG,26,TOT,75,13,1699,242,558,50,168,192,390,119,150,68,198,266,248,88,30,77,103,653
523,Guerschon Yabusele,PF,23,BOS,41,1,251,35,77,9,28,26,49,15,22,23,30,53,15,8,7,15,32,94
524,Nick Young,SG,33,DEN,4,0,37,3,9,3,8,0,1,0,0,0,1,1,2,0,1,2,4,9
525,Thaddeus Young,PF,30,IND,81,81,2489,443,841,51,146,392,695,87,135,192,331,523,204,123,36,123,194,1024
526,Trae Young,PG,20,ATL,81,81,2503,525,1256,156,482,369,774,343,414,64,237,301,653,72,15,308,140,1549
527,Cody Zeller,C,26,CHO,49,47,1243,190,345,6,22,184,323,111,141,110,223,333,102,38,41,62,164,497
528,Tyler Zeller,C,29,TOT,6,1,93,16,30,0,1,16,29,14,18,11,13,24,4,1,3,4,20,46
529,Ante Žižić,C,22,CLE,59,25,1082,183,331,0,0,183,331,93,132,108,212,320,53,13,22,61,113,459
530,Ivica Zubac,C,21,TOT,59,37,1040,212,379,0,0,212,379,101,126,115,247,362,63,14,51,70,137,525
